,CNTYVTD,CVAP18,BCVAP18,ObamaD_12G_President,RomneyR_12G_President,OVAP,TOT_VOTES,factor,BCVAP18_pct,OVAP_pct,PRES12None,ObamaD_12G_President_pct,RomneyR_12G_President_pct,PRES12None_pct
0,1010101,293,47,42,179,246,293,1.0,0.16040955631399317,0.8395904436860068,72,0.14334470989761092,0.6109215017064846,0.24573378839590443
1,1010201,220,15,27,179,205,220,1.0,0.06818181818181818,0.9318181818181818,14,0.12272727272727273,0.8136363636363636,0.06363636363636363
2,1010301,283,52,67,87,231,283,1.0,0.18374558303886926,0.8162544169611308,129,0.23674911660777384,0.30742049469964666,0.4558303886925795
3,1010401,262,39,44,110,223,262,1.0,0.14885496183206107,0.851145038167939,108,0.16793893129770993,0.4198473282442748,0.4122137404580153
4,1030001,1003,1,51,384,1002,1003,1.0,0.0009970089730807576,0.9990029910269193,568,0.05084745762711865,0.382851445663011,0.5663010967098704
5,1030002,565,16,75,285,549,565,1.0,0.02831858407079646,0.9716814159292035,205,0.13274336283185842,0.504424778761062,0.36283185840707965
6,1030003,793,57,103,144,736,793,1.0,0.07187894073139975,0.9281210592686002,546,0.12988650693568726,0.18158890290037832,0.6885245901639344
7,1030004,564,17,46,172,547,564,1.0,0.030141843971631204,0.9698581560283688,346,0.08156028368794327,0.3049645390070922,0.6134751773049646
8,1050001,713,12,200,184,701,713,1.0,0.016830294530154277,0.9831697054698457,329,0.2805049088359046,0.25806451612903225,0.46143057503506313
9,1050002,653,13,103,298,640,653,1.0,0.019908116385911178,0.9800918836140888,252,0.15773353751914243,0.4563552833078101,0.38591117917304746
10,1050003,586,3,62,350,583,586,1.0,0.005119453924914676,0.9948805460750854,174,0.10580204778156997,0.5972696245733788,0.29692832764505117
11,1050004,486,0,115,125,486,486,1.0,0.0,1.0,246,0.2366255144032922,0.257201646090535,0.5061728395061729
12,1070011,990,42,130,216,948,990,1.0,0.04242424242424243,0.9575757575757575,644,0.13131313131313133,0.21818181818181817,0.6505050505050505
13,1070027,1058,65,181,336,993,1058,1.0,0.06143667296786389,0.9385633270321361,541,0.17107750472589792,0.31758034026465026,0.5113421550094518
14,1070039,1086,44,143,245,1042,1086,1.0,0.040515653775322284,0.9594843462246777,698,0.13167587476979742,0.22559852670349909,0.6427255985267035
15,1070044,1032,21,185,335,1011,1032,1.0,0.020348837209302327,0.9796511627906976,512,0.17926356589147288,0.3246124031007752,0.49612403100775193
16,1090001,370,0,129,39,370,370,1.0,0.0,1.0,202,0.34864864864864864,0.10540540540540541,0.5459459459459459
17,1090002,431,1,158,68,430,431,1.0,0.002320185614849188,0.9976798143851509,205,0.3665893271461717,0.15777262180974477,0.4756380510440835
18,1090004,417,1,142,47,416,417,1.0,0.002398081534772182,0.9976019184652278,228,0.3405275779376499,0.11270983213429256,0.5467625899280576
19,10903-3,36,0,5,31,36,36,1.565217391304348,0.0,1.0,0,0.1388888888888889,0.8611111111111112,0.0
20,10903-5,356,0,134,110,356,356,1.0,0.0,1.0,112,0.37640449438202245,0.3089887640449438,0.3146067415730337
21,1110001,491,0,29,217,491,491,1.0,0.0,1.0,245,0.059063136456211814,0.4419551934826884,0.4989816700610998
22,1110002,55,0,0,41,55,55,1.0,0.0,1.0,14,0.0,0.7454545454545455,0.2545454545454545
23,1110003,22,0,0,22,22,22,1.4666666666666666,0.0,1.0,0,0.0,1.0,0.0
24,1110004,59,0,1,26,59,59,1.0,0.0,1.0,32,0.01694915254237288,0.4406779661016949,0.5423728813559322
25,1110005,36,0,3,20,36,36,1.0,0.0,1.0,13,0.08333333333333333,0.5555555555555556,0.3611111111111111
26,1110006,400,0,39,151,400,400,1.0,0.0,1.0,210,0.0975,0.3775,0.525
27,1110007,834,25,64,180,809,834,1.0,0.02997601918465228,0.9700239808153477,590,0.07673860911270983,0.2158273381294964,0.7074340527577938
28,1110008,978,7,64,343,971,978,1.0,0.007157464212678937,0.9928425357873211,571,0.065439672801636,0.3507157464212679,0.5838445807770961
29,1110009,1070,12,53,248,1058,1070,1.0,0.011214953271028037,0.9887850467289719,769,0.04953271028037383,0.23177570093457944,0.7186915887850467
30,1131000,1381,694,269,39,687,1381,1.0,0.502534395365677,0.49746560463432293,1073,0.1947863866763215,0.028240405503258507,0.77697320782042
31,1131001,1144,485,255,74,659,1144,1.0,0.42395104895104896,0.576048951048951,815,0.2229020979020979,0.06468531468531469,0.7124125874125874
32,1131002,1444,676,414,134,768,1444,1.0,0.46814404432132967,0.5318559556786704,896,0.2867036011080332,0.09279778393351801,0.6204986149584487
33,1131003,4791,3015,1682,149,1776,4791,1.0,0.6293049467752035,0.3706950532247965,2960,0.35107493216447505,0.031099979127530788,0.6178250887079941
34,1131004,1623,460,454,677,1163,1623,1.0,0.28342575477510784,0.7165742452248922,492,0.2797288971041282,0.41712877387553915,0.3031423290203327
35,1131005,2295,655,922,624,1640,2295,1.0,0.28540305010893247,0.7145969498910676,749,0.4017429193899782,0.2718954248366013,0.32636165577342047
36,1131006,1534,16,381,921,1518,1534,1.0,0.010430247718383311,0.9895697522816167,232,0.24837027379400262,0.6003911342894394,0.15123859191655803
37,1131007,403,15,51,238,388,403,1.0,0.03722084367245657,0.9627791563275434,114,0.12655086848635236,0.5905707196029777,0.28287841191067
38,1131008,1526,269,211,152,1257,1526,1.0,0.17627785058977719,0.8237221494102228,1163,0.1382699868938401,0.09960681520314547,0.7621231979030144
39,1131009,1870,735,340,89,1135,1870,1.0,0.393048128342246,0.606951871657754,1441,0.18181818181818182,0.04759358288770053,0.7705882352941177
40,1131010,2917,935,475,140,1982,2917,1.0,0.32053479602331164,0.6794652039766884,2302,0.16283853273911553,0.04799451491258142,0.789166952348303
41,1131011,1595,795,264,42,800,1595,1.0,0.49843260188087773,0.5015673981191222,1289,0.16551724137931034,0.026332288401253918,0.8081504702194358
42,1131012,287,55,23,62,232,287,1.0,0.1916376306620209,0.8083623693379791,202,0.08013937282229965,0.21602787456445993,0.7038327526132404
43,1131013,4489,385,841,898,4104,4489,1.0,0.08576520383158832,0.9142347961684116,2750,0.18734684785030073,0.2000445533526398,0.6126085987970595
44,1131014,3733,612,524,233,3121,3733,1.0,0.1639432092151085,0.8360567907848915,2976,0.1403696758639164,0.06241628716849719,0.7972140369675864
45,1131015,3280,199,415,312,3081,3280,1.0,0.06067073170731707,0.9393292682926829,2553,0.12652439024390244,0.0951219512195122,0.7783536585365853
46,1131016,232,13,54,46,219,232,1.0,0.05603448275862069,0.9439655172413793,132,0.23275862068965517,0.19827586206896552,0.5689655172413793
47,1131017,1178,49,423,333,1129,1178,1.0,0.04159592529711375,0.9584040747028862,422,0.35908319185059423,0.2826825127334465,0.35823429541595925
48,1131018,338,0,88,67,338,338,1.0,0.0,1.0,183,0.2603550295857988,0.19822485207100593,0.5414201183431953
49,1131019,2761,76,852,532,2685,2761,1.0,0.027526258601955813,0.9724737413980442,1377,0.308583846432452,0.1926838102136907,0.4987323433538573
50,1131020,1560,10,381,370,1550,1560,1.0,0.00641025641025641,0.9935897435897436,809,0.24423076923076922,0.23717948717948717,0.5185897435897436
51,1131021,1891,7,531,464,1884,1891,1.0,0.0037017451084082496,0.9962982548915917,896,0.2808038075092544,0.2453728186144897,0.47382337387625595
52,1131022,3814,222,1316,714,3592,3814,1.0,0.058206607236497114,0.9417933927635029,1784,0.3450445726271631,0.18720503408495018,0.46775039328788676
53,1131023,2116,25,576,596,2091,2116,1.0,0.011814744801512287,0.9881852551984878,944,0.2722117202268431,0.28166351606805295,0.44612476370510395
54,1131026,714,160,219,150,554,714,1.0,0.22408963585434175,0.7759103641456583,345,0.3067226890756303,0.21008403361344538,0.4831932773109244
55,1131027,4542,1576,1321,626,2966,4542,1.0,0.3469837076177895,0.6530162923822105,2595,0.2908410391897842,0.13782474680757376,0.5713342140026421
56,1131028,2435,1070,521,262,1365,2435,1.0,0.4394250513347023,0.5605749486652978,1652,0.21396303901437372,0.10759753593429158,0.6784394250513347
57,1131029,2191,1174,769,150,1017,2191,1.0,0.5358283888635327,0.4641716111364674,1272,0.3509812870835235,0.06846188954815152,0.5805568233683249
58,1131030,3490,1604,775,439,1886,3490,1.0,0.4595988538681948,0.5404011461318051,2276,0.22206303724928367,0.12578796561604585,0.6521489971346704
59,1131032,781,117,233,251,664,781,1.0,0.14980793854033292,0.8501920614596671,297,0.29833546734955185,0.3213828425096031,0.38028169014084506
60,1131033,1448,145,364,407,1303,1448,1.0,0.10013812154696132,0.8998618784530387,677,0.2513812154696133,0.28107734806629836,0.4675414364640884
61,1131035,398,10,50,51,388,398,1.0,0.02512562814070352,0.9748743718592965,297,0.12562814070351758,0.12814070351758794,0.7462311557788944
62,1131036,971,154,265,132,817,971,1.0,0.15859938208032956,0.8414006179196705,574,0.2729145211122554,0.13594232749742532,0.5911431513903193
63,1131037,2180,564,417,153,1616,2180,1.0,0.25871559633027524,0.7412844036697248,1610,0.19128440366972477,0.07018348623853211,0.7385321100917431
64,1131038,5407,3548,1028,136,1859,5407,1.0,0.6561864250046237,0.34381357499537635,4243,0.19012391344553356,0.025152579988903273,0.7847235065655631
65,1131039,530,405,157,8,125,530,1.0,0.7641509433962265,0.2358490566037736,365,0.2962264150943396,0.01509433962264151,0.6886792452830188
66,1131040,4268,1937,1144,464,2331,4268,1.0,0.45384254920337397,0.546157450796626,2660,0.26804123711340205,0.10871602624179943,0.6232427366447985
67,1131041,1469,1025,412,29,444,1469,1.0,0.6977535738597685,0.30224642614023145,1028,0.28046289993192647,0.019741320626276378,0.6997957794417972
68,1131042,1845,1205,593,51,640,1845,1.0,0.6531165311653117,0.34688346883468835,1201,0.3214092140921409,0.027642276422764227,0.6509485094850949
69,1131043,2523,384,583,866,2139,2523,1.0,0.15219976218787157,0.8478002378121284,1074,0.23107411811335712,0.34324217201743956,0.42568370986920334
70,1131044,2734,476,566,981,2258,2734,1.0,0.17410387710314557,0.8258961228968544,1187,0.20702267739575714,0.358814923189466,0.43416239941477686
71,1131045,3278,1337,707,221,1941,3278,1.0,0.4078706528370958,0.5921293471629042,2350,0.21568029286150092,0.06741915802318486,0.7169005491153142
72,1131046,277,66,107,75,211,277,1.0,0.23826714801444043,0.7617328519855595,95,0.3862815884476534,0.27075812274368233,0.34296028880866425
73,1131047,1682,0,377,266,1682,1682,1.0,0.0,1.0,1039,0.22413793103448276,0.1581450653983353,0.617717003567182
74,1131048,2504,35,679,1033,2469,2504,1.0,0.013977635782747603,0.9860223642172524,792,0.2711661341853035,0.41253993610223644,0.31629392971246006
75,1131049,2400,515,529,680,1885,2400,1.0,0.21458333333333332,0.7854166666666667,1191,0.22041666666666668,0.2833333333333333,0.49625
76,1131050,108,8,32,53,100,108,1.0,0.07407407407407407,0.9259259259259259,23,0.2962962962962963,0.49074074074074076,0.21296296296296297
77,1131051,252,37,34,43,215,252,1.0,0.14682539682539683,0.8531746031746031,175,0.1349206349206349,0.17063492063492064,0.6944444444444444
78,1131052,3579,562,1074,1015,3017,3579,1.0,0.15702710254260968,0.8429728974573903,1490,0.3000838222967309,0.2835987706063146,0.4163174070969545
79,1131054,1884,124,463,235,1760,1884,1.0,0.06581740976645435,0.9341825902335457,1186,0.24575371549893843,0.12473460721868365,0.6295116772823779
80,1131055,1133,185,223,125,948,1133,1.0,0.16328331862312445,0.8367166813768756,785,0.1968225948808473,0.11032656663724624,0.6928508384819064
81,1131056,1239,25,288,266,1214,1239,1.0,0.020177562550443905,0.9798224374495561,685,0.2324455205811138,0.21468926553672316,0.552865213882163
82,1131057,2437,203,523,378,2234,2437,1.0,0.08329913828477636,0.9167008617152236,1536,0.21460812474353713,0.15510874025441115,0.6302831350020517
83,1131058,2130,44,571,460,2086,2130,1.0,0.020657276995305163,0.9793427230046948,1099,0.268075117370892,0.215962441314554,0.515962441314554
84,1131059,2017,75,533,518,1942,2017,1.0,0.03718393653941497,0.962816063460585,966,0.26425384234010907,0.25681705503222607,0.47892910262766486
85,1131060,3889,132,1345,1350,3757,3889,1.0,0.033941887374646436,0.9660581126253536,1194,0.3458472615068141,0.34713293905888404,0.30701979943430185
86,1131061,1275,0,486,395,1275,1275,1.0,0.0,1.0,394,0.3811764705882353,0.30980392156862746,0.30901960784313726
87,1131062,48,0,12,8,48,48,1.0,0.0,1.0,28,0.25,0.16666666666666666,0.5833333333333334
88,1131063,1715,202,491,310,1513,1715,1.0,0.11778425655976676,0.8822157434402332,914,0.2862973760932945,0.18075801749271136,0.5329446064139942
89,1131064,275,124,65,16,151,275,1.0,0.4509090909090909,0.5490909090909091,194,0.23636363636363636,0.05818181818181818,0.7054545454545454
90,1131065A,3545,1469,1069,248,2076,3545,1.0,0.4143864598025388,0.5856135401974613,2228,0.30155148095909734,0.0699576868829337,0.628490832157969
93,1131067,9,1,5,1,8,9,1.0,0.1111111111111111,0.8888888888888888,3,0.5555555555555556,0.1111111111111111,0.3333333333333333
94,1131068,69,0,11,12,69,69,1.0,0.0,1.0,46,0.15942028985507245,0.17391304347826086,0.6666666666666666
95,1131069,55,1,22,6,54,55,1.0,0.01818181818181818,0.9818181818181818,27,0.4,0.10909090909090909,0.4909090909090909
96,1131070,2441,436,558,189,2005,2441,1.0,0.1786153215895125,0.8213846784104875,1694,0.22859483818107332,0.07742728390004097,0.6939778779188857
97,1131071A,3038,151,967,596,2887,3038,1.0,0.04970375246872943,0.9502962475312706,1475,0.3183015141540487,0.19618169848584596,0.48551678736010534
99,1131073,2955,428,804,282,2527,2955,1.0,0.14483925549915397,0.855160744500846,1869,0.2720812182741117,0.09543147208121827,0.63248730964467
100,1131074,1819,12,417,80,1807,1819,1.0,0.006597031335898846,0.9934029686641012,1322,0.22924683892248487,0.0439802089059923,0.7267729521715228
101,1131076,1698,66,685,520,1632,1698,1.0,0.038869257950530034,0.9611307420494699,493,0.4034157832744405,0.30624263839811544,0.29034157832744406
103,1131078,1974,1149,481,68,825,1974,1.0,0.5820668693009119,0.41793313069908816,1425,0.24366767983789261,0.034447821681864235,0.7218844984802432
104,1131079,2279,946,612,301,1333,2279,1.0,0.41509433962264153,0.5849056603773585,1366,0.2685388328214129,0.1320754716981132,0.5993856954804739
105,1131080,1706,1054,320,48,652,1706,1.0,0.6178194607268465,0.3821805392731536,1338,0.18757327080890973,0.02813599062133646,0.7842907385697538
106,1131081,3499,772,1022,667,2727,3499,1.0,0.22063446699056874,0.7793655330094312,1810,0.2920834524149757,0.1906258931123178,0.5172906544727065
107,1131082,555,217,72,17,338,555,1.0,0.390990990990991,0.609009009009009,466,0.12972972972972974,0.03063063063063063,0.8396396396396396
108,1131083,2043,35,540,172,2008,2043,1.0,0.017131669114047968,0.982868330885952,1331,0.2643171806167401,0.08418991678903573,0.6514929025942242
109,1131084,3444,1781,1539,435,1663,3444,1.0,0.5171312427409989,0.48286875725900114,1470,0.44686411149825783,0.12630662020905922,0.4268292682926829
110,1131085,1199,154,355,120,1045,1199,1.0,0.12844036697247707,0.8715596330275229,724,0.29608006672226855,0.10008340283569642,0.603836530442035
111,1131086,647,249,182,56,398,647,1.0,0.3848531684698609,0.615146831530139,409,0.28129829984544047,0.0865533230293663,0.6321483771251932
112,1131087A,4133,2384,1573,179,1749,4133,1.0,0.5768207113476893,0.4231792886523107,2381,0.3805952092910719,0.043309944350350835,0.5760948463585773
116,1131088,2885,816,634,194,2069,2885,1.0,0.282842287694974,0.717157712305026,2057,0.21975736568457538,0.06724436741767764,0.7129982668977469
117,1131089,2344,1645,970,72,699,2344,1.0,0.7017918088737202,0.2982081911262799,1302,0.4138225255972696,0.030716723549488054,0.5554607508532423
118,1131090,2378,945,968,168,1433,2378,1.0,0.3973927670311186,0.6026072329688814,1242,0.40706476030277544,0.07064760302775441,0.5222876366694701
119,1131091,2419,863,780,178,1556,2419,1.0,0.35675899131872674,0.6432410086812732,1461,0.3224472922695329,0.07358412567176519,0.603968582058702
120,1131092,3640,1643,1389,182,1997,3640,1.0,0.4513736263736264,0.5486263736263737,2069,0.38159340659340657,0.05,0.5684065934065934
121,1131093,1680,780,763,66,900,1680,1.0,0.4642857142857143,0.5357142857142857,851,0.45416666666666666,0.039285714285714285,0.506547619047619
122,1131094,1555,795,694,53,760,1555,1.0,0.5112540192926045,0.4887459807073955,808,0.44630225080385855,0.03408360128617363,0.5196141479099678
123,1131095,1629,414,591,81,1215,1629,1.0,0.2541436464088398,0.7458563535911602,957,0.36279926335174956,0.049723756906077346,0.5874769797421732
124,1131096,1425,260,475,93,1165,1425,1.0,0.1824561403508772,0.8175438596491228,857,0.3333333333333333,0.06526315789473684,0.6014035087719298
125,1131097,3018,814,1034,256,2204,3018,1.0,0.26971504307488403,0.730284956925116,1728,0.3426110006626905,0.08482438701126574,0.5725646123260437
126,1131098,2706,1041,887,105,1665,2706,1.0,0.38470066518847007,0.61529933481153,1714,0.32779009608277904,0.038802660753880266,0.6334072431633407
127,1131099,84,45,16,5,39,84,1.0,0.5357142857142857,0.4642857142857143,63,0.19047619047619047,0.05952380952380952,0.75
128,1131100,3254,1880,1429,86,1374,3254,1.0,0.5777504609711125,0.4222495390288875,1739,0.4391518131530424,0.02642901044867855,0.5344191763982791
129,1131101,2022,391,512,122,1631,2022,1.0,0.1933728981206726,0.8066271018793274,1388,0.2532146389713155,0.06033630069238378,0.6864490603363007
130,1131102,2495,755,579,179,1740,2495,1.0,0.3026052104208417,0.6973947895791583,1737,0.232064128256513,0.07174348697394789,0.696192384769539
131,1131103,545,104,159,40,441,545,1.0,0.1908256880733945,0.8091743119266055,346,0.29174311926605506,0.07339449541284404,0.634862385321101
132,1131104,2902,1460,1108,134,1442,2902,1.0,0.5031013094417643,0.4968986905582357,1660,0.3818056512749828,0.0461750516884907,0.5720192970365265
133,1131105,41,15,10,0,26,41,1.0,0.36585365853658536,0.6341463414634146,31,0.24390243902439024,0.0,0.7560975609756098
134,1131106,348,113,88,18,235,348,1.0,0.32471264367816094,0.6752873563218391,242,0.25287356321839083,0.05172413793103448,0.6954022988505747
135,1131107,995,304,247,70,691,995,1.0,0.3055276381909548,0.6944723618090453,678,0.24824120603015076,0.07035175879396985,0.6814070351758794
136,1131108,3221,1282,1030,171,1939,3221,1.0,0.3980130394287488,0.6019869605712511,2020,0.31977646693573425,0.05308910276311705,0.6271344303011487
137,1131109,928,105,130,48,823,928,1.0,0.11314655172413793,0.8868534482758621,750,0.1400862068965517,0.05172413793103448,0.8081896551724138
138,1131110,22,2,17,4,20,22,1.1666666666666667,0.09090909090909091,0.9090909090909091,1,0.7727272727272727,0.18181818181818182,0.045454545454545456
139,1131111,1737,572,377,103,1165,1737,1.0,0.32930339666090963,0.6706966033390904,1257,0.21704087507196315,0.059297639608520435,0.7236614853195165
140,1131112,699,261,191,11,438,699,1.0,0.37339055793991416,0.6266094420600858,497,0.2732474964234621,0.015736766809728183,0.7110157367668097
141,1131113,342,245,58,4,97,342,1.0,0.716374269005848,0.28362573099415206,280,0.1695906432748538,0.011695906432748537,0.8187134502923976
142,1131114,1308,874,359,13,434,1308,1.0,0.6681957186544343,0.3318042813455658,936,0.27446483180428133,0.009938837920489297,0.7155963302752294
143,1131115,1740,235,435,227,1505,1740,1.0,0.13505747126436782,0.8649425287356322,1078,0.25,0.13045977011494253,0.6195402298850575
144,1131116,1324,0,425,239,1324,1324,1.0,0.0,1.0,660,0.32099697885196377,0.18051359516616314,0.4984894259818731
145,1131117,2334,20,776,964,2314,2334,1.0,0.00856898029134533,0.9914310197086547,594,0.3324764353041988,0.4130248500428449,0.2544987146529563
146,1131118,1277,704,543,57,573,1277,1.0,0.5512920908379013,0.4487079091620987,677,0.42521534847298353,0.04463586530931871,0.5301487862176977
147,1131119,2086,1032,876,57,1054,2086,1.0,0.4947267497603068,0.5052732502396932,1153,0.4199424736337488,0.02732502396931927,0.552732502396932
148,1131120,1422,35,445,267,1387,1422,1.0,0.02461322081575246,0.9753867791842475,710,0.3129395218002813,0.1877637130801688,0.49929676511954996
149,1131121,2935,739,738,287,2196,2935,1.0,0.2517887563884157,0.7482112436115843,1910,0.2514480408858603,0.09778534923339012,0.6507666098807495
150,1131122,413,65,151,63,348,413,1.0,0.15738498789346247,0.8426150121065376,199,0.36561743341404357,0.15254237288135594,0.48184019370460046
151,1131124,21,4,2,0,17,21,1.0,0.19047619047619047,0.8095238095238095,19,0.09523809523809523,0.0,0.9047619047619048
152,1131125,3865,1460,667,350,2405,3865,1.0,0.3777490297542044,0.6222509702457956,2848,0.17257438551099613,0.09055627425614489,0.736869340232859
153,1131126,2315,1143,245,52,1172,2315,1.0,0.4937365010799136,0.5062634989200864,2018,0.10583153347732181,0.0224622030237581,0.8717062634989201
154,1131127,870,165,219,49,705,870,1.0,0.1896551724137931,0.8103448275862069,602,0.2517241379310345,0.05632183908045977,0.6919540229885057
155,1131128,566,0,102,447,566,566,1.0,0.0,1.0,17,0.18021201413427562,0.7897526501766784,0.030035335689045935
156,1131129,347,155,43,7,192,347,1.0,0.44668587896253603,0.553314121037464,297,0.1239193083573487,0.020172910662824207,0.8559077809798271
157,1131130,2033,392,407,128,1641,2033,1.0,0.1928184948352189,0.8071815051647812,1498,0.20019675356615838,0.06296114117068372,0.7368421052631579
158,1131131,2033,454,369,176,1579,2033,1.0,0.2233152975897688,0.7766847024102311,1488,0.18150516478111164,0.08657156910969012,0.7319232661091982
159,1131132,56,13,15,10,43,56,1.0,0.23214285714285715,0.7678571428571429,31,0.26785714285714285,0.17857142857142858,0.5535714285714286
160,1131133,340,50,121,87,290,340,1.0,0.14705882352941177,0.8529411764705882,132,0.3558823529411765,0.25588235294117645,0.38823529411764707
161,1131134,426,193,192,18,233,426,1.0,0.45305164319248825,0.5469483568075117,216,0.4507042253521127,0.04225352112676056,0.5070422535211268
162,1131135,1980,940,709,67,1040,1980,1.0,0.47474747474747475,0.5252525252525253,1204,0.35808080808080806,0.03383838383838384,0.6080808080808081
163,1131136,7,0,1,1,7,7,1.0,0.0,1.0,5,0.14285714285714285,0.14285714285714285,0.7142857142857143
164,1131137,24,0,16,7,24,24,1.0952380952380953,0.0,1.0,1,0.6666666666666666,0.2916666666666667,0.041666666666666664
165,1131138,378,211,0,0,167,378,1.0,0.5582010582010583,0.4417989417989418,378,0.0,0.0,1.0
166,1131139,3,0,2,1,3,3,3.0,0.0,1.0,0,0.6666666666666666,0.3333333333333333,0.0
168,1131300,3182,223,517,745,2959,3182,1.0,0.07008170961659334,0.9299182903834067,1920,0.1624764299182904,0.23412947831552483,0.6033940917661847
169,1131301,2550,664,682,739,1886,2550,1.0,0.2603921568627451,0.7396078431372549,1129,0.26745098039215687,0.28980392156862744,0.4427450980392157
170,1131302,3213,1253,743,535,1960,3213,1.0,0.3899782135076253,0.6100217864923747,1935,0.23124805477746654,0.16651104886399004,0.6022408963585434
171,1131303,412,148,46,2,264,412,1.0,0.3592233009708738,0.6407766990291263,364,0.11165048543689321,0.0048543689320388345,0.883495145631068
172,1131304,1716,170,388,463,1546,1716,1.0,0.09906759906759907,0.9009324009324009,865,0.2261072261072261,0.2698135198135198,0.504079254079254
173,1131305,1695,328,354,350,1367,1695,1.0,0.1935103244837758,0.8064896755162242,991,0.2088495575221239,0.20648967551622419,0.5846607669616519
174,1131307,262,186,85,4,76,262,1.0,0.7099236641221374,0.2900763358778626,173,0.3244274809160305,0.015267175572519083,0.6603053435114504
175,1131308A,2270,606,531,477,1664,2270,1.0,0.2669603524229075,0.7330396475770925,1262,0.23392070484581498,0.21013215859030837,0.5559471365638766
177,1131309,637,453,164,24,184,637,1.0,0.7111459968602826,0.28885400313971743,449,0.25745682888540034,0.03767660910518053,0.7048665620094191
178,1131310,5063,1948,654,798,3115,5063,1.0,0.3847521232470867,0.6152478767529133,3611,0.12917242741457635,0.15761406280861148,0.7132135097768122
179,1131311,2344,215,586,815,2129,2344,1.0,0.09172354948805461,0.9082764505119454,943,0.25,0.3476962457337884,0.4023037542662116
180,1131312,1255,370,230,283,885,1255,1.0,0.2948207171314741,0.7051792828685259,742,0.18326693227091634,0.2254980079681275,0.5912350597609561
181,1131313,217,84,155,39,133,217,1.0,0.3870967741935484,0.6129032258064516,23,0.7142857142857143,0.17972350230414746,0.10599078341013825
182,1131314,2508,928,729,411,1580,2508,1.0,0.3700159489633174,0.6299840510366826,1368,0.29066985645933013,0.1638755980861244,0.5454545454545454
183,1131315,49,0,4,4,49,49,1.0,0.0,1.0,41,0.08163265306122448,0.08163265306122448,0.8367346938775511
184,1131316,1355,400,279,125,955,1355,1.0,0.2952029520295203,0.7047970479704797,951,0.2059040590405904,0.09225092250922509,0.7018450184501845
186,1131500,2748,525,685,505,2223,2748,1.0,0.19104803493449782,0.8089519650655022,1558,0.2492721979621543,0.18377001455604075,0.5669577874818049
187,1131501,2444,454,597,686,1990,2444,1.0,0.18576104746317512,0.8142389525368249,1161,0.24427168576104746,0.2806873977086743,0.47504091653027825
188,1131502,4302,730,971,804,3572,4302,1.0,0.1696885169688517,0.8303114830311483,2527,0.22570897257089725,0.18688981868898186,0.5874012087401209
189,1131503,3069,721,734,438,2348,3069,1.0,0.23492994460736397,0.7650700553926361,1897,0.23916585206907787,0.14271749755620725,0.6181166503747149
190,1131504,2522,514,594,771,2008,2522,1.0,0.20380650277557494,0.796193497224425,1157,0.23552735923869944,0.30570975416336243,0.4587628865979381
191,1131700,2947,414,514,411,2533,2947,1.0,0.14048184594502885,0.8595181540549711,2022,0.17441465897522904,0.13946386155412283,0.6861214794706482
192,1131701,2649,149,434,473,2500,2649,1.0,0.05624764061910155,0.9437523593808984,1742,0.16383540958852397,0.178557946394866,0.6576066440166101
193,1131702,3547,456,681,640,3091,3547,1.0,0.12855934592613477,0.8714406540738653,2226,0.19199323371863547,0.18043416972089088,0.6275725965604736
194,1131703,3439,305,750,536,3134,3439,1.0,0.08868857225937772,0.9113114277406222,2153,0.21808665309683048,0.1558592614132015,0.626054085489968
195,1131704,1304,190,384,321,1114,1304,1.0,0.14570552147239263,0.8542944785276073,599,0.294478527607362,0.24616564417177914,0.4593558282208589
196,1131705,2410,379,577,491,2031,2410,1.0,0.15726141078838174,0.8427385892116183,1342,0.23941908713692947,0.2037344398340249,0.5568464730290457
197,1131706,3519,339,735,547,3180,3519,1.0,0.09633418584825235,0.9036658141517476,2237,0.20886615515771526,0.1554418868996874,0.6356919579425974
198,1131707,1455,450,124,59,1005,1455,1.0,0.30927835051546393,0.6907216494845361,1272,0.0852233676975945,0.04054982817869416,0.8742268041237113
199,1131708,803,140,129,137,663,803,1.0,0.17434620174346202,0.825653798256538,537,0.16064757160647572,0.1706102117061021,0.6687422166874222
200,1131709,3831,1294,1203,389,2537,3831,1.0,0.3377708170190551,0.6622291829809449,2239,0.3140172278778387,0.10154006786739754,0.5844427042547637
201,1131710,1563,475,680,72,1088,1563,1.0,0.3039027511196417,0.6960972488803583,811,0.4350607805502239,0.046065259117082535,0.5188739603326935
202,1131711,2825,310,506,405,2515,2825,1.0,0.10973451327433628,0.8902654867256637,1914,0.1791150442477876,0.1433628318584071,0.6775221238938053
203,1131713,1206,14,183,336,1192,1206,1.0,0.011608623548922056,0.988391376451078,687,0.1517412935323383,0.27860696517412936,0.5696517412935324
204,1131714,2245,196,411,558,2049,2245,1.0,0.08730512249443208,0.9126948775055679,1276,0.18307349665924277,0.2485523385300668,0.5683741648106905
205,1131715,1709,125,342,241,1584,1709,1.0,0.07314218841427736,0.9268578115857227,1126,0.20011702750146285,0.14101813926272674,0.6588648332358105
206,1131716,2399,120,458,1069,2279,2399,1.0,0.0500208420175073,0.9499791579824927,872,0.1909128803668195,0.4456023343059608,0.3634847853272197
207,1131717,3815,930,931,762,2885,3815,1.0,0.2437745740498034,0.7562254259501966,2122,0.24403669724770644,0.19973787680209698,0.5562254259501966
208,1131718,1908,144,306,592,1764,1908,1.0,0.07547169811320754,0.9245283018867925,1010,0.16037735849056603,0.31027253668763105,0.5293501048218029
209,1131719,3155,689,833,621,2466,3155,1.0,0.21838351822503962,0.7816164817749603,1701,0.2640253565768621,0.19683042789223454,0.5391442155309033
210,1131720,3144,379,747,853,2765,3144,1.0,0.1205470737913486,0.8794529262086515,1544,0.23759541984732824,0.27131043256997456,0.4910941475826972
211,1131721,2543,685,492,804,1858,2543,1.0,0.26936688950058985,0.7306331104994102,1247,0.19347227683837986,0.3161620133700354,0.4903657097915847
212,1131722,3737,1235,909,490,2502,3737,1.0,0.33047899384533047,0.6695210061546695,2338,0.24324324324324326,0.13112122023013112,0.6256355365266256
213,1131723,304,168,79,25,136,304,1.0,0.5526315789473685,0.4473684210526316,200,0.2598684210526316,0.08223684210526316,0.6578947368421053
214,1131724,99,8,45,11,91,99,1.0,0.08080808080808081,0.9191919191919192,43,0.45454545454545453,0.1111111111111111,0.43434343434343436
215,1131725,471,74,96,235,397,471,1.0,0.15711252653927812,0.8428874734607219,140,0.20382165605095542,0.4989384288747346,0.29723991507430997
216,1131726,2384,169,426,600,2215,2384,1.0,0.07088926174496644,0.9291107382550335,1358,0.17869127516778524,0.2516778523489933,0.5696308724832215
217,1131727,236,4,58,56,232,236,1.0,0.01694915254237288,0.9830508474576272,122,0.2457627118644068,0.23728813559322035,0.5169491525423728
218,1131728,1674,190,314,411,1484,1674,1.0,0.1135005973715651,0.8864994026284349,949,0.1875746714456392,0.24551971326164876,0.5669056152927121
219,1131729,1915,610,413,287,1305,1915,1.0,0.3185378590078329,0.6814621409921671,1215,0.21566579634464753,0.14986945169712793,0.6344647519582245
222,1132000,19,5,0,2,14,19,1.0,0.2631578947368421,0.7368421052631579,17,0.0,0.10526315789473684,0.8947368421052632
223,1132001,40,2,7,7,38,40,1.0,0.05,0.95,26,0.175,0.175,0.65
224,1132002,1302,80,349,475,1222,1302,1.0,0.06144393241167435,0.9385560675883257,478,0.26804915514592936,0.36482334869431643,0.3671274961597542
225,1132003,2512,173,707,1217,2339,2512,1.0,0.06886942675159236,0.9311305732484076,588,0.28144904458598724,0.48447452229299365,0.2340764331210191
226,1132004,1868,57,476,935,1811,1868,1.0,0.030513918629550323,0.9694860813704497,457,0.25481798715203424,0.5005353319057816,0.24464668094218414
227,1132005,820,45,285,390,775,820,1.0,0.054878048780487805,0.9451219512195121,145,0.3475609756097561,0.47560975609756095,0.17682926829268292
228,1132006,1397,34,397,695,1363,1397,1.0,0.024337866857551897,0.9756621331424481,305,0.28418038654259126,0.49749463135289906,0.21832498210450965
229,1132007,2665,48,588,1545,2617,2665,1.0,0.01801125703564728,0.9819887429643527,532,0.22063789868667918,0.5797373358348968,0.199624765478424
230,1132008,1138,0,312,826,1138,1138,1.0655430711610487,0.0,1.0,0,0.2741652021089631,0.7258347978910369,0.0
231,1132009,1940,22,589,808,1918,1940,1.0,0.01134020618556701,0.988659793814433,543,0.3036082474226804,0.41649484536082476,0.27989690721649485
232,1132010,1322,62,361,627,1260,1322,1.0,0.046898638426626324,0.9531013615733737,334,0.273071104387292,0.4742813918305598,0.2526475037821483
233,1132011,1910,52,437,1040,1858,1910,1.0,0.027225130890052355,0.9727748691099476,433,0.22879581151832462,0.5445026178010471,0.22670157068062827
234,1132012,1575,0,474,665,1575,1575,1.0,0.0,1.0,436,0.30095238095238097,0.4222222222222222,0.2768253968253968
235,1132013,1084,0,226,671,1084,1084,1.0,0.0,1.0,187,0.20848708487084872,0.6190036900369004,0.17250922509225092
236,1132014,433,0,90,313,433,433,1.0,0.0,1.0,30,0.20785219399538107,0.7228637413394919,0.06928406466512702
237,1132015,1430,208,292,401,1222,1430,1.0,0.14545454545454545,0.8545454545454545,737,0.2041958041958042,0.2804195804195804,0.5153846153846153
238,1132016,3711,99,642,1790,3612,3711,1.0,0.02667744543249798,0.973322554567502,1279,0.17299919159256266,0.4823497709512261,0.3446510374562113
239,1132017,1836,210,401,339,1626,1836,1.0,0.11437908496732026,0.8856209150326797,1096,0.21840958605664487,0.184640522875817,0.5969498910675382
240,1132018,848,15,171,427,833,848,1.0,0.01768867924528302,0.9823113207547169,250,0.2016509433962264,0.5035377358490566,0.294811320754717
241,1132019,1481,3,392,855,1478,1481,1.0,0.002025658338960162,0.9979743416610398,234,0.2646860229574612,0.5773126266036462,0.15800135043889263
242,1132020,3063,279,737,930,2784,3063,1.0,0.0910871694417238,0.9089128305582762,1396,0.2406137773424747,0.3036238981390793,0.45576232451844595
243,1132021,3319,0,674,1933,3319,3319,1.0,0.0,1.0,712,0.2030732148237421,0.5824043386562218,0.21452244652003616
244,1132022,770,9,192,350,761,770,1.0,0.011688311688311689,0.9883116883116884,228,0.24935064935064935,0.45454545454545453,0.2961038961038961
245,1132023,1301,164,317,483,1137,1301,1.0,0.12605687932359724,0.8739431206764028,501,0.2436587240584166,0.3712528823981553,0.3850883935434281
246,1132024,1359,64,334,530,1295,1359,1.0,0.047093451066961,0.9529065489330389,495,0.2457689477557027,0.3899926416482708,0.36423841059602646
247,1132025,2109,0,515,1464,2109,2109,1.0,0.0,1.0,130,0.24419155998103367,0.6941678520625889,0.06164058795637743
248,1132026,2762,7,473,1488,2755,2762,1.0,0.0025343953656770456,0.997465604634323,801,0.1712527154236061,0.5387400434467777,0.29000724112961623
249,1132027,1502,6,297,936,1496,1502,1.0,0.0039946737683089215,0.996005326231691,269,0.1977363515312916,0.6231691078561917,0.17909454061251665
250,1132029,1320,3,263,902,1317,1320,1.0,0.0022727272727272726,0.9977272727272727,155,0.19924242424242425,0.6833333333333333,0.11742424242424243
251,1132030,1764,20,233,1186,1744,1764,1.0,0.011337868480725623,0.9886621315192744,345,0.1320861678004535,0.6723356009070295,0.195578231292517
252,1132031,4618,275,905,896,4343,4618,1.0,0.059549588566478996,0.940450411433521,2817,0.1959722823733218,0.19402338674750974,0.6100043308791685
253,1132032,2460,180,599,573,2280,2460,1.0,0.07317073170731707,0.926829268292683,1288,0.2434959349593496,0.2329268292682927,0.5235772357723577
254,1132033,2358,170,466,353,2188,2358,1.0,0.0720949957591179,0.9279050042408821,1539,0.19762510602205258,0.14970313825275658,0.6526717557251909
255,1132034,1649,25,300,731,1624,1649,1.0,0.015160703456640388,0.9848392965433597,618,0.18192844147968465,0.44329896907216493,0.3747725894481504
256,1132035,2295,180,407,343,2115,2295,1.0,0.0784313725490196,0.9215686274509803,1545,0.17734204793028321,0.1494553376906318,0.673202614379085
257,1132036,2450,15,532,1061,2435,2450,1.0,0.006122448979591836,0.9938775510204082,857,0.21714285714285714,0.4330612244897959,0.3497959183673469
258,1132037,1140,20,205,246,1120,1140,1.0,0.017543859649122806,0.9824561403508771,689,0.17982456140350878,0.21578947368421053,0.6043859649122807
259,1132038,3300,55,965,1055,3245,3300,1.0,0.016666666666666666,0.9833333333333333,1280,0.2924242424242424,0.3196969696969697,0.3878787878787879
260,1132039,3065,64,813,852,3001,3065,1.0,0.020880913539967374,0.9791190864600327,1400,0.265252854812398,0.27797716150081564,0.4567699836867863
261,1132040,1455,0,434,682,1455,1455,1.0,0.0,1.0,339,0.29828178694158075,0.46872852233676976,0.2329896907216495
262,1132041,4769,465,849,1926,4304,4769,1.0,0.09750471797022436,0.9024952820297756,1994,0.17802474313273223,0.4038582512057035,0.4181170056615643
263,1132042,2879,80,881,1285,2799,2879,1.0,0.027787426189649182,0.9722125738103509,713,0.3060090309135116,0.44633553317124003,0.24765543591524836
264,1132043,1890,17,573,896,1873,1890,1.0,0.008994708994708995,0.991005291005291,421,0.30317460317460315,0.4740740740740741,0.22275132275132276
265,1132044,909,44,305,408,865,909,1.0,0.0484048404840484,0.9515951595159516,196,0.3355335533553355,0.44884488448844884,0.2156215621562156
266,1132045,2070,161,576,719,1909,2070,1.0,0.07777777777777778,0.9222222222222223,775,0.2782608695652174,0.3473429951690821,0.3743961352657005
267,1132046,1597,23,456,845,1574,1597,1.0,0.014402003757044458,0.9855979962429555,296,0.2855353788353162,0.5291170945522855,0.18534752661239826
268,1132047,2661,25,603,1040,2636,2661,1.0,0.009394964299135663,0.9906050357008643,1018,0.2266065388951522,0.3908305148440436,0.3825629462608042
269,1132048,4414,1070,982,883,3344,4414,1.0,0.24241051200724967,0.7575894879927504,2549,0.22247394653375624,0.20004531037607612,0.5774807430901676
270,1132049,1848,411,456,621,1437,1848,1.0,0.2224025974025974,0.7775974025974026,771,0.24675324675324675,0.336038961038961,0.4172077922077922
271,1132050,1816,263,476,656,1553,1816,1.0,0.1448237885462555,0.8551762114537445,684,0.2621145374449339,0.36123348017621143,0.3766519823788546
272,1132051,2428,100,582,1142,2328,2428,1.0,0.04118616144975288,0.9588138385502472,704,0.2397034596375618,0.47034596375617793,0.2899505766062603
273,1132052,1119,19,258,758,1100,1119,1.0,0.016979445933869526,0.9830205540661304,103,0.23056300268096513,0.677390527256479,0.09204647006255585
274,1132053,3204,770,683,469,2434,3204,1.0,0.24032459425717853,0.7596754057428214,2052,0.21317103620474406,0.14637952559300874,0.6404494382022472
275,1132054,4243,1029,960,472,3214,4243,1.0,0.2425170869667688,0.7574829130332312,2811,0.2262550082488805,0.11124204572236625,0.6625029460287533
276,1132055,2795,895,446,229,1900,2795,1.0,0.32021466905187834,0.6797853309481217,2120,0.1595706618962433,0.08193202146690519,0.7584973166368515
277,1132056,1354,2,259,667,1352,1354,1.0,0.0014771048744460858,0.9985228951255539,428,0.1912850812407681,0.49261447562776955,0.31610044313146235
278,1132057,463,13,95,276,450,463,1.0,0.028077753779697623,0.9719222462203023,92,0.20518358531317496,0.5961123110151187,0.19870410367170627
279,1132058,1207,71,279,402,1136,1207,1.0,0.058823529411764705,0.9411764705882353,526,0.2311516155758078,0.33305716652858325,0.43579121789560893
280,1132059,1205,122,261,619,1083,1205,1.0,0.1012448132780083,0.8987551867219917,325,0.216597510373444,0.5136929460580912,0.2697095435684647
281,1132060,2819,360,587,1288,2459,2819,1.0,0.12770485987938984,0.8722951401206102,944,0.2082298687477829,0.45689960979070593,0.3348705214615112
282,1132061,3194,410,698,1294,2784,3194,1.0,0.12836568566061365,0.8716343143393863,1202,0.2185347526612398,0.40513462742642453,0.37633061991233563
283,1132062,2015,1,480,827,2014,2015,1.0,0.0004962779156327543,0.9995037220843672,708,0.23821339950372208,0.4104218362282878,0.35136476426799007
284,1132063,589,20,150,376,569,589,1.0,0.03395585738539898,0.966044142614601,63,0.2546689303904924,0.6383701188455009,0.10696095076400679
285,1132064,1862,157,603,695,1705,1862,1.0,0.08431793770139635,0.9156820622986036,564,0.3238453276047261,0.3732545649838883,0.3029001074113856
286,1132065,2935,269,802,785,2666,2935,1.0,0.09165247018739353,0.9083475298126065,1348,0.27325383304940376,0.2674616695059625,0.45928449744463373
287,1132066,1614,109,342,718,1505,1614,1.0,0.06753407682775713,0.9324659231722429,554,0.21189591078066913,0.4448574969021066,0.34324659231722426
288,1132067,1249,10,323,472,1239,1249,1.0,0.008006405124099279,0.9919935948759008,454,0.2586068855084067,0.377902321857486,0.3634907926341073
289,1132068,2509,199,747,761,2310,2509,1.0,0.07931446791550419,0.9206855320844958,1001,0.2977281785571941,0.3033080908728577,0.39896373056994816
290,1132069,2885,42,847,1227,2843,2885,1.0,0.014558058925476604,0.9854419410745234,811,0.29358752166377816,0.42530329289428076,0.2811091854419411
291,1132070,1590,13,354,604,1577,1590,1.0,0.008176100628930818,0.9918238993710692,632,0.22264150943396227,0.379874213836478,0.39748427672955977
292,1132071,1574,38,548,887,1536,1574,1.0,0.0241423125794155,0.9758576874205845,139,0.34815756035578144,0.5635324015247777,0.08831003811944091
293,1132072,2916,141,872,1085,2775,2916,1.0,0.04835390946502058,0.9516460905349794,959,0.299039780521262,0.3720850480109739,0.32887517146776407
294,1132073,893,0,373,336,893,893,1.0,0.0,1.0,184,0.4176931690929451,0.3762597984322508,0.20604703247480402
296,1132076,5,0,0,5,5,5,1.6666666666666667,0.0,1.0,0,0.0,1.0,0.0
297,1132077,1329,121,348,557,1208,1329,1.0,0.09104589917231001,0.90895410082769,424,0.2618510158013544,0.41911211437170803,0.3190368698269376
298,1132078,107,4,0,0,103,107,1.0,0.037383177570093455,0.9626168224299065,107,0.0,0.0,1.0
299,1132079,2692,981,562,238,1711,2692,1.0,0.36441307578008914,0.6355869242199108,1892,0.2087667161961367,0.08841010401188708,0.7028231797919762
300,1132200,1936,0,252,1127,1936,1936,1.0,0.0,1.0,557,0.13016528925619836,0.5821280991735537,0.28770661157024796
301,1132201,1683,9,237,1077,1674,1683,1.0,0.0053475935828877,0.9946524064171123,369,0.1408199643493761,0.6399286987522281,0.2192513368983957
302,1132202,1696,0,278,1125,1696,1696,1.0,0.0,1.0,293,0.16391509433962265,0.6633254716981132,0.17275943396226415
303,1132203,1332,0,274,919,1332,1332,1.0,0.0,1.0,139,0.2057057057057057,0.68993993993994,0.10435435435435435
304,1132220,1662,0,166,1170,1662,1662,1.0,0.0,1.0,326,0.09987966305655836,0.703971119133574,0.19614921780986763
305,1132221,2922,0,390,2209,2922,2922,1.0,0.0,1.0,323,0.13347022587268995,0.7559890485968515,0.11054072553045859
306,1132222,2628,0,322,1915,2628,2628,1.0,0.0,1.0,391,0.12252663622526636,0.7286910197869102,0.14878234398782345
307,1132223,1605,9,314,776,1596,1605,1.0,0.005607476635514018,0.994392523364486,515,0.1956386292834891,0.4834890965732087,0.32087227414330216
308,1132224,4120,155,295,611,3965,4120,1.0,0.03762135922330097,0.962378640776699,3214,0.07160194174757281,0.1483009708737864,0.7800970873786408
309,1132225,1659,0,220,970,1659,1659,1.0,0.0,1.0,469,0.13261000602772754,0.5846895720313442,0.28270042194092826
310,1132226,2757,0,395,1645,2757,2757,1.0,0.0,1.0,717,0.14327167210736308,0.5966630395357272,0.2600652883569097
311,1132300,1478,14,354,340,1464,1478,1.0,0.009472259810554804,0.9905277401894452,784,0.2395128552097429,0.23004059539918809,0.530446549391069
312,1132301,3148,135,496,1135,3013,3148,1.0,0.042884371029224905,0.9571156289707751,1517,0.15756035578144853,0.36054637865311306,0.4818932655654384
313,1132302,1861,42,403,211,1819,1861,1.0,0.022568511552928532,0.9774314884470715,1247,0.21655024180548094,0.11337990327780763,0.6700698549167114
314,1132303,2984,55,583,829,2929,2984,1.0,0.018431635388739945,0.9815683646112601,1572,0.19537533512064342,0.27781501340482573,0.5268096514745308
315,1132305,4789,514,812,1082,4275,4789,1.0,0.10732929630403007,0.8926707036959699,2895,0.16955523073710588,0.22593443307579872,0.6045103361870954
316,1132306,1444,0,295,474,1444,1444,1.0,0.0,1.0,675,0.20429362880886426,0.32825484764542934,0.46745152354570635
317,1132307,1165,100,197,247,1065,1165,1.0,0.08583690987124463,0.9141630901287554,721,0.16909871244635194,0.21201716738197424,0.6188841201716738
319,1132309,1275,425,91,79,850,1275,1.0,0.3333333333333333,0.6666666666666666,1105,0.07137254901960784,0.06196078431372549,0.8666666666666667
320,1132310,2658,110,480,834,2548,2658,1.0,0.04138449962377728,0.9586155003762227,1344,0.18058690744920994,0.31376975169300225,0.5056433408577878
321,1132311,1051,115,120,86,936,1051,1.0,0.10941960038058991,0.89058039961941,845,0.11417697431018078,0.0818268315889629,0.8039961941008563
322,1132312,300,8,7,10,292,300,1.0,0.02666666666666667,0.9733333333333334,283,0.023333333333333334,0.03333333333333333,0.9433333333333334
323,1132400,87,0,24,63,87,87,1.4745762711864407,0.0,1.0,0,0.27586206896551724,0.7241379310344828,0.0
324,1132401,3515,273,838,1288,3242,3515,1.0,0.07766714082503556,0.9223328591749644,1389,0.2384068278805121,0.36642958748221904,0.39516358463726886
325,1132402,3804,465,773,883,3339,3804,1.0,0.1222397476340694,0.8777602523659306,2148,0.20320715036803366,0.23212407991587802,0.5646687697160884
327,1132404,2134,124,503,520,2010,2134,1.0,0.05810684161199625,0.9418931583880038,1111,0.23570759137769448,0.2436738519212746,0.520618556701031
328,1132405,3898,307,772,1427,3591,3898,1.0,0.07875833760903027,0.9212416623909697,1699,0.19805028219599793,0.3660851718830169,0.4358645459209851
329,1132406,4037,807,894,884,3230,4037,1.0,0.19990091652216993,0.8000990834778301,2259,0.22145157295021056,0.21897448600445876,0.5595739410453306
330,1132407,4438,405,890,1102,4033,4438,1.0,0.09125732311852186,0.9087426768814781,2446,0.20054078413699863,0.24831004957187922,0.5511491662911221
331,1132408,2100,137,266,269,1963,2100,1.0,0.06523809523809523,0.9347619047619048,1565,0.12666666666666668,0.1280952380952381,0.7452380952380953
332,1132409,2737,121,504,422,2616,2737,1.0,0.04420898794300329,0.9557910120569967,1811,0.18414322250639387,0.15418341249543296,0.6616733649981732
333,1132410,2387,626,486,410,1761,2387,1.0,0.26225387515710097,0.737746124842899,1491,0.2036028487641391,0.17176372015081692,0.624633431085044
334,1132411,777,53,173,87,724,777,1.0,0.0682110682110682,0.9317889317889317,517,0.22265122265122264,0.11196911196911197,0.6653796653796654
335,1132500,3913,135,569,730,3778,3913,1.0,0.03450038333759264,0.9654996166624074,2614,0.14541272680807565,0.18655762841809354,0.6680296447738309
336,1132501,1521,30,304,701,1491,1521,1.0,0.01972386587771203,0.980276134122288,516,0.19986850756081526,0.4608809993425378,0.33925049309664695
337,1132502,1527,40,302,1035,1487,1527,1.0,0.02619515389652914,0.9738048461034708,190,0.19777341191879502,0.6777996070726916,0.12442698100851342
338,1132503,2734,176,554,1405,2558,2734,1.0,0.06437454279444038,0.9356254572055597,775,0.20263350402340893,0.513899049012436,0.2834674469641551
339,1132504,1431,65,301,576,1366,1431,1.0,0.045422781271837874,0.9545772187281621,554,0.2103424178895877,0.4025157232704403,0.38714185883997204
340,1132505,3298,283,777,910,3015,3298,1.0,0.0858095815645846,0.9141904184354154,1611,0.23559733171619163,0.2759248029108551,0.4884778653729533
341,1132506,2600,299,484,966,2301,2600,1.0,0.115,0.885,1150,0.18615384615384614,0.37153846153846154,0.4423076923076923
342,1132507,2077,35,489,933,2042,2077,1.0,0.016851227732306212,0.9831487722676938,655,0.2354357246027925,0.4492055849783341,0.3153586904188734
343,1132508,3480,453,670,689,3027,3480,1.0,0.13017241379310346,0.8698275862068966,2121,0.1925287356321839,0.19798850574712643,0.6094827586206897
344,1132509,3105,65,710,1310,3040,3105,1.0,0.020933977455716585,0.9790660225442834,1085,0.2286634460547504,0.4219001610305958,0.3494363929146538
345,1132510,2064,160,479,619,1904,2064,1.0,0.07751937984496124,0.9224806201550387,966,0.2320736434108527,0.2999031007751938,0.4680232558139535
346,1132511,2325,240,498,773,2085,2325,1.0,0.1032258064516129,0.896774193548387,1054,0.21419354838709678,0.3324731182795699,0.4533333333333333
347,1132512,1519,80,358,568,1439,1519,1.0,0.052666227781435156,0.9473337722185649,593,0.23568136932192232,0.3739302172481896,0.39038841342988806
348,1132513,3169,650,832,821,2519,3169,1.0,0.20511202272010098,0.794887977279899,1516,0.26254338908172925,0.2590722625433891,0.47838434837488164
349,1132514,3435,255,738,1043,3180,3435,1.0,0.07423580786026202,0.925764192139738,1654,0.21484716157205241,0.3036390101892285,0.4815138282387191
350,1132601,3008,626,716,508,2382,3008,1.0,0.2081117021276596,0.7918882978723404,1784,0.23803191489361702,0.16888297872340424,0.5930851063829787
351,1132602,3196,809,927,737,2387,3196,1.0,0.25312891113892366,0.7468710888610763,1532,0.2900500625782228,0.23060075093867335,0.4793491864831039
352,1132603,3630,802,966,740,2828,3630,1.0,0.2209366391184573,0.7790633608815427,1924,0.26611570247933886,0.20385674931129477,0.5300275482093664
353,1132604,3268,685,969,701,2583,3268,1.0,0.20960832313341493,0.7903916768665851,1598,0.29651162790697677,0.21450428396572827,0.488984088127295
354,1132605,2309,315,643,396,1994,2309,1.0,0.1364226938068428,0.8635773061931572,1270,0.27847553053269813,0.1715028150714595,0.5500216543958424
356,1132700,3769,523,852,956,3246,3769,1.0,0.13876359777129213,0.8612364022287079,1961,0.22605465640753516,0.2536481825417883,0.5202971610506766
357,1132701,3380,229,775,1390,3151,3380,1.0,0.06775147928994082,0.9322485207100591,1215,0.22928994082840237,0.41124260355029585,0.3594674556213018
358,1132702,4221,342,828,2275,3879,4221,1.0,0.08102345415778252,0.9189765458422174,1118,0.19616204690831557,0.538971807628524,0.2648661454631604
359,1132703,2160,126,302,247,2034,2160,1.0,0.058333333333333334,0.9416666666666667,1611,0.1398148148148148,0.11435185185185186,0.7458333333333333
360,1132704,3882,935,987,793,2947,3882,1.0,0.24085522926326636,0.7591447707367336,2102,0.2542503863987635,0.20427614631633179,0.5414734672849046
361,1132705,2484,420,596,488,2064,2484,1.0,0.16908212560386474,0.8309178743961353,1400,0.23993558776167473,0.1964573268921095,0.5636070853462157
362,1132706,3450,334,640,1049,3116,3450,1.0,0.09681159420289855,0.9031884057971015,1761,0.1855072463768116,0.3040579710144928,0.5104347826086957
363,1132707,4059,608,865,897,3451,4059,1.0,0.14979058881497906,0.8502094111850209,2297,0.21310667652131066,0.22099039172209903,0.5659029317565903
364,1132708,5052,597,990,1641,4455,5052,1.0,0.11817102137767221,0.8818289786223278,2421,0.19596199524940616,0.3248218527315915,0.47921615201900236
365,1132709,1540,177,298,544,1363,1540,1.0,0.11493506493506493,0.8850649350649351,698,0.19350649350649352,0.35324675324675325,0.45324675324675323
366,1132710,3308,342,656,718,2966,3308,1.0,0.1033857315598549,0.8966142684401451,1934,0.19830713422007254,0.21704957678355502,0.5846432889963724
367,1132711,2775,235,627,695,2540,2775,1.0,0.08468468468468468,0.9153153153153153,1453,0.22594594594594594,0.25045045045045045,0.5236036036036036
368,1132712,4358,799,1093,984,3559,4358,1.0,0.1833409821018816,0.8166590178981185,2281,0.2508031206975677,0.2257916475447453,0.523405231757687
369,1132713,1654,254,262,920,1400,1654,1.0,0.15356711003627568,0.8464328899637243,472,0.15840386940749698,0.5562273276904474,0.28536880290205563
370,1132714,4655,1321,1189,1102,3334,4655,1.0,0.283780880773362,0.7162191192266381,2364,0.2554242749731472,0.23673469387755103,0.5078410311493018
371,1132715,3024,370,850,858,2654,3024,1.0,0.12235449735449735,0.8776455026455027,1316,0.2810846560846561,0.2837301587301587,0.4351851851851852
372,1132716,1925,355,448,350,1570,1925,1.0,0.18441558441558442,0.8155844155844156,1127,0.23272727272727273,0.18181818181818182,0.5854545454545454
374,1132801,3240,166,615,1496,3074,3240,1.0,0.05123456790123457,0.9487654320987654,1129,0.18981481481481483,0.4617283950617284,0.3484567901234568
375,1132802,3878,132,679,1769,3746,3878,1.0,0.03403816400206292,0.9659618359979371,1430,0.17509025270758122,0.45616297060340383,0.36874677668901495
376,1132803,1274,10,220,747,1264,1274,1.0,0.007849293563579277,0.9921507064364207,307,0.1726844583987441,0.5863422291993721,0.24097331240188383
377,1132804,2385,120,483,1167,2265,2385,1.0,0.050314465408805034,0.949685534591195,735,0.20251572327044026,0.48930817610062893,0.3081761006289308
378,1132805,3762,117,787,1841,3645,3762,1.0,0.03110047846889952,0.9688995215311005,1134,0.209197235513025,0.4893673577884104,0.3014354066985646
379,1132806,2706,252,543,1127,2454,2706,1.0,0.09312638580931264,0.9068736141906873,1036,0.2006651884700665,0.4164818920916482,0.3828529194382853
380,1132807A,2345,30,521,1066,2315,2345,1.0,0.01279317697228145,0.9872068230277186,758,0.22217484008528784,0.45458422174840085,0.3232409381663113
382,1132808,2615,233,504,1229,2382,2615,1.0,0.08910133843212237,0.9108986615678776,882,0.1927342256214149,0.469980879541109,0.3372848948374761
383,1132809,3190,185,745,1001,3005,3190,1.0,0.05799373040752351,0.9420062695924765,1444,0.2335423197492163,0.3137931034482759,0.4526645768025078
384,1132810A,19,1,1,8,18,19,1.0,0.05263157894736842,0.9473684210526315,10,0.05263157894736842,0.42105263157894735,0.5263157894736842
386,1132900,2881,260,722,1181,2621,2881,1.0,0.09024644220756682,0.9097535577924332,978,0.25060742797639707,0.4099271086428323,0.33946546338077055
387,1132901,2355,405,314,170,1950,2355,1.0,0.17197452229299362,0.8280254777070064,1871,0.13333333333333333,0.07218683651804671,0.79447983014862
388,1132902,2639,349,588,414,2290,2639,1.0,0.13224706328154603,0.867752936718454,1637,0.22281167108753316,0.15687760515346721,0.6203107237589996
389,1132903,3121,319,444,607,2802,3121,1.0,0.10221082986222364,0.8977891701377764,2070,0.14226209548221724,0.19448894585068888,0.6632489586670939
390,1132904,89,28,5,4,61,89,1.0,0.3146067415730337,0.6853932584269663,80,0.056179775280898875,0.0449438202247191,0.898876404494382
391,1132905,382,47,97,284,335,382,1.0269541778975741,0.12303664921465969,0.8769633507853403,1,0.25392670157068065,0.743455497382199,0.002617801047120419
392,1132910,73,6,6,16,67,73,1.0,0.0821917808219178,0.9178082191780822,51,0.0821917808219178,0.2191780821917808,0.6986301369863014
393,1132911,504,80,78,112,424,504,1.0,0.15873015873015872,0.8412698412698413,314,0.15476190476190477,0.2222222222222222,0.623015873015873
394,1132920,4325,794,668,1051,3531,4325,1.0,0.18358381502890173,0.8164161849710982,2606,0.15445086705202313,0.2430057803468208,0.6025433526011561
395,1132921,4685,637,888,1576,4048,4685,1.0,0.135965848452508,0.864034151547492,2221,0.1895410885805763,0.33639274279615794,0.4740661686232657
396,1132922,6828,1128,1254,1782,5700,6828,1.0,0.16520210896309315,0.8347978910369068,3792,0.18365553602811951,0.2609841827768014,0.5553602811950791
397,1132923,3835,605,868,1249,3230,3835,1.0,0.1577574967405476,0.8422425032594524,1718,0.22633637548891786,0.3256844850065189,0.44797913950456325
398,1132924,2928,721,492,585,2207,2928,1.0,0.2462431693989071,0.7537568306010929,1851,0.1680327868852459,0.19979508196721313,0.632172131147541
399,1132925,3320,115,604,1479,3205,3320,1.0,0.03463855421686747,0.9653614457831325,1237,0.1819277108433735,0.4454819277108434,0.3725903614457831
400,1132926,2819,520,457,671,2299,2819,1.0,0.1844625753813409,0.8155374246186591,1691,0.16211422490244767,0.2380276693863072,0.5998581057112451
401,1132927,5104,1253,1236,1730,3851,5104,1.0,0.2454937304075235,0.7545062695924765,2138,0.2421630094043887,0.33894984326018807,0.4188871473354232
402,1132928,3049,225,513,1505,2824,3049,1.0,0.07379468678255166,0.9262053132174484,1031,0.16825188586421777,0.49360446047884554,0.3381436536569367
403,1132929,1515,130,315,500,1385,1515,1.0,0.0858085808580858,0.9141914191419142,700,0.2079207920792079,0.33003300330033003,0.46204620462046203
404,1132940,1644,130,263,751,1514,1644,1.0,0.07907542579075426,0.9209245742092458,630,0.1599756690997567,0.45681265206812655,0.38321167883211676
405,1132941,5869,595,787,1601,5274,5869,1.0,0.10138013290168683,0.8986198670983132,3481,0.13409439427500425,0.2727892315556313,0.5931163741693645
406,1132942,5418,278,631,1647,5140,5418,1.0,0.051310446659283866,0.9486895533407161,3140,0.11646363971945367,0.30398671096345514,0.5795496493170912
407,1133000,4072,161,701,1171,3911,4072,1.0,0.03953831041257368,0.9604616895874263,2200,0.17215127701375246,0.287573673870334,0.5402750491159135
408,1133001,623,177,258,11,446,623,1.0,0.2841091492776886,0.7158908507223114,354,0.41412520064205455,0.01765650080256822,0.5682182985553772
409,1133002,1900,973,517,64,927,1900,1.0,0.5121052631578947,0.48789473684210527,1319,0.27210526315789474,0.03368421052631579,0.6942105263157895
410,1133003,2352,1326,1036,102,1026,2352,1.0,0.5637755102040817,0.4362244897959184,1214,0.44047619047619047,0.04336734693877551,0.516156462585034
411,1133004,1791,644,985,266,1147,1791,1.0,0.3595756560580681,0.6404243439419319,540,0.5499720826353992,0.14852037967615858,0.3015075376884422
412,1133005,527,60,80,23,467,527,1.0,0.11385199240986717,0.8861480075901328,424,0.15180265654648956,0.04364326375711575,0.8045540796963947
413,1133006,5278,389,599,1045,4889,5278,1.0,0.07370215990905646,0.9262978400909435,3634,0.11348995831754452,0.19799166350890487,0.6885183781735505
414,1133007,956,29,124,216,927,956,1.0,0.030334728033472803,0.9696652719665272,616,0.1297071129707113,0.22594142259414227,0.6443514644351465
415,1133009,3047,317,739,464,2730,3047,1.0,0.10403675746636036,0.8959632425336397,1844,0.242533639645553,0.15228093206432555,0.6051854282901215
416,1133010,693,126,79,149,567,693,1.0,0.18181818181818182,0.8181818181818182,465,0.113997113997114,0.215007215007215,0.670995670995671
417,1133011,1681,465,413,190,1216,1681,1.0,0.2766210588935158,0.7233789411064843,1078,0.24568709101725164,0.11302795954788816,0.6412849494348603
418,1133012,349,216,54,6,133,349,1.0,0.6189111747851003,0.38108882521489973,289,0.15472779369627507,0.017191977077363897,0.828080229226361
419,1133013,1378,117,185,89,1261,1378,1.0,0.08490566037735849,0.9150943396226415,1104,0.13425253991291727,0.06458635703918723,0.8011611030478955
420,1133014,3003,424,330,275,2579,3003,1.0,0.14119214119214119,0.8588078588078588,2398,0.10989010989010989,0.09157509157509157,0.7985347985347986
421,1133015,354,110,47,53,244,354,1.0,0.3107344632768362,0.6892655367231638,254,0.1327683615819209,0.1497175141242938,0.7175141242937854
422,1133016A,2132,639,445,118,1493,2132,1.0,0.299718574108818,0.700281425891182,1569,0.20872420262664165,0.055347091932457786,0.7359287054409006
424,1133017,899,677,368,23,222,899,1.0,0.7530589543937709,0.24694104560622915,508,0.40934371523915464,0.025583982202447165,0.5650723025583982
425,1133018,1751,1468,996,15,283,1751,1.0,0.8383780696744717,0.16162193032552827,740,0.5688178183894917,0.008566533409480296,0.422615648201028
426,1133019,957,734,432,2,223,957,1.0,0.7669801462904912,0.2330198537095089,523,0.45141065830721006,0.0020898641588296763,0.5464994775339603
427,1133020,97,52,83,13,45,97,1.170731707317073,0.5360824742268041,0.4639175257731959,1,0.8556701030927835,0.13402061855670103,0.010309278350515464
428,1133021,1279,1134,523,4,145,1279,1.0,0.8866301798279906,0.11336982017200939,752,0.40891321344800624,0.003127443315089914,0.5879593432369038
429,1133022,1970,1780,932,11,190,1970,1.0,0.9035532994923858,0.09644670050761421,1027,0.4730964467005076,0.005583756345177665,0.5213197969543147
430,1133023,1084,1045,730,7,39,1084,1.0,0.9640221402214022,0.035977859778597784,347,0.6734317343173432,0.006457564575645757,0.32011070110701106
431,1133024,1884,1704,938,12,180,1884,1.0,0.9044585987261147,0.09554140127388536,934,0.4978768577494692,0.006369426751592357,0.49575371549893843
432,1133025,314,215,76,0,99,314,1.0,0.6847133757961783,0.31528662420382164,238,0.24203821656050956,0.0,0.7579617834394905
433,1133026,1037,1022,440,1,15,1037,1.0,0.9855351976856316,0.01446480231436837,596,0.42430086788813887,0.0009643201542912247,0.5747348119575699
434,1133027,1321,1227,809,7,94,1321,1.0,0.9288417865253595,0.07115821347464042,505,0.6124148372445117,0.005299015897047691,0.3822861468584406
435,1133028,777,671,552,0,106,777,1.0,0.8635778635778636,0.1364221364221364,225,0.7104247104247104,0.0,0.28957528957528955
436,1133029,648,532,320,4,116,648,1.0,0.8209876543209876,0.17901234567901234,324,0.49382716049382713,0.006172839506172839,0.5
437,1133030,14,0,6,1,14,14,1.0,0.0,1.0,7,0.42857142857142855,0.07142857142857142,0.5
438,1133031,811,192,130,61,619,811,1.0,0.23674475955610358,0.7632552404438965,620,0.16029593094944514,0.0752157829839704,0.7644882860665845
439,1133032,1925,425,413,60,1500,1925,1.0,0.22077922077922077,0.7792207792207793,1452,0.21454545454545454,0.03116883116883117,0.7542857142857143
440,1133033,602,350,256,7,252,602,1.0,0.5813953488372093,0.4186046511627907,339,0.42524916943521596,0.011627906976744186,0.5631229235880398
441,1133034,1320,1075,709,15,245,1320,1.0,0.8143939393939394,0.1856060606060606,596,0.5371212121212121,0.011363636363636364,0.45151515151515154
442,1133035,2046,1834,804,15,212,2046,1.0,0.8963831867057673,0.10361681329423265,1227,0.39296187683284456,0.007331378299120235,0.5997067448680352
443,1133036,62,0,16,5,62,62,1.0,0.0,1.0,41,0.25806451612903225,0.08064516129032258,0.6612903225806451
444,1133037,324,221,252,3,103,324,1.0,0.6820987654320988,0.31790123456790126,69,0.7777777777777778,0.009259259259259259,0.21296296296296297
445,1133038,1188,1105,523,13,83,1188,1.0,0.9301346801346801,0.06986531986531987,652,0.44023569023569026,0.010942760942760943,0.5488215488215489
446,1133039,2347,2006,1365,10,341,2347,1.0,0.8547081380485726,0.14529186195142735,972,0.5815935236472092,0.004260758414997869,0.4141457179377929
447,1133040,1993,1760,709,14,233,1993,1.0,0.8830908178625189,0.11690918213748118,1270,0.3557451078775715,0.007024586051179127,0.6372303060712494
448,1133041,375,65,39,1,310,375,1.0,0.17333333333333334,0.8266666666666667,335,0.104,0.0026666666666666666,0.8933333333333333
449,1133042,1582,1305,890,10,277,1582,1.0,0.8249051833122629,0.17509481668773705,682,0.5625790139064475,0.006321112515802781,0.4310998735777497
450,1133043,1906,1660,1221,14,246,1906,1.0,0.8709338929695698,0.12906610703043023,671,0.6406086044071354,0.007345225603357817,0.35204616998950683
451,1133044,2770,2286,1409,15,484,2770,1.0,0.8252707581227436,0.17472924187725633,1346,0.5086642599277978,0.005415162454873646,0.48592057761732854
452,1133045,555,551,317,2,4,555,1.0,0.9927927927927928,0.007207207207207207,236,0.5711711711711712,0.0036036036036036037,0.4252252252252252
453,1133046,2379,1314,1140,167,1065,2379,1.0,0.5523329129886507,0.44766708701134933,1072,0.4791929382093317,0.0701975620008407,0.45060949978982767
454,1133047,3018,1852,785,444,1166,3018,1.0,0.6136514247846255,0.3863485752153744,1789,0.2601060304837641,0.147117296222664,0.5927766732935719
455,1133048,2511,2021,1554,52,490,2511,1.0,0.8048586220629231,0.19514137793707687,905,0.6188769414575866,0.020708880923934688,0.3604141776184787
456,1133049,2113,1802,1302,18,311,2113,1.0,0.8528159015617606,0.14718409843823946,793,0.6161855182205395,0.008518693800283956,0.3752957879791765
457,1133050,2362,1832,934,20,530,2362,1.0,0.7756138865368332,0.2243861134631668,1408,0.3954276037256562,0.00846740050804403,0.5961049957662997
458,1133051,1021,907,523,8,114,1021,1.0,0.8883447600391773,0.11165523996082272,490,0.5122428991185113,0.007835455435847209,0.47992164544564153
459,1133052,2915,2642,1413,13,273,2915,1.0,0.9063464837049743,0.09365351629502573,1489,0.48473413379073754,0.0044596912521440825,0.5108061749571183
460,1133053,3732,2832,1163,53,900,3732,1.0,0.7588424437299035,0.24115755627009647,2516,0.31162915326902463,0.01420150053590568,0.6741693461950696
461,1133054,2404,1996,1756,66,408,2404,1.0,0.8302828618968386,0.16971713810316139,582,0.7304492512479202,0.02745424292845258,0.2420965058236273
462,1133055,2158,1768,1530,126,390,2158,1.0,0.8192771084337349,0.18072289156626506,502,0.7089898053753475,0.05838739573679333,0.23262279888785914
463,1133056,2299,1950,1587,73,349,2299,1.0,0.8481948673336233,0.15180513266637669,639,0.6903001304915181,0.031752936059156155,0.2779469334493258
464,1133057,2585,1539,1412,91,1046,2585,1.0,0.595357833655706,0.404642166344294,1082,0.5462282398452611,0.035203094777562866,0.418568665377176
465,1133058,2496,2369,1442,20,127,2496,1.0,0.9491185897435898,0.050881410256410256,1034,0.5777243589743589,0.008012820512820512,0.41426282051282054
466,1133059,1283,1177,861,6,106,1283,1.0,0.9173811379579111,0.08261886204208885,416,0.6710833982852689,0.004676539360872954,0.32424006235385816
467,1133060,1301,1261,1086,18,40,1301,1.0,0.9692544196771714,0.030745580322828592,197,0.8347425057647964,0.013835511145272867,0.15142198308993082
468,1133061,1865,1327,846,9,538,1865,1.0,0.7115281501340482,0.28847184986595176,1010,0.45361930294906166,0.00482573726541555,0.5415549597855228
469,1133062,3344,2845,1385,17,499,3344,1.0,0.8507775119617225,0.1492224880382775,1942,0.41417464114832536,0.005083732057416268,0.5807416267942583
470,1133063,5414,4909,2017,57,505,5414,1.0,0.9067233099371999,0.09327669006280015,3340,0.3725526413003325,0.010528260066494275,0.6169190986331733
471,1133064,2210,1634,1587,28,576,2210,1.0,0.7393665158371041,0.26063348416289595,595,0.7180995475113122,0.012669683257918552,0.2692307692307692
472,1133065,2360,1845,1500,28,515,2360,1.0,0.7817796610169492,0.21822033898305085,832,0.635593220338983,0.011864406779661017,0.3525423728813559
473,1133066,2659,2175,1162,35,484,2659,1.0,0.8179766829635201,0.1820233170364799,1462,0.4370063933809703,0.013162843174125612,0.5498307634449041
474,1133067,4384,3498,1379,29,886,4384,1.0,0.7979014598540146,0.2020985401459854,2976,0.3145529197080292,0.006614963503649635,0.6788321167883211
475,1133068,3254,2793,1967,44,461,3254,1.0,0.8583282114320836,0.1416717885679164,1243,0.6044867854947756,0.013521819299323909,0.3819913952059004
476,1133069,1396,1282,1030,15,114,1396,1.0,0.9183381088825215,0.08166189111747851,351,0.7378223495702005,0.010744985673352435,0.251432664756447
477,1133070,3148,2951,1744,20,197,3148,1.0,0.9374205844980941,0.06257941550190597,1384,0.554002541296061,0.0063532401524777635,0.43964421855146124
478,1133071,2593,2408,1660,13,185,2593,1.0,0.9286540686463556,0.07134593135364442,920,0.6401851137678365,0.005013497878904744,0.35480138835325875
479,1133072,133,128,35,9,5,133,1.0,0.9624060150375939,0.03759398496240601,89,0.2631578947368421,0.06766917293233082,0.6691729323308271
480,1133073,292,265,84,1,27,292,1.0,0.9075342465753424,0.09246575342465753,207,0.2876712328767123,0.003424657534246575,0.708904109589041
481,1133074,1239,98,194,42,1141,1239,1.0,0.07909604519774012,0.9209039548022598,1003,0.1565778853914447,0.03389830508474576,0.8095238095238095
482,1133075,211,36,114,12,175,211,1.0,0.17061611374407584,0.8293838862559242,85,0.5402843601895735,0.05687203791469194,0.4028436018957346
484,1133077,3645,1922,1366,418,1723,3645,1.0,0.5272976680384088,0.4727023319615912,1861,0.3747599451303155,0.11467764060356653,0.5105624142661179
485,1133078,3075,1954,1407,231,1121,3075,1.0,0.6354471544715448,0.3645528455284553,1437,0.4575609756097561,0.07512195121951219,0.46731707317073173
486,1133079,1287,423,152,113,864,1287,1.0,0.32867132867132864,0.6713286713286714,1022,0.11810411810411811,0.08780108780108781,0.7940947940947941
487,1133080,1519,538,399,174,981,1519,1.0,0.35418038183015144,0.6458196181698486,946,0.2626728110599078,0.11454904542462147,0.6227781435154707
488,1133081,1395,15,285,362,1380,1395,1.0,0.010752688172043012,0.989247311827957,748,0.20430107526881722,0.25949820788530464,0.5362007168458781
489,1133082,3851,2965,1480,72,886,3851,1.0,0.7699298883406908,0.23007011165930927,2299,0.384315762139704,0.018696442482472084,0.596987795377824
490,1133083,2334,848,511,226,1486,2334,1.0,0.363324764353042,0.636675235646958,1597,0.21893744644387317,0.09682947729220223,0.6842330762639246
491,1133084,1489,354,393,92,1135,1489,1.0,0.23774345198119542,0.7622565480188046,1004,0.2639355271994627,0.06178643384822028,0.674278038952317
492,1133086,4558,175,592,820,4383,4558,1.0,0.03839403247038175,0.9616059675296182,3146,0.12988152698551997,0.1799034664326459,0.6902150065818341
493,1133087,1,0,0,0,1,1,1.0,0.0,1.0,1,0.0,0.0,1.0
494,1133088,108,30,21,7,78,108,1.0,0.2777777777777778,0.7222222222222222,80,0.19444444444444445,0.06481481481481481,0.7407407407407407
495,1133089,13,0,1,3,13,13,1.0,0.0,1.0,9,0.07692307692307693,0.23076923076923078,0.6923076923076923
496,1133090,1743,471,359,176,1272,1743,1.0,0.270223752151463,0.729776247848537,1208,0.2059667240390132,0.10097532989099255,0.6930579460699943
497,1133091,7,2,0,0,5,7,1.0,0.2857142857142857,0.7142857142857143,7,0.0,0.0,1.0
498,1133092,2348,1922,961,45,426,2348,1.0,0.8185689948892675,0.18143100511073254,1342,0.40928449744463374,0.019165247018739354,0.5715502555366269
499,1133093,18,3,2,1,15,18,1.0,0.16666666666666666,0.8333333333333334,15,0.1111111111111111,0.05555555555555555,0.8333333333333334
500,1133094,3,1,3,0,2,3,1.0,0.3333333333333333,0.6666666666666666,0,1.0,0.0,0.0
503,1133097,168,145,108,1,23,168,1.0,0.8630952380952381,0.13690476190476192,59,0.6428571428571429,0.005952380952380952,0.35119047619047616
504,1133098,306,250,149,3,56,306,1.0,0.8169934640522876,0.1830065359477124,154,0.4869281045751634,0.00980392156862745,0.5032679738562091
505,1133099,347,306,201,3,41,347,1.0,0.8818443804034583,0.11815561959654179,143,0.579250720461095,0.008645533141210375,0.41210374639769454
506,1133100,1847,1039,988,389,808,1847,1.0,0.5625338386572821,0.43746616134271793,470,0.5349214943151056,0.21061180292366,0.25446670276123445
507,1133101,660,442,272,136,218,660,1.0,0.6696969696969697,0.3303030303030303,252,0.4121212121212121,0.20606060606060606,0.38181818181818183
508,1133102,3526,2137,1413,333,1389,3526,1.0,0.606069200226886,0.393930799773114,1780,0.4007373794668179,0.0944412932501418,0.5048213272830403
509,1133103,3319,2312,1513,269,1007,3319,1.0,0.6965953600482073,0.30340463995179273,1537,0.45586019885507684,0.08104850858692378,0.4630912925579994
510,1133104,4684,2797,2424,683,1887,4684,1.0,0.5971391972672929,0.4028608027327071,1577,0.5175064047822374,0.14581554227156276,0.33667805294619985
511,1133105,2274,946,1101,505,1328,2274,1.0,0.4160070360598065,0.5839929639401935,668,0.4841688654353562,0.22207563764291996,0.2937554969217238
512,1133106,4027,2458,1625,418,1569,4027,1.0,0.6103799354358083,0.3896200645641917,1984,0.40352619816240376,0.10379935435808293,0.4926744474795133
513,1133107,2663,1964,1408,259,699,2663,1.0,0.7375140818625611,0.262485918137439,996,0.5287269996244837,0.09725873075478783,0.3740142696207285
514,1133108,2545,826,534,777,1719,2545,1.0,0.3245579567779961,0.675442043222004,1234,0.20982318271119843,0.3053045186640472,0.4848722986247544
515,1133109,3053,684,917,1200,2369,3053,1.0,0.22404192597445136,0.7759580740255486,936,0.3003603013429414,0.39305601048149363,0.30658368817556503
516,1133110,3160,2152,1634,252,1008,3160,1.0,0.6810126582278481,0.3189873417721519,1274,0.5170886075949367,0.07974683544303797,0.4031645569620253
517,1133111,16,9,7,4,7,16,1.0,0.5625,0.4375,5,0.4375,0.25,0.3125
518,1133112,16,5,9,6,11,16,1.0,0.3125,0.6875,1,0.5625,0.375,0.0625
520,1133200,2120,876,738,859,1244,2120,1.0,0.41320754716981134,0.5867924528301887,523,0.3481132075471698,0.405188679245283,0.24669811320754717
521,1133201,1864,534,564,581,1330,1864,1.0,0.286480686695279,0.7135193133047211,719,0.30257510729613735,0.3116952789699571,0.3857296137339056
522,1133202,2028,1086,927,411,942,2028,1.0,0.5355029585798816,0.46449704142011833,690,0.45710059171597633,0.20266272189349113,0.34023668639053256
523,1133203,2516,968,813,468,1548,2516,1.0,0.3847376788553259,0.615262321144674,1235,0.32313195548489665,0.18600953895071543,0.4908585055643879
524,1133204,3230,1338,886,613,1892,3230,1.0,0.41424148606811145,0.5857585139318885,1731,0.2743034055727554,0.18978328173374612,0.5359133126934984
525,1133205,1901,1420,970,117,481,1901,1.0,0.7469752761704366,0.25302472382956337,814,0.5102577590741715,0.061546554445028934,0.4281956864807996
526,1133206,2176,513,713,878,1663,2176,1.0,0.23575367647058823,0.7642463235294118,585,0.32766544117647056,0.40349264705882354,0.2688419117647059
527,1133207,3124,825,858,780,2299,3124,1.0,0.2640845070422535,0.7359154929577465,1486,0.2746478873239437,0.2496798975672215,0.47567221510883484
528,1133208,2643,868,636,388,1775,2643,1.0,0.328414680287552,0.671585319712448,1619,0.24063564131668558,0.14680287552024215,0.6125614831630722
529,1133209,195,51,59,76,144,195,1.0,0.26153846153846155,0.7384615384615385,60,0.30256410256410254,0.38974358974358975,0.3076923076923077
530,1133210,2880,1055,675,585,1825,2880,1.0,0.3663194444444444,0.6336805555555556,1620,0.234375,0.203125,0.5625
531,1133211,1324,142,354,220,1182,1324,1.0,0.10725075528700906,0.8927492447129909,750,0.2673716012084592,0.1661631419939577,0.5664652567975831
532,1133300,2840,506,680,981,2334,2840,1.0,0.17816901408450705,0.821830985915493,1179,0.23943661971830985,0.3454225352112676,0.41514084507042254
533,1133301,2823,507,620,930,2316,2823,1.0,0.179596174282678,0.820403825717322,1273,0.2196245129295076,0.3294367693942614,0.45093871767623095
534,1133302,1569,250,379,503,1319,1569,1.0,0.15933715742511154,0.8406628425748884,687,0.24155513065646908,0.3205863607393244,0.4378585086042065
535,1133303,4150,1490,924,597,2660,4150,1.0,0.35903614457831323,0.6409638554216868,2629,0.22265060240963855,0.14385542168674698,0.6334939759036144
536,1133304,3671,672,718,962,2999,3671,1.0,0.18305638790520296,0.816943612094797,1991,0.1955870335058567,0.2620539362571506,0.5423590302369926
537,1133305,4453,1413,1062,1207,3040,4453,1.0,0.31731417022232206,0.682685829777678,2184,0.23849090500785988,0.2710532225465978,0.49045587244554234
538,1133306,1943,392,434,405,1551,1943,1.0,0.20174987133299022,0.7982501286670097,1104,0.2233659289758106,0.20844055584148224,0.5681935151827071
539,1133307,2753,945,532,352,1808,2753,1.0,0.3432618961133309,0.6567381038866691,1869,0.19324373410824555,0.12786051580094443,0.67889575009081
540,1133308,2491,498,545,436,1993,2491,1.0,0.19991971095945404,0.800080289040546,1510,0.21878763548775593,0.17503010839020475,0.6061822561220394
541,1133309,2149,541,585,663,1608,2149,1.0,0.2517449976733364,0.7482550023266635,901,0.27221963704048396,0.3085155886458818,0.41926477431363424
542,1133310,3350,680,671,769,2670,3350,1.0,0.20298507462686566,0.7970149253731343,1910,0.20029850746268657,0.22955223880597014,0.5701492537313433
543,1133311,2951,664,532,711,2287,2951,1.0,0.22500847170450694,0.774991528295493,1708,0.18027787190782785,0.24093527617756694,0.5787868519146052
544,1133312,3306,921,971,1024,2385,3306,1.0,0.27858439201451907,0.721415607985481,1311,0.29370840895341804,0.30973986690865096,0.39655172413793105
545,1133313,5617,2430,1795,1151,3187,5617,1.0,0.43261527505786007,0.56738472494214,2671,0.31956560441516824,0.2049136549759658,0.47552074060886595
546,1133314,4015,1665,1318,758,2350,4015,1.0,0.41469489414694893,0.5853051058530511,1939,0.32826899128268994,0.1887920298879203,0.4829389788293898
547,1133315,2230,822,441,318,1408,2230,1.0,0.368609865470852,0.6313901345291479,1471,0.1977578475336323,0.14260089686098654,0.6596412556053811
548,1133316,2741,684,880,770,2057,2741,1.0,0.2495439620576432,0.7504560379423568,1091,0.32105071141919006,0.28091937249179133,0.3980299160890186
549,1133317,1836,839,550,326,997,1836,1.0,0.45697167755991286,0.5430283224400871,960,0.2995642701525055,0.1775599128540305,0.5228758169934641
550,1133318,2190,723,460,476,1467,2190,1.0,0.33013698630136984,0.6698630136986301,1254,0.2100456621004566,0.217351598173516,0.5726027397260274
551,1133400,684,338,288,65,346,684,1.0,0.49415204678362573,0.5058479532163743,331,0.42105263157894735,0.09502923976608187,0.48391812865497075
552,1133401,13,4,2,0,9,13,1.0,0.3076923076923077,0.6923076923076923,11,0.15384615384615385,0.0,0.8461538461538461
553,1133402,484,175,124,66,309,484,1.0,0.3615702479338843,0.6384297520661157,294,0.256198347107438,0.13636363636363635,0.6074380165289256
554,1133404,2503,770,756,274,1733,2503,1.0,0.3076308429884139,0.6923691570115861,1473,0.3020375549340791,0.10946863763483819,0.5884938074310827
555,1133405,2944,990,888,546,1954,2944,1.0,0.33627717391304346,0.6637228260869565,1510,0.3016304347826087,0.18546195652173914,0.5129076086956522
556,1133406,75,13,5,10,62,75,1.0,0.17333333333333334,0.8266666666666667,60,0.06666666666666667,0.13333333333333333,0.8
557,1133407,403,82,65,93,321,403,1.0,0.20347394540942929,0.7965260545905707,245,0.16129032258064516,0.23076923076923078,0.607940446650124
558,1133408,2200,536,631,247,1664,2200,1.0,0.24363636363636362,0.7563636363636363,1322,0.2868181818181818,0.11227272727272727,0.600909090909091
559,1133409,655,43,114,113,612,655,1.0,0.06564885496183206,0.934351145038168,428,0.17404580152671756,0.17251908396946564,0.6534351145038167
560,1133410,495,269,95,37,226,495,1.0,0.5434343434343434,0.45656565656565656,363,0.1919191919191919,0.07474747474747474,0.7333333333333333
561,1133411,5,0,2,3,5,5,1.6666666666666667,0.0,1.0,0,0.4,0.6,0.0
562,1133500,4217,541,669,2021,3676,4217,1.0,0.12829025373488262,0.8717097462651174,1527,0.15864358548731325,0.47925065212236184,0.3621057623903249
563,1133501,7,0,1,2,7,7,1.0,0.0,1.0,4,0.14285714285714285,0.2857142857142857,0.5714285714285714
564,1133600,2886,2091,1033,304,795,2886,1.0,0.7245322245322245,0.27546777546777546,1549,0.3579348579348579,0.10533610533610534,0.5367290367290367
565,1133601,1563,975,1032,354,588,1563,1.0,0.6238003838771593,0.3761996161228407,177,0.6602687140115163,0.22648752399232247,0.11324376199616124
566,1133602,521,427,359,102,94,521,1.0,0.8195777351247601,0.18042226487523993,60,0.6890595009596929,0.19577735124760076,0.11516314779270634
567,1133603,228,187,133,62,41,228,1.0,0.8201754385964912,0.17982456140350878,33,0.5833333333333334,0.2719298245614035,0.14473684210526316
568,1133604,3158,2219,1392,486,939,3158,1.0,0.7026599113362888,0.2973400886637112,1280,0.4407853071564281,0.1538948701709943,0.4053198226725776
569,1133605,3174,2371,1625,349,803,3174,1.0,0.7470069313169502,0.25299306868304977,1200,0.5119722747321991,0.10995589161940769,0.3780718336483932
570,1133606,2506,1945,1586,126,561,2506,1.0,0.7761372705506784,0.22386272944932162,794,0.6328810853950518,0.05027932960893855,0.31683958499600956
571,1133607,3616,2829,2108,288,787,3616,1.0,0.7823561946902655,0.2176438053097345,1220,0.5829646017699115,0.07964601769911504,0.33738938053097345
572,1133608,2904,2640,1805,156,264,2904,1.0,0.9090909090909091,0.09090909090909091,943,0.6215564738292011,0.05371900826446281,0.3247245179063361
573,1133609,2709,1602,1431,366,1107,2709,1.0,0.5913621262458472,0.40863787375415284,912,0.5282392026578073,0.13510520487264674,0.33665559246954596
574,1133610,470,303,205,130,167,470,1.0,0.6446808510638298,0.3553191489361702,135,0.43617021276595747,0.2765957446808511,0.2872340425531915
575,1133611,1150,685,454,246,465,1150,1.0,0.5956521739130435,0.4043478260869565,450,0.3947826086956522,0.21391304347826087,0.391304347826087
576,1133612,2976,2283,1796,323,693,2976,1.0,0.7671370967741935,0.23286290322580644,857,0.603494623655914,0.10853494623655914,0.2879704301075269
577,1133613,622,324,248,153,298,622,1.0,0.5209003215434084,0.4790996784565916,221,0.3987138263665595,0.2459807073954984,0.3553054662379421
578,1133614,936,658,504,62,278,936,1.0,0.7029914529914529,0.297008547008547,370,0.5384615384615384,0.06623931623931624,0.3952991452991453
579,1133615,2587,2095,1426,196,492,2587,1.0,0.8098183223811365,0.19018167761886354,965,0.551217626594511,0.07576343254735214,0.37301894085813686
580,1133616,989,679,366,42,310,989,1.0,0.6865520728008089,0.3134479271991911,581,0.3700707785642063,0.042467138523761376,0.5874620829120324
581,1133617,1750,1358,929,89,392,1750,1.0,0.776,0.224,732,0.5308571428571428,0.05085714285714286,0.41828571428571426
582,1133618,221,152,107,17,69,221,1.0,0.6877828054298643,0.31221719457013575,97,0.4841628959276018,0.07692307692307693,0.43891402714932126
583,1133619,585,202,76,44,383,585,1.0,0.3452991452991453,0.6547008547008547,465,0.12991452991452992,0.07521367521367521,0.7948717948717948
584,1133620,1425,684,572,102,741,1425,1.0,0.48,0.52,751,0.4014035087719298,0.07157894736842105,0.5270175438596492
586,1133700,5875,1693,1246,953,4182,5875,1.0,0.28817021276595745,0.7118297872340426,3676,0.21208510638297873,0.1622127659574468,0.6257021276595744
587,1133701,4686,1133,1166,1174,3553,4686,1.0,0.24178403755868544,0.7582159624413145,2346,0.24882629107981222,0.2505335040546308,0.5006402048655569
588,1133702,3511,797,650,583,2714,3511,1.0,0.22700085445741955,0.7729991455425804,2278,0.18513244090002848,0.16604955853033324,0.6488180005696382
589,1133703,69,15,12,21,54,69,1.0,0.21739130434782608,0.782608695652174,36,0.17391304347826086,0.30434782608695654,0.5217391304347826
590,1133800,4282,3331,2296,118,951,4282,1.0,0.7779075198505371,0.22209248014946287,1868,0.5361980382998599,0.027557216254086876,0.43624474544605324
591,1133801,776,466,133,35,310,776,1.0,0.6005154639175257,0.39948453608247425,608,0.1713917525773196,0.045103092783505154,0.7835051546391752
592,1133802,4429,3100,2400,249,1329,4429,1.0,0.6999322646195529,0.30006773538044706,1780,0.5418830435764281,0.056220365771054416,0.4018965906525175
593,1133803,4260,3630,1949,128,630,4260,1.0,0.852112676056338,0.14788732394366197,2183,0.4575117370892019,0.03004694835680751,0.5124413145539906
594,1133805,5191,4406,2823,140,785,5191,1.0,0.8487767289539587,0.15122327104604122,2228,0.5438258524369101,0.026969755345790793,0.42920439221729917
595,1133806,876,660,506,32,216,876,1.0,0.7534246575342466,0.2465753424657534,338,0.5776255707762558,0.0365296803652968,0.3858447488584475
596,1133807,1899,1433,1150,259,466,1899,1.0,0.7546076882569773,0.24539231174302265,490,0.6055818852027383,0.13638757240652974,0.258030542390732
597,1133808,3681,1345,1210,848,2336,3681,1.0,0.3653898397174681,0.6346101602825319,1623,0.3287150230915512,0.23037218147242597,0.4409127954360228
598,1133809,487,152,189,55,335,487,1.0,0.31211498973305957,0.6878850102669405,243,0.38809034907597534,0.11293634496919917,0.4989733059548255
599,1133900,6062,4035,2305,489,2027,6062,1.0,0.6656219069613989,0.3343780930386011,3268,0.38023754536456617,0.08066644671725504,0.5390960079181788
600,1133920,4906,884,566,767,4022,4906,1.0,0.1801875254790053,0.8198124745209947,3573,0.11536893599673868,0.15633917651854873,0.7282918874847126
601,1133921,5551,899,856,997,4652,5551,1.0,0.1619528012970636,0.8380471987029364,3698,0.1542064492884165,0.17960727796793372,0.6661862727436498
602,1133922,110,18,38,4,92,110,1.0,0.16363636363636364,0.8363636363636363,68,0.34545454545454546,0.03636363636363636,0.6181818181818182
603,1133940A,2692,995,618,303,1697,2692,1.0,0.3696136701337296,0.6303863298662704,1771,0.22956909361069835,0.11255572065378901,0.6578751857355126
605,1133950,4074,1781,684,240,2293,4074,1.0,0.4371624938635248,0.5628375061364752,3150,0.16789396170839468,0.05891016200294551,0.7731958762886598
606,1134002,769,49,333,332,720,769,1.0,0.06371911573472042,0.9362808842652796,104,0.43302990897269183,0.4317295188556567,0.1352405721716515
607,1134003A,792,78,102,30,714,792,1.0,0.09848484848484848,0.9015151515151515,660,0.12878787878787878,0.03787878787878788,0.8333333333333334
609,1134004,1857,266,548,272,1591,1857,1.0,0.14324178782983307,0.8567582121701669,1037,0.29509962304792675,0.1464728056004308,0.5584275713516424
610,1134005,1200,124,284,197,1076,1200,1.0,0.10333333333333333,0.8966666666666666,719,0.23666666666666666,0.16416666666666666,0.5991666666666666
611,1134006A,1254,139,392,373,1115,1254,1.0,0.11084529505582137,0.8891547049441786,489,0.31259968102073366,0.2974481658692185,0.38995215311004783
613,1134007,159,6,61,60,153,159,1.0,0.03773584905660377,0.9622641509433962,38,0.3836477987421384,0.37735849056603776,0.2389937106918239
614,1134008,1268,100,151,31,1168,1268,1.0,0.07886435331230283,0.9211356466876972,1086,0.11908517350157728,0.02444794952681388,0.8564668769716088
615,1134010,1381,3,395,333,1378,1381,1.0,0.002172338884866039,0.997827661115134,653,0.28602461984069516,0.24112961622013035,0.4728457639391745
616,1134011,853,57,233,99,796,853,1.0,0.0668229777256741,0.9331770222743259,521,0.2731535756154748,0.1160609613130129,0.6107854630715123
617,1134012,103,2,28,18,101,103,1.0,0.019417475728155338,0.9805825242718447,57,0.27184466019417475,0.17475728155339806,0.5533980582524272
618,1134013,306,0,118,118,306,306,1.0,0.0,1.0,70,0.38562091503267976,0.38562091503267976,0.22875816993464052
619,1134014,1825,12,471,851,1813,1825,1.0,0.006575342465753425,0.9934246575342466,503,0.2580821917808219,0.4663013698630137,0.2756164383561644
620,1134015,1605,885,872,134,720,1605,1.0,0.5514018691588785,0.4485981308411215,599,0.5433021806853583,0.08348909657320873,0.373208722741433
621,1134016,1905,460,911,182,1445,1905,1.0,0.24146981627296588,0.7585301837270341,812,0.47821522309711284,0.09553805774278215,0.426246719160105
622,1134017,580,180,175,119,400,580,1.0,0.3103448275862069,0.6896551724137931,286,0.3017241379310345,0.20517241379310344,0.49310344827586206
623,1134018,1330,326,285,287,1004,1330,1.0,0.24511278195488723,0.7548872180451128,758,0.21428571428571427,0.21578947368421053,0.5699248120300752
624,1134019,2764,966,649,121,1798,2764,1.0,0.34949348769898697,0.650506512301013,1994,0.23480463096960927,0.04377713458755427,0.7214182344428365
625,1134020,1048,260,206,42,788,1048,1.0,0.2480916030534351,0.7519083969465649,800,0.1965648854961832,0.04007633587786259,0.7633587786259542
626,1134021,4570,539,1546,425,4031,4570,1.0,0.11794310722100657,0.8820568927789935,2599,0.33829321663019696,0.09299781181619256,0.5687089715536106
627,1134022,4253,727,859,206,3526,4253,1.0,0.17093816129790737,0.8290618387020926,3188,0.20197507641664708,0.04843639783682107,0.7495885257465319
628,1134023,8,3,2,4,5,8,1.0,0.375,0.625,2,0.25,0.5,0.25
629,1134024,2464,1457,1049,59,1007,2464,1.0,0.591314935064935,0.40868506493506496,1356,0.4257305194805195,0.023944805194805196,0.5503246753246753
630,1134025,458,245,170,3,213,458,1.0,0.5349344978165939,0.4650655021834061,285,0.37117903930131,0.006550218340611353,0.6222707423580786
631,1134026,160,74,140,19,86,160,1.119718309859155,0.4625,0.5375,1,0.875,0.11875,0.00625
632,1134027,294,0,70,14,294,294,1.0,0.0,1.0,210,0.23809523809523808,0.047619047619047616,0.7142857142857143
633,1134028,680,429,519,23,251,680,1.0,0.6308823529411764,0.36911764705882355,138,0.763235294117647,0.033823529411764704,0.20294117647058824
634,1134029,90,47,11,2,43,90,1.0,0.5222222222222223,0.4777777777777778,77,0.12222222222222222,0.022222222222222223,0.8555555555555555
635,1134030,87,45,8,0,42,87,1.0,0.5172413793103449,0.4827586206896552,79,0.09195402298850575,0.0,0.9080459770114943
636,1134031,1695,1078,1137,23,617,1695,1.0,0.6359882005899705,0.3640117994100295,535,0.6707964601769911,0.013569321533923304,0.31563421828908556
637,1134032,3759,411,790,280,3348,3759,1.0,0.10933758978451716,0.8906624102154829,2689,0.21016227720138334,0.074487895716946,0.7153498270816706
638,1134033,7142,3124,279,177,4018,7142,1.0,0.43741248949873984,0.5625875105012601,6686,0.039064687762531504,0.024782973956874826,0.9361523382805936
639,1134035,1400,750,505,109,650,1400,1.0,0.5357142857142857,0.4642857142857143,786,0.3607142857142857,0.07785714285714286,0.5614285714285714
640,1134036,1201,322,358,41,879,1201,1.0,0.2681099084096586,0.7318900915903414,802,0.2980849292256453,0.03413821815154038,0.6677768526228143
641,1134037,308,83,74,17,225,308,1.0,0.2694805194805195,0.7305194805194806,217,0.24025974025974026,0.05519480519480519,0.7045454545454546
642,1134038,2472,1062,1074,69,1410,2472,1.0,0.42961165048543687,0.5703883495145631,1329,0.4344660194174757,0.027912621359223302,0.537621359223301
643,1134039,675,460,297,11,215,675,1.0,0.6814814814814815,0.31851851851851853,367,0.44,0.016296296296296295,0.5437037037037037
644,1134040,810,721,478,8,89,810,1.0,0.8901234567901235,0.10987654320987654,324,0.5901234567901235,0.009876543209876543,0.4
645,1134041,642,370,412,11,272,642,1.0,0.5763239875389408,0.4236760124610592,219,0.6417445482866043,0.017133956386292833,0.3411214953271028
646,1134043,1280,210,546,43,1070,1280,1.0,0.1640625,0.8359375,691,0.4265625,0.03359375,0.53984375
647,1134044,1353,515,510,33,838,1353,1.0,0.38063562453806354,0.6193643754619365,810,0.376940133037694,0.024390243902439025,0.5986696230598669
648,1134046,1278,548,535,23,730,1278,1.0,0.4287949921752739,0.5712050078247262,720,0.418622848200313,0.017996870109546165,0.5633802816901409
649,1134047,745,488,450,13,257,745,1.0,0.6550335570469799,0.34496644295302015,282,0.6040268456375839,0.0174496644295302,0.3785234899328859
650,1134048,280,187,4,56,93,280,1.0,0.6678571428571428,0.33214285714285713,220,0.014285714285714285,0.2,0.7857142857142857
652,1134050,4274,2556,1660,575,1718,4274,1.0,0.598034627983154,0.40196537201684607,2039,0.3883949461862424,0.1345343940102948,0.4770706598034628
654,1134052,5873,2448,1584,528,3425,5873,1.0,0.41682274816958964,0.5831772518304104,3761,0.2697088370509109,0.08990294568363698,0.640388217265452
655,1134053,380,74,138,36,306,380,1.0,0.19473684210526315,0.8052631578947368,206,0.3631578947368421,0.09473684210526316,0.5421052631578948
656,1134054,661,181,117,30,480,661,1.0,0.27382753403933435,0.7261724659606656,514,0.17700453857791226,0.0453857791225416,0.7776096822995462
657,1134055,3082,975,935,257,2107,3082,1.0,0.3163530175210902,0.6836469824789098,1890,0.30337443218689164,0.08338741077222583,0.6132381570408826
658,1134056,4054,1873,994,137,2181,4054,1.0,0.4620128268376912,0.5379871731623088,2923,0.24518993586581153,0.033793783917118896,0.7210162802170695
659,1134057,2077,317,573,144,1760,2077,1.0,0.15262397688974483,0.8473760231102552,1360,0.2758786711603274,0.0693307655272027,0.6547905633124699
660,1134058,1087,42,281,79,1045,1087,1.0,0.03863845446182153,0.9613615455381784,727,0.25850965961361544,0.07267709291628335,0.6688132474701012
661,1134059,362,80,130,17,282,362,1.0,0.22099447513812154,0.7790055248618785,215,0.35911602209944754,0.04696132596685083,0.5939226519337016
662,1134060,3312,1004,770,155,2308,3312,1.0,0.3031400966183575,0.6968599033816425,2387,0.23248792270531402,0.04679951690821256,0.7207125603864735
663,1134061,3146,96,658,224,3050,3146,1.0,0.030514939605848695,0.9694850603941513,2264,0.20915448188175462,0.0712015257469803,0.7196439923712651
664,1134062,2030,25,491,164,2005,2030,1.0,0.012315270935960592,0.9876847290640394,1375,0.241871921182266,0.08078817733990148,0.6773399014778325
665,1134063,2923,314,879,295,2609,2923,1.0,0.10742387957577831,0.8925761204242217,1749,0.3007184399589463,0.10092370851864522,0.5983578515224085
666,1134065,1673,126,285,115,1547,1673,1.0,0.07531380753138076,0.9246861924686193,1273,0.17035265989240886,0.06873879258816497,0.7609085475194262
667,1134066,1544,59,350,91,1485,1544,1.0,0.03821243523316062,0.9617875647668394,1103,0.2266839378238342,0.05893782383419689,0.7143782383419689
668,1134067,2284,145,592,210,2139,2284,1.0,0.06348511383537653,0.9365148861646234,1482,0.2591943957968476,0.09194395796847636,0.648861646234676
669,1134068,2079,22,595,187,2057,2079,1.0,0.010582010582010581,0.9894179894179894,1297,0.28619528619528617,0.08994708994708994,0.6238576238576239
670,1134069,3268,97,919,301,3171,3268,1.0,0.02968176254589963,0.9703182374541004,2048,0.28121175030599754,0.09210526315789473,0.6266829865361077
671,1134070,1795,89,531,127,1706,1795,1.0,0.04958217270194986,0.9504178272980501,1137,0.2958217270194986,0.07075208913649025,0.6334261838440112
672,1134071,613,55,104,14,558,613,1.0,0.08972267536704731,0.9102773246329527,495,0.16965742251223492,0.022838499184339316,0.8075040783034257
673,1134072,308,10,85,20,298,308,1.0,0.032467532467532464,0.9675324675324676,203,0.275974025974026,0.06493506493506493,0.6590909090909091
674,1134073,2197,171,589,231,2026,2197,1.0,0.07783340919435594,0.9221665908056441,1377,0.2680928538916705,0.10514337733272644,0.6267637687756031
675,1134074,2719,312,920,327,2407,2719,1.0,0.1147480691430673,0.8852519308569327,1472,0.33835969106289077,0.120264803236484,0.5413755057006252
676,1134075,1359,90,287,87,1269,1359,1.0,0.06622516556291391,0.9337748344370861,985,0.21118469462840322,0.0640176600441501,0.7247976453274466
677,1134076,3932,641,811,212,3291,3932,1.0,0.16302136317395727,0.8369786368260427,2909,0.2062563580874873,0.05391658189216684,0.7398270600203459
678,1134077,970,56,300,85,914,970,1.0,0.0577319587628866,0.9422680412371134,585,0.30927835051546393,0.08762886597938144,0.6030927835051546
679,1134078,1777,144,465,142,1633,1777,1.0,0.08103545301069218,0.9189645469893079,1170,0.26167698368036013,0.0799099606077659,0.6584130557118739
680,1134079,4386,635,1684,811,3751,4386,1.0,0.14477884176926584,0.8552211582307342,1891,0.38394892840857275,0.184906520747834,0.43114455084359327
681,1134080,584,4,233,234,580,584,1.0,0.00684931506849315,0.9931506849315068,117,0.398972602739726,0.4006849315068493,0.20034246575342465
682,1134081,3592,298,925,181,3294,3592,1.0,0.08296213808463251,0.9170378619153675,2486,0.2575167037861915,0.05038975501113586,0.6920935412026726
683,1134082,806,215,136,15,591,806,1.0,0.2667493796526055,0.7332506203473945,655,0.1687344913151365,0.018610421836228287,0.8126550868486352
684,1134083,987,91,137,50,896,987,1.0,0.09219858156028368,0.9078014184397163,800,0.13880445795339413,0.05065856129685917,0.8105369807497467
685,1134084,870,401,236,14,469,870,1.0,0.46091954022988507,0.539080459770115,620,0.271264367816092,0.016091954022988506,0.7126436781609196
686,1134085,1056,86,348,74,970,1056,1.0,0.08143939393939394,0.9185606060606061,634,0.32954545454545453,0.07007575757575757,0.6003787878787878
687,1134086,3425,475,816,177,2950,3425,1.0,0.1386861313868613,0.8613138686131386,2432,0.23824817518248176,0.05167883211678832,0.7100729927007299
688,1134088,986,100,78,33,886,986,1.0,0.10141987829614604,0.8985801217038539,875,0.07910750507099391,0.033468559837728194,0.8874239350912779
689,1134090,115,13,21,21,102,115,1.0,0.11304347826086956,0.8869565217391304,73,0.1826086956521739,0.1826086956521739,0.6347826086956522
693,1134092,262,11,55,39,251,262,1.0,0.04198473282442748,0.9580152671755725,168,0.2099236641221374,0.14885496183206107,0.6412213740458015
694,1134093,82,61,37,1,21,82,1.0,0.7439024390243902,0.25609756097560976,44,0.45121951219512196,0.012195121951219513,0.5365853658536586
695,1134094,611,45,148,126,566,611,1.0,0.07364975450081833,0.9263502454991817,337,0.24222585924713586,0.20621931260229132,0.5515548281505729
696,1134095,87,11,12,5,76,87,1.0,0.12643678160919541,0.8735632183908046,70,0.13793103448275862,0.05747126436781609,0.8045977011494253
697,1134096,134,11,3,14,123,134,1.0,0.08208955223880597,0.917910447761194,117,0.022388059701492536,0.1044776119402985,0.8731343283582089
698,1134097A,1046,81,327,154,965,1046,1.0,0.07743785850860421,0.9225621414913958,565,0.31261950286806883,0.14722753346080306,0.5401529636711281
700,1134098,37,0,12,14,37,37,1.0,0.0,1.0,11,0.32432432432432434,0.3783783783783784,0.2972972972972973
701,1134099,1199,72,249,401,1127,1199,1.0,0.060050041701417846,0.9399499582985822,549,0.20767306088407006,0.33444537114261885,0.4578815679733111
702,1134100,19,0,5,6,19,19,1.0,0.0,1.0,8,0.2631578947368421,0.3157894736842105,0.42105263157894735
703,1134101,201,123,40,6,78,201,1.0,0.6119402985074627,0.3880597014925373,155,0.19900497512437812,0.029850746268656716,0.7711442786069652
704,1134102,350,8,61,91,342,350,1.0,0.022857142857142857,0.9771428571428571,198,0.1742857142857143,0.26,0.5657142857142857
705,1134103,137,5,47,23,132,137,1.0,0.0364963503649635,0.9635036496350365,67,0.34306569343065696,0.1678832116788321,0.48905109489051096
706,1134104,1,0,1,0,1,1,1.0,0.0,1.0,0,1.0,0.0,0.0
707,1134105,18,2,3,0,16,18,1.0,0.1111111111111111,0.8888888888888888,15,0.16666666666666666,0.0,0.8333333333333334
708,1134106,219,5,41,53,214,219,1.0,0.0228310502283105,0.9771689497716894,125,0.1872146118721461,0.2420091324200913,0.5707762557077626
709,1134107,129,24,49,5,105,129,1.0,0.18604651162790697,0.813953488372093,75,0.3798449612403101,0.03875968992248062,0.5813953488372093
710,1134108,55,16,37,1,39,55,1.0,0.2909090909090909,0.7090909090909091,17,0.6727272727272727,0.01818181818181818,0.3090909090909091
711,1134109,38,25,25,0,13,38,1.0,0.6578947368421053,0.34210526315789475,13,0.6578947368421053,0.0,0.34210526315789475
712,1134110,998,664,606,14,334,998,1.0,0.6653306613226453,0.3346693386773547,378,0.6072144288577155,0.014028056112224449,0.3787575150300601
713,1134111,241,28,89,30,213,241,1.0,0.11618257261410789,0.8838174273858921,122,0.36929460580912865,0.12448132780082988,0.5062240663900415
714,1134112,1933,461,14,145,1472,1933,1.0,0.23848939472322814,0.7615106052767718,1774,0.007242628039317123,0.07501293326435593,0.9177444386963269
715,1134113,2459,105,565,210,2354,2459,1.0,0.04270028466856446,0.9572997153314355,1684,0.22976819845465637,0.08540056933712892,0.6848312322082147
716,1134114,1681,35,465,134,1646,1681,1.0,0.02082093991671624,0.9791790600832838,1082,0.2766210588935158,0.07971445568114217,0.643664485425342
717,1134115,195,19,74,64,176,195,1.0,0.09743589743589744,0.9025641025641026,57,0.37948717948717947,0.3282051282051282,0.2923076923076923
719,1134117,162,107,24,5,55,162,1.0,0.6604938271604939,0.3395061728395062,133,0.14814814814814814,0.030864197530864196,0.8209876543209876
722,1134120,1028,101,148,26,927,1028,1.0,0.09824902723735408,0.9017509727626459,854,0.14396887159533073,0.02529182879377432,0.830739299610895
728,1134300,2054,22,432,186,2032,2054,1.0,0.010710808179162609,0.9892891918208374,1436,0.2103213242453749,0.09055501460564752,0.6991236611489776
729,1134500,2812,807,756,540,2005,2812,1.0,0.28698435277382645,0.7130156472261735,1516,0.26884779516358465,0.19203413940256045,0.5391180654338549
730,1134501,2918,501,622,647,2417,2918,1.0,0.1716929403701165,0.8283070596298835,1649,0.2131596984235778,0.2217272104180946,0.5651130911583276
731,1134502,4404,1543,1144,803,2861,4404,1.0,0.3503633060853769,0.6496366939146231,2457,0.259763851044505,0.18233424159854678,0.5579019073569482
732,1134503,5178,1777,1216,612,3401,5178,1.0,0.34318269602163,0.65681730397837,3350,0.23483970645036695,0.11819235225955968,0.6469679412900734
733,1134504,1646,182,393,336,1464,1646,1.0,0.11057108140947752,0.8894289185905225,917,0.2387606318347509,0.20413122721749696,0.5571081409477521
734,1134505,2650,825,455,467,1825,2650,1.0,0.3113207547169811,0.6886792452830188,1728,0.17169811320754716,0.17622641509433962,0.6520754716981132
735,1134506,2069,340,354,305,1729,2069,1.0,0.16433059449009182,0.8356694055099082,1410,0.17109714838086032,0.1474142097631706,0.681488641855969
736,1134507,1198,600,558,46,598,1198,1.0,0.5008347245409015,0.4991652754590985,594,0.4657762938230384,0.038397328881469114,0.4958263772954925
737,1134508,977,218,153,115,759,977,1.0,0.22313203684749233,0.7768679631525077,709,0.15660184237461616,0.11770726714431934,0.7256908904810645
738,1134509,2349,328,310,532,2021,2349,1.0,0.13963388676032354,0.8603661132396765,1507,0.13197105151128138,0.22647935291613452,0.6415495955725841
739,1134510,3102,402,445,346,2700,3102,1.0,0.12959381044487428,0.8704061895551257,2311,0.14345583494519665,0.11154094132817537,0.745003223726628
740,1134511,2908,331,450,353,2577,2908,1.0,0.11382393397524071,0.8861760660247593,2105,0.15474552957359008,0.12138927097661623,0.7238651994497937
741,1134512,2235,204,323,384,2031,2235,1.0,0.0912751677852349,0.9087248322147651,1528,0.14451901565995526,0.17181208053691274,0.6836689038031319
742,1134513,4559,1450,720,417,3109,4559,1.0,0.31805220443079624,0.6819477955692038,3422,0.15792937047598157,0.09146742706733933,0.7506032024566791
743,1134514,1949,279,268,442,1670,1949,1.0,0.1431503335043612,0.8568496664956388,1239,0.1375064135454079,0.22678296562339662,0.6357106208311954
744,1134515,2797,256,449,270,2541,2797,1.0,0.09152663568108688,0.9084733643189131,2078,0.16052913836253127,0.09653199856989632,0.7429388630675724
745,1134516,81,0,3,3,81,81,1.0,0.0,1.0,75,0.037037037037037035,0.037037037037037035,0.9259259259259259
746,1134517,4405,679,673,1290,3726,4405,1.0,0.15414301929625426,0.8458569807037457,2442,0.15278093076049942,0.29284903518728717,0.5543700340522134
747,1134519,3703,1044,959,903,2659,3703,1.0,0.2819335673778018,0.7180664326221983,1841,0.2589792060491493,0.2438563327032136,0.497164461247637
748,1134520,1555,205,431,273,1350,1555,1.0,0.13183279742765272,0.8681672025723473,851,0.2771704180064309,0.17556270096463023,0.547266881028939
749,1134521,4774,724,1088,1191,4050,4774,1.0,0.15165479681608715,0.8483452031839128,2495,0.22790113112693758,0.24947633012149142,0.522622538751571
750,1134522,2972,901,937,634,2071,2972,1.0,0.3031628532974428,0.6968371467025573,1401,0.3152759084791386,0.2133243606998654,0.47139973082099595
751,1134523,407,159,163,94,248,407,1.0,0.3906633906633907,0.6093366093366094,150,0.4004914004914005,0.23095823095823095,0.36855036855036855
752,1134525,2017,444,418,251,1573,2017,1.0,0.22012890431333665,0.7798710956866634,1348,0.2072384729796728,0.12444224095190877,0.6683192860684184
753,1134527,2200,6,358,240,2194,2200,1.0,0.0027272727272727275,0.9972727272727273,1602,0.16272727272727272,0.10909090909090909,0.7281818181818182
754,1134528,5,0,0,0,5,5,1.0,0.0,1.0,5,0.0,0.0,1.0
755,1134529,805,206,256,194,599,805,1.0,0.25590062111801243,0.7440993788819876,355,0.31801242236024846,0.24099378881987576,0.4409937888198758
756,1134530,405,110,84,12,295,405,1.0,0.2716049382716049,0.7283950617283951,309,0.2074074074074074,0.02962962962962963,0.762962962962963
757,1134531,656,73,101,206,583,656,1.0,0.11128048780487805,0.8887195121951219,349,0.15396341463414634,0.31402439024390244,0.5320121951219512
758,1134532,340,22,53,82,318,340,1.0,0.06470588235294118,0.9352941176470588,205,0.15588235294117647,0.2411764705882353,0.6029411764705882
759,1134533,1419,311,234,167,1108,1419,1.0,0.21916842847075405,0.780831571529246,1018,0.1649048625792812,0.11768851303735024,0.7174066243833686
760,1134534,144,16,29,19,128,144,1.0,0.1111111111111111,0.8888888888888888,96,0.2013888888888889,0.13194444444444445,0.6666666666666666
761,1134535,712,42,167,88,670,712,1.0,0.05898876404494382,0.9410112359550562,457,0.2345505617977528,0.12359550561797752,0.6418539325842697
762,1134536,37,2,5,16,35,37,1.0,0.05405405405405406,0.9459459459459459,16,0.13513513513513514,0.43243243243243246,0.43243243243243246
763,1134537,3,0,3,0,3,3,1.5,0.0,1.0,0,1.0,0.0,0.0
764,1134538,1706,625,270,151,1081,1706,1.0,0.36635404454865184,0.6336459554513482,1285,0.15826494724501758,0.08851113716295428,0.7532239155920282
769,1134600,2162,300,475,678,1862,2162,1.0,0.13876040703052728,0.8612395929694727,1009,0.21970397779833487,0.3135985198889917,0.46669750231267343
770,1134601,4374,215,840,1249,4159,4374,1.0,0.04915409236396891,0.950845907636031,2285,0.19204389574759945,0.2855509830818473,0.5224051211705533
771,1134602,1947,146,444,570,1801,1947,1.0,0.07498715973292244,0.9250128402670775,933,0.2280431432973806,0.29275808936825887,0.47919876733436056
772,1134603,130,3,14,10,127,130,1.0,0.023076923076923078,0.9769230769230769,106,0.1076923076923077,0.07692307692307693,0.8153846153846154
773,1134604,3404,210,718,713,3194,3404,1.0,0.06169212690951821,0.9383078730904818,1973,0.2109283196239718,0.20945945945945946,0.5796122209165687
774,1134605,2749,265,585,686,2484,2749,1.0,0.09639869043288468,0.9036013095671153,1478,0.21280465623863223,0.2495452891960713,0.5376500545652965
775,1134606,3590,175,680,795,3415,3590,1.0,0.04874651810584958,0.9512534818941504,2115,0.1894150417827298,0.2214484679665738,0.5891364902506964
776,1134607,1988,178,477,336,1810,1988,1.0,0.08953722334004025,0.9104627766599598,1175,0.23993963782696176,0.16901408450704225,0.5910462776659959
777,1134608A,3984,1457,992,642,2527,3984,1.0,0.3657128514056225,0.6342871485943775,2350,0.24899598393574296,0.16114457831325302,0.589859437751004
779,1134609,2598,867,643,222,1731,2598,1.0,0.33371824480369516,0.6662817551963048,1733,0.24749807544264818,0.08545034642032333,0.6670515781370285
780,1134610,2200,137,541,846,2063,2200,1.0,0.06227272727272727,0.9377272727272727,813,0.2459090909090909,0.3845454545454545,0.36954545454545457
781,1134611,2047,123,371,446,1924,2047,1.0,0.06008793356130923,0.9399120664386907,1230,0.18124084025403028,0.21787982413287738,0.6008793356130924
782,1134612,269,14,59,125,255,269,1.0,0.05204460966542751,0.9479553903345725,85,0.21933085501858737,0.4646840148698885,0.3159851301115242
783,1134614,380,7,80,264,373,380,1.0,0.018421052631578946,0.9815789473684211,36,0.21052631578947367,0.6947368421052632,0.09473684210526316
784,1134615,205,41,70,40,164,205,1.0,0.2,0.8,95,0.34146341463414637,0.1951219512195122,0.4634146341463415
785,1134616,1553,71,319,209,1482,1553,1.0,0.04571796522858983,0.9542820347714102,1025,0.20540888602704443,0.13457823567289118,0.6600128783000644
786,1134617,189,6,37,63,183,189,1.0,0.031746031746031744,0.9682539682539683,89,0.19576719576719576,0.3333333333333333,0.4708994708994709
787,1134618,1001,0,111,138,1001,1001,1.0,0.0,1.0,752,0.1108891108891109,0.13786213786213786,0.7512487512487512
788,1134619,1375,65,266,550,1310,1375,1.0,0.04727272727272727,0.9527272727272728,559,0.19345454545454546,0.4,0.40654545454545454
789,1134620,1674,144,345,497,1530,1674,1.0,0.08602150537634409,0.9139784946236559,832,0.2060931899641577,0.2968936678614098,0.4970131421744325
790,1134621,4302,1289,1210,576,3013,4302,1.0,0.299628079962808,0.700371920037192,2516,0.2812645281264528,0.13389121338912133,0.5848442584844259
791,1134622,2156,190,534,560,1966,2156,1.0,0.08812615955473098,0.911873840445269,1062,0.24768089053803338,0.2597402597402597,0.49257884972170685
792,1134623,2630,385,627,587,2245,2630,1.0,0.14638783269961977,0.8536121673003803,1416,0.23840304182509506,0.2231939163498099,0.538403041825095
793,1134624,1894,176,417,514,1718,1894,1.0,0.09292502639915523,0.9070749736008448,963,0.220168954593453,0.2713833157338965,0.5084477296726505
794,1134625,2793,397,492,743,2396,2793,1.0,0.14214106695309703,0.857858933046903,1558,0.1761546723952739,0.26602219835302543,0.5578231292517006
795,1134626,2440,204,564,983,2236,2440,1.0,0.08360655737704918,0.9163934426229509,893,0.23114754098360657,0.4028688524590164,0.36598360655737705
796,1134627A,5354,1060,704,955,4294,5354,1.0,0.1979828165857303,0.8020171834142698,3695,0.13149047441165485,0.17837131116921928,0.6901382144191259
798,1134628,2770,1508,894,263,1262,2770,1.0,0.5444043321299639,0.4555956678700361,1613,0.3227436823104693,0.09494584837545127,0.5823104693140794
799,1134629,1545,344,356,241,1201,1545,1.0,0.2226537216828479,0.7773462783171521,948,0.23042071197411004,0.15598705501618124,0.6135922330097088
800,1134630,1367,107,367,540,1260,1367,1.0,0.07827359180687637,0.9217264081931237,460,0.26847110460863205,0.3950256035113387,0.33650329188002925
801,1134631,1053,98,311,468,955,1053,1.0,0.09306742640075974,0.9069325735992403,274,0.29534662867996203,0.4444444444444444,0.26020892687559355
802,1134632,2287,911,437,178,1376,2287,1.0,0.3983384346305203,0.6016615653694797,1672,0.1910800174901618,0.07783121993878443,0.7310887625710538
803,1134633,1026,404,321,144,622,1026,1.0,0.3937621832358674,0.6062378167641326,561,0.3128654970760234,0.14035087719298245,0.5467836257309941
804,1134634,3225,508,584,817,2717,3225,1.0,0.15751937984496123,0.8424806201550388,1824,0.18108527131782945,0.25333333333333335,0.5655813953488372
805,1134635,1966,641,477,346,1325,1966,1.0,0.32604272634791454,0.6739572736520855,1143,0.24262461851475076,0.17599186164801628,0.5813835198372329
807,1134637,3927,574,666,747,3353,3927,1.0,0.14616755793226383,0.8538324420677362,2514,0.16959511077158135,0.19022154316271964,0.640183346065699
808,1134639,874,181,171,94,693,874,1.0,0.20709382151029748,0.7929061784897025,609,0.1956521739130435,0.10755148741418764,0.6967963386727689
809,1134640,3483,1236,972,447,2247,3483,1.0,0.35486649440137813,0.6451335055986219,2064,0.27906976744186046,0.12833763996554695,0.5925925925925926
810,1134641,544,0,139,151,544,544,1.0,0.0,1.0,254,0.2555147058823529,0.2775735294117647,0.46691176470588236
811,1134642,176,25,38,46,151,176,1.0,0.14204545454545456,0.8579545454545454,92,0.2159090909090909,0.26136363636363635,0.5227272727272727
812,1134644,13,6,7,5,7,13,1.7142857142857142,0.46153846153846156,0.5384615384615384,1,0.5384615384615384,0.38461538461538464,0.07692307692307693
813,1134645,3,0,2,1,3,3,1.0,0.0,1.0,0,0.6666666666666666,0.3333333333333333,0.0
814,1134646,729,12,108,141,717,729,1.0,0.01646090534979424,0.9835390946502057,480,0.14814814814814814,0.1934156378600823,0.6584362139917695
815,1134647,3407,588,869,1210,2819,3407,1.0,0.17258585265629586,0.8274141473437041,1328,0.2550631053712944,0.3551511593777517,0.3897857352509539
816,1134648,3178,1491,870,291,1687,3178,1.0,0.46916299559471364,0.5308370044052864,2017,0.2737570799244808,0.09156702328508495,0.6346758967904342
817,1134649,275,9,10,5,266,275,1.0,0.03272727272727273,0.9672727272727273,260,0.03636363636363636,0.01818181818181818,0.9454545454545454
818,1134651,125,28,11,4,97,125,1.0,0.224,0.776,110,0.088,0.032,0.88
819,1134652,790,14,188,129,776,790,1.0,0.017721518987341773,0.9822784810126582,473,0.2379746835443038,0.16329113924050634,0.5987341772151898
820,1134653,302,20,25,7,282,302,1.0,0.06622516556291391,0.9337748344370861,270,0.08278145695364239,0.023178807947019868,0.8940397350993378
821,1134654,1597,173,312,289,1424,1597,1.0,0.10832811521603006,0.89167188478397,996,0.19536631183469005,0.18096430807764557,0.6236693800876644
822,1134655,39,3,4,34,36,39,1.4615384615384615,0.07692307692307693,0.9230769230769231,1,0.10256410256410256,0.8717948717948718,0.02564102564102564
823,1134656,124,0,29,17,124,124,1.0,0.0,1.0,78,0.23387096774193547,0.13709677419354838,0.6290322580645161
824,1134657,208,42,10,12,166,208,1.0,0.20192307692307693,0.7980769230769231,186,0.04807692307692308,0.057692307692307696,0.8942307692307693
825,1134658,114,2,30,24,112,114,1.0,0.017543859649122806,0.9824561403508771,60,0.2631578947368421,0.21052631578947367,0.5263157894736842
826,1134659,244,18,54,47,226,244,1.0,0.07377049180327869,0.9262295081967213,143,0.22131147540983606,0.19262295081967212,0.5860655737704918
827,1134660,47,3,8,13,44,47,1.0,0.06382978723404255,0.9361702127659575,26,0.1702127659574468,0.2765957446808511,0.5531914893617021
828,1134661,1081,47,219,135,1034,1081,1.0,0.043478260869565216,0.9565217391304348,727,0.20259019426456984,0.12488436632747456,0.6725254394079556
829,1134662,423,11,58,71,412,423,1.0,0.026004728132387706,0.9739952718676123,294,0.13711583924349882,0.16784869976359337,0.6950354609929078
831,1134664,1957,395,243,176,1562,1957,1.0,0.20183955033214104,0.7981604496678589,1538,0.12416964741951968,0.08993357179356157,0.7858967807869187
832,1150001,3317,598,317,287,2719,3317,1.0,0.18028338860416038,0.8197166113958396,2713,0.09556828459451311,0.08652396744045825,0.8179077479650286
833,1150002,1728,45,304,339,1683,1728,1.0,0.026041666666666668,0.9739583333333334,1085,0.17592592592592593,0.19618055555555555,0.6278935185185185
834,1150003,1927,20,183,826,1907,1927,1.0,0.010378827192527244,0.9896211728074727,918,0.09496626881162429,0.4286455630513752,0.4763881681370005
835,1150004,1742,90,168,756,1652,1742,1.0,0.05166475315729047,0.9483352468427095,818,0.09644087256027555,0.43398392652123996,0.4695752009184845
836,1150005,118,0,9,73,118,118,1.0,0.0,1.0,36,0.07627118644067797,0.6186440677966102,0.3050847457627119
837,1150011,187,0,19,111,187,187,1.0,0.0,1.0,57,0.10160427807486631,0.5935828877005348,0.3048128342245989
838,1150012,59,0,4,45,59,59,1.0,0.0,1.0,10,0.06779661016949153,0.7627118644067796,0.1694915254237288
839,1150013,125,0,7,96,125,125,1.0,0.0,1.0,22,0.056,0.768,0.176
840,1150017,99,0,8,58,99,99,1.0,0.0,1.0,33,0.08080808080808081,0.5858585858585859,0.3333333333333333
841,1170001,2273,21,270,598,2252,2273,1.0,0.009238891333040036,0.99076110866696,1405,0.11878574571051474,0.2630884293884734,0.6181258249010119
842,1170002,2353,17,301,604,2336,2353,1.0,0.007224819379515512,0.9927751806204845,1448,0.12792180195495112,0.2566935826604335,0.6153846153846154
843,1170003,3499,20,373,1138,3479,3499,1.0,0.005715918833952558,0.9942840811660475,1988,0.1066018862532152,0.32523578165190054,0.5681623320948842
844,1170004,2502,44,295,702,2458,2502,1.0,0.017585931254996003,0.982414068745004,1505,0.11790567545963229,0.2805755395683453,0.6015187849720224
845,1190001,760,77,65,357,683,760,1.0,0.1013157894736842,0.8986842105263158,338,0.08552631578947369,0.4697368421052632,0.44473684210526315
846,1190003,627,84,111,169,543,627,1.0,0.1339712918660287,0.8660287081339713,347,0.17703349282296652,0.26953748006379585,0.5534290271132376
847,1190004,672,59,66,240,613,672,1.0,0.08779761904761904,0.9122023809523809,366,0.09821428571428571,0.35714285714285715,0.5446428571428571
848,1190005,994,36,87,354,958,994,1.0,0.03621730382293763,0.9637826961770624,553,0.0875251509054326,0.3561368209255533,0.5563380281690141
849,1190007,276,0,34,111,276,276,1.0,0.0,1.0,131,0.12318840579710146,0.40217391304347827,0.4746376811594203
850,1190009,239,0,31,139,239,239,1.0,0.0,1.0,69,0.1297071129707113,0.5815899581589958,0.28870292887029286
851,1190010,394,1,60,154,393,394,1.0,0.0025380710659898475,0.9974619289340102,180,0.15228426395939088,0.39086294416243655,0.45685279187817257
852,1211000,3275,0,272,1294,3275,3275,1.0,0.0,1.0,1709,0.08305343511450382,0.3951145038167939,0.5218320610687023
853,1211001,1817,11,166,732,1806,1817,1.0,0.006053935057787562,0.9939460649422125,919,0.09135938359933957,0.40286186020913595,0.5057787561915245
854,1211002,5416,257,412,1574,5159,5416,1.0,0.047451994091580504,0.9525480059084195,3430,0.07607090103397342,0.29062038404726737,0.6333087149187593
855,1211003,4109,40,349,1429,4069,4109,1.0,0.009734728644439037,0.990265271355561,2331,0.0849355074227306,0.34777318082258457,0.5672913117546848
856,1211005,3154,9,261,1072,3145,3154,1.0,0.0028535193405199747,0.99714648065948,1821,0.08275206087507926,0.3398858592263792,0.5773620798985415
857,1211006,4582,246,530,1460,4336,4582,1.0,0.053688345700567436,0.9463116542994325,2592,0.11567001309471846,0.3186381492797905,0.565691837625491
858,1211007,4417,474,384,1054,3943,4417,1.0,0.1073126556486303,0.8926873443513698,2979,0.08693683495585239,0.238623500113199,0.6744396649309486
859,1211008,1429,0,182,618,1429,1429,1.0,0.0,1.0,629,0.12736179146256124,0.4324702589223233,0.44016794961511546
860,1211009,3918,289,487,611,3629,3918,1.0,0.0737621235324145,0.9262378764675855,2820,0.12429811128126596,0.15594691168963756,0.7197549770290965
861,1211010,2601,120,554,1001,2481,2601,1.0,0.0461361014994233,0.9538638985005767,1046,0.21299500192233756,0.38485198000768933,0.4021530180699731
862,1211011,4085,395,769,856,3690,4085,1.0,0.0966952264381885,0.9033047735618115,2460,0.18824969400244798,0.209547123623011,0.602203182374541
863,1211012,2591,0,713,1043,2591,2591,1.0,0.0,1.0,835,0.2751833269008105,0.4025472790428406,0.3222693940563489
864,1211013,4499,618,579,830,3881,4499,1.0,0.13736385863525227,0.8626361413647478,3090,0.12869526561458103,0.18448544120915758,0.6868192931762613
865,1211014,510,95,77,31,415,510,1.0,0.18627450980392157,0.8137254901960784,402,0.15098039215686274,0.060784313725490195,0.788235294117647
866,1211015,3025,95,590,1115,2930,3025,1.0,0.03140495867768595,0.968595041322314,1320,0.19504132231404958,0.3685950413223141,0.43636363636363634
867,1211016,3127,187,528,1195,2940,3127,1.0,0.059801726894787334,0.9401982731052126,1404,0.16885193476175248,0.38215542053086027,0.44899264470738726
868,1211017,726,39,194,373,687,726,1.0,0.05371900826446281,0.9462809917355371,159,0.26721763085399447,0.5137741046831956,0.2190082644628099
869,1211018,5869,572,947,1695,5297,5869,1.0,0.09746123700800818,0.9025387629919919,3227,0.16135627875276878,0.28880558868631795,0.5498381325609133
870,1211019,4315,334,564,805,3981,4315,1.0,0.07740440324449595,0.9225955967555041,2946,0.13070683661645424,0.186558516801854,0.6827346465816918
871,1211020,3724,137,576,2029,3587,3724,1.0,0.03678839957035446,0.9632116004296455,1119,0.15467239527389903,0.5448442534908701,0.30048335123523096
872,1211021,3325,189,551,1438,3136,3325,1.0,0.056842105263157895,0.9431578947368421,1336,0.1657142857142857,0.4324812030075188,0.4018045112781955
873,1211022,3902,355,455,1173,3547,3902,1.0,0.09097898513582778,0.9090210148641722,2274,0.11660686827268067,0.30061506919528447,0.5827780625320349
874,1211023,4334,239,595,1642,4095,4334,1.0,0.05514536225196124,0.9448546377480388,2097,0.1372865712967236,0.3788647900323027,0.4838486386709737
875,1211025,3563,252,363,1171,3311,3563,1.0,0.07072691552062868,0.9292730844793713,2029,0.10188043783328656,0.3286556272803817,0.5694639348863317
876,1211026,4901,700,659,800,4201,4901,1.0,0.14282799428688023,0.8571720057131198,3442,0.13446235462150583,0.16323199347072026,0.7023056519077739
877,1211028,1975,339,257,310,1636,1975,1.0,0.17164556962025315,0.8283544303797469,1408,0.130126582278481,0.1569620253164557,0.7129113924050633
878,1211029,5787,833,983,1752,4954,5787,1.0,0.14394332123725592,0.856056678762744,3052,0.1698634871263176,0.30274753758424056,0.5273889752894418
879,1211030,4362,194,496,1703,4168,4362,1.0,0.044475011462631824,0.9555249885373682,2163,0.11370930765703806,0.39041723979825765,0.4958734525447043
880,1211031,2644,234,349,918,2410,2644,1.0,0.08850226928895613,0.9114977307110439,1377,0.13199697428139184,0.3472012102874433,0.5208018154311649
881,1211033,2372,229,319,770,2143,2372,1.0,0.09654300168634064,0.9034569983136593,1283,0.13448566610455312,0.3246205733558179,0.540893760539629
882,1211034,4820,389,555,1577,4431,4820,1.0,0.08070539419087137,0.9192946058091286,2688,0.11514522821576763,0.3271784232365145,0.5576763485477179
883,1211035,3934,220,566,1910,3714,3934,1.0,0.05592272496187087,0.9440772750381291,1458,0.14387391967463142,0.485510930350788,0.37061514997458056
884,1211036,4428,222,576,1425,4206,4428,1.0,0.05013550135501355,0.9498644986449865,2427,0.13008130081300814,0.3218157181571816,0.5481029810298103
885,1211037,791,3,94,253,788,791,1.0,0.0037926675094816687,0.9962073324905183,444,0.11883691529709228,0.3198482932996207,0.561314791403287
886,1211038,379,26,41,138,353,379,1.0,0.06860158311345646,0.9313984168865436,200,0.10817941952506596,0.3641160949868074,0.5277044854881267
888,1211040,2280,59,317,1091,2221,2280,1.0,0.02587719298245614,0.9741228070175438,872,0.13903508771929823,0.47850877192982455,0.3824561403508772
889,1211041,2303,649,323,558,1654,2303,1.0,0.28180633955709944,0.7181936604429006,1422,0.14025184541901867,0.24229266174554928,0.617455492835432
890,1211042,177,0,38,67,177,177,1.0,0.0,1.0,72,0.21468926553672316,0.3785310734463277,0.4067796610169492
891,1211043,267,0,78,135,267,267,1.0,0.0,1.0,54,0.29213483146067415,0.5056179775280899,0.20224719101123595
892,1211044,1594,440,104,181,1154,1594,1.0,0.27603513174404015,0.7239648682559598,1309,0.06524466750313676,0.11355081555834379,0.8212045169385195
893,1211045,1856,12,216,588,1844,1856,1.0,0.00646551724137931,0.9935344827586207,1052,0.11637931034482758,0.3168103448275862,0.5668103448275862
894,1211046,3746,162,733,1405,3584,3746,1.0,0.043246129204484784,0.9567538707955152,1608,0.1956753870795515,0.37506673785371064,0.42925787506673785
895,1211047,991,140,90,299,851,991,1.0,0.14127144298688193,0.858728557013118,602,0.09081735620585267,0.30171543895055497,0.6074672048435923
896,1211048,651,0,109,341,651,651,1.0,0.0,1.0,201,0.1674347158218126,0.5238095238095238,0.3087557603686636
897,1211049,16,2,0,0,14,16,1.0,0.125,0.875,16,0.0,0.0,1.0
898,1211050,682,60,66,122,622,682,1.0,0.08797653958944282,0.9120234604105572,494,0.0967741935483871,0.17888563049853373,0.7243401759530792
899,1211051,1980,15,273,718,1965,1980,1.0,0.007575757575757576,0.9924242424242424,989,0.13787878787878788,0.36262626262626263,0.4994949494949495
900,1211052,1515,85,120,289,1430,1515,1.0,0.056105610561056105,0.9438943894389439,1106,0.07920792079207921,0.19075907590759075,0.73003300330033
901,1212000,5922,1904,1218,566,4018,5922,1.0,0.3215130023640662,0.6784869976359338,4138,0.20567375886524822,0.09557581898007429,0.6987504221546774
902,1212001,6777,2628,1035,492,4149,6777,1.0,0.38778220451527223,0.6122177954847278,5250,0.15272244355909695,0.07259849490925188,0.7746790615316512
903,1212002,7039,2368,1558,959,4671,7039,1.0,0.3364114220769996,0.6635885779230004,4522,0.2213382582753232,0.1362409433158119,0.6424207984088649
904,1212003,2288,299,509,622,1989,2288,1.0,0.13068181818181818,0.8693181818181818,1157,0.22246503496503497,0.2718531468531469,0.5056818181818182
905,1212004,4159,575,872,959,3584,4159,1.0,0.13825438807405627,0.8617456119259438,2328,0.20966578504448186,0.23058427506612167,0.5597499398893965
906,1212005,4118,297,947,1818,3821,4118,1.0,0.07212238950947061,0.9278776104905294,1353,0.22996600291403593,0.44147644487615345,0.3285575522098106
907,1212006,3415,292,641,1191,3123,3415,1.0,0.08550512445095168,0.9144948755490483,1583,0.187701317715959,0.3487554904831625,0.4635431918008785
908,1212007,4549,730,741,748,3819,4549,1.0,0.16047482963288634,0.8395251703671136,3060,0.16289294350406683,0.1644317432402726,0.6726753132556605
909,1212008,3930,478,906,1040,3452,3930,1.0,0.12162849872773537,0.8783715012722646,1984,0.23053435114503817,0.26463104325699743,0.5048346055979643
910,1212009,3032,207,540,945,2825,3032,1.0,0.06827176781002639,0.9317282321899736,1547,0.17810026385224276,0.3116754617414248,0.5102242744063324
911,1212010,4946,508,945,1600,4438,4946,1.0,0.10270926000808735,0.8972907399919127,2401,0.19106348564496564,0.3234937323089365,0.48544278204609786
912,1212011,4091,462,767,999,3629,4091,1.0,0.11293082375947201,0.887069176240528,2325,0.18748472256172086,0.24419457345392326,0.5683207039843559
913,1212012,2008,280,254,870,1728,2008,1.0,0.1394422310756972,0.8605577689243028,884,0.12649402390438247,0.43326693227091634,0.4402390438247012
914,1212013,2050,69,336,763,1981,2050,1.0,0.033658536585365856,0.9663414634146341,951,0.16390243902439025,0.3721951219512195,0.46390243902439027
915,1212014,2681,191,522,1162,2490,2681,1.0,0.0712420738530399,0.9287579261469601,997,0.1947034688549049,0.43342036553524804,0.3718761656098471
916,1212016,5291,901,699,1091,4390,5291,1.0,0.1702891702891703,0.8297108297108297,3501,0.13211113211113212,0.2061992061992062,0.6616896616896617
917,1212017,5309,513,807,2206,4796,5309,1.0,0.09662836692409117,0.9033716330759088,2296,0.1520060275004709,0.41552081371256355,0.4324731587869655
918,1212018,3755,351,312,401,3404,3755,1.0,0.09347536617842876,0.9065246338215712,3042,0.08308921438082556,0.10679094540612516,0.8101198402130493
919,1212019,8,0,2,0,8,8,1.0,0.0,1.0,6,0.25,0.0,0.75
920,1212021,5032,794,938,1315,4238,5032,1.0,0.15779014308426073,0.8422098569157392,2779,0.18640699523052465,0.2613275039745628,0.5522655007949125
921,1212022,3370,183,546,1196,3187,3370,1.0,0.0543026706231454,0.9456973293768546,1628,0.16201780415430267,0.3548961424332344,0.4830860534124629
922,1212023,4544,608,839,1267,3936,4544,1.0,0.13380281690140844,0.8661971830985915,2438,0.18463908450704225,0.2788292253521127,0.5365316901408451
923,1212024,2750,121,416,836,2629,2750,1.0,0.044,0.956,1498,0.15127272727272728,0.304,0.5447272727272727
924,1212025,2670,189,469,758,2481,2670,1.0,0.07078651685393259,0.9292134831460674,1443,0.1756554307116105,0.28389513108614234,0.5404494382022472
925,1212026,4512,530,687,1433,3982,4512,1.0,0.1174645390070922,0.8825354609929078,2392,0.15226063829787234,0.31759751773049644,0.5301418439716312
926,1212027,3600,304,323,683,3296,3600,1.0,0.08444444444444445,0.9155555555555556,2594,0.08972222222222222,0.1897222222222222,0.7205555555555555
927,1212028,6117,1211,771,1005,4906,6117,1.0,0.1979728625143044,0.8020271374856957,4341,0.12604217753800884,0.16429622363903876,0.7096615988229524
928,1212029,2384,442,333,500,1942,2384,1.0,0.18540268456375839,0.8145973154362416,1551,0.13968120805369127,0.20973154362416108,0.6505872483221476
929,1212030,7552,1401,1156,1462,6151,7552,1.0,0.1855137711864407,0.8144862288135594,4934,0.1530720338983051,0.19359110169491525,0.6533368644067796
930,1212031,4405,1043,438,658,3362,4405,1.0,0.23677639046538024,0.7632236095346198,3309,0.09943246311010216,0.14937570942111236,0.7511918274687854
931,1212033,4224,761,817,827,3463,4224,1.0,0.18016098484848486,0.8198390151515151,2580,0.1934185606060606,0.19578598484848486,0.6107954545454546
932,1212034,935,95,48,131,840,935,1.0,0.10160427807486631,0.8983957219251337,756,0.051336898395721926,0.14010695187165775,0.8085561497326204
933,1212035,2722,163,180,235,2559,2722,1.0,0.05988243938280676,0.9401175606171932,2307,0.06612784717119764,0.08633357825128582,0.8475385745775166
937,1213000,5655,169,688,1578,5486,5655,1.0,0.029885057471264367,0.9701149425287356,3389,0.12166224580017683,0.2790450928381963,0.5992926613616268
938,1213001,3104,121,390,1096,2983,3104,1.0,0.0389819587628866,0.9610180412371134,1618,0.12564432989690721,0.35309278350515466,0.5212628865979382
939,1213002,4135,114,659,2215,4021,4135,1.0,0.027569528415961306,0.9724304715840387,1261,0.15937122128174122,0.535671100362757,0.3049576783555018
940,1213003,2694,222,438,1130,2472,2694,1.0,0.08240534521158129,0.9175946547884187,1126,0.16258351893095768,0.4194506310319228,0.4179658500371195
941,1213004,3291,28,476,1655,3263,3291,1.0,0.00850805226374962,0.9914919477362504,1160,0.14463688848374354,0.5028866605894865,0.35247645092677
942,1213005,1890,13,317,1027,1877,1890,1.0,0.0068783068783068784,0.9931216931216931,546,0.16772486772486772,0.5433862433862434,0.28888888888888886
943,1213006,3644,369,760,1486,3275,3644,1.0,0.10126234906695938,0.8987376509330406,1398,0.20856201975850713,0.40779363336992314,0.38364434687156973
944,1213007,4661,654,1045,1388,4007,4661,1.0,0.14031323750268182,0.8596867624973181,2228,0.2242008152756919,0.2977901737824501,0.478009010941858
945,1213008,3579,210,660,1246,3369,3579,1.0,0.0586756077116513,0.9413243922883487,1673,0.18440905280804695,0.34814193908913105,0.46744900810282203
946,1213009,3189,70,548,1112,3119,3189,1.0,0.021950454687989965,0.97804954531201,1529,0.17184070241455002,0.3486986516149263,0.4794606459705237
947,1213010,6191,474,1032,1425,5717,6191,1.0,0.07656275238249072,0.9234372476175093,3734,0.16669358746567597,0.2301728315296398,0.6031335810046842
948,1213011,6279,844,1117,1179,5435,6279,1.0,0.1344163083293518,0.8655836916706482,3983,0.17789456919891702,0.1877687529861443,0.6343366778149386
949,1213012,1934,208,381,706,1726,1934,1.0,0.10754912099276112,0.8924508790072389,847,0.1970010341261634,0.3650465356773526,0.43795243019648394
950,1213013,2555,221,457,897,2334,2555,1.0,0.08649706457925636,0.9135029354207437,1201,0.17886497064579257,0.35107632093933466,0.4700587084148728
951,1213014,2219,237,504,822,1982,2219,1.0,0.106804867057233,0.893195132942767,893,0.22712933753943218,0.3704371338440739,0.4024335286164939
952,1213015,2577,450,614,702,2127,2577,1.0,0.17462165308498254,0.8253783469150174,1261,0.23826154443150951,0.2724097788125728,0.48932867675591774
953,1213017,6828,1789,1084,606,5039,6828,1.0,0.2620093731693029,0.7379906268306972,5138,0.15875805506736965,0.08875219683655536,0.7524897480960749
954,1213018,1990,264,241,321,1726,1990,1.0,0.13266331658291458,0.8673366834170855,1428,0.12110552763819095,0.16130653266331657,0.7175879396984924
955,1213019,6693,1386,1170,990,5307,6693,1.0,0.20708202599731063,0.7929179740026894,4533,0.17480950246526222,0.14791573285522186,0.6772747646795159
956,1213020,537,13,62,59,524,537,1.0,0.024208566108007448,0.9757914338919925,416,0.1154562383612663,0.10986964618249534,0.7746741154562383
957,1213021,6179,845,768,1197,5334,6179,1.0,0.13675351998705293,0.8632464800129471,4214,0.12429195662728597,0.19372066677455899,0.681987376598155
958,1213022,75,13,16,45,62,75,1.0,0.17333333333333334,0.8266666666666667,14,0.21333333333333335,0.6,0.18666666666666668
959,1213023,415,40,107,140,375,415,1.0,0.0963855421686747,0.9036144578313253,168,0.25783132530120484,0.3373493975903614,0.40481927710843374
960,1213024,3080,175,510,1380,2905,3080,1.0,0.056818181818181816,0.9431818181818182,1190,0.16558441558441558,0.44805194805194803,0.38636363636363635
961,1213025,3311,193,541,1551,3118,3311,1.0,0.058290546662639685,0.9417094533373603,1219,0.16339474479009364,0.4684385382059801,0.3681667170039263
962,1213026,2612,241,479,1093,2371,2612,1.0,0.09226646248085758,0.9077335375191424,1040,0.1833843797856049,0.4184532924961715,0.3981623277182236
963,1213027,4670,90,883,2049,4580,4670,1.0,0.019271948608137045,0.9807280513918629,1738,0.1890792291220557,0.4387580299785867,0.3721627408993576
964,1213028,4089,109,695,1862,3980,4089,1.0,0.026656884323795548,0.9733431156762045,1532,0.16996820738566887,0.4553680606505258,0.3746637319638053
965,1213029,3163,140,528,1032,3023,3163,1.0,0.044261776794182736,0.9557382232058172,1603,0.1669301296237749,0.32627252608283275,0.5067973442933924
966,1213030,3230,375,444,1192,2855,3230,1.0,0.11609907120743033,0.8839009287925697,1594,0.13746130030959752,0.3690402476780186,0.4934984520123839
967,1213031,3242,225,541,1358,3017,3242,1.0,0.06940160394818014,0.9305983960518198,1343,0.16687230104873535,0.418877236273905,0.41425046267735965
968,1213032,2574,545,388,327,2029,2574,1.0,0.21173271173271174,0.7882672882672883,1859,0.15073815073815075,0.12703962703962704,0.7222222222222222
969,1213033,2510,90,313,834,2420,2510,1.0,0.035856573705179286,0.9641434262948207,1363,0.12470119521912351,0.3322709163346614,0.5430278884462152
972,1214000,4634,34,435,1789,4600,4634,1.0,0.0073370738023306,0.9926629261976694,2410,0.09387138541217091,0.3860595597755719,0.5200690548122572
973,1214001,2023,2,173,601,2021,2023,1.0,0.0009886307464162135,0.9990113692535838,1249,0.08551655956500247,0.2970835392980722,0.6173999011369253
974,1214002,4209,60,300,1498,4149,4209,1.0,0.014255167498218105,0.9857448325017819,2411,0.07127583749109052,0.355904015205512,0.5728201473033975
975,1214003,3211,65,354,1421,3146,3211,1.0,0.020242914979757085,0.979757085020243,1436,0.11024602927436936,0.4425412644036126,0.44721270632201804
976,1214004,3533,730,616,389,2803,3533,1.0,0.20662326634588168,0.7933767336541183,2528,0.17435607132748374,0.11010472686102463,0.7155392018114917
977,1214005,2968,155,530,720,2813,2968,1.0,0.052223719676549867,0.9477762803234502,1718,0.17857142857142858,0.24258760107816713,0.5788409703504043
978,1214006,2625,70,687,618,2555,2625,1.0,0.02666666666666667,0.9733333333333334,1320,0.26171428571428573,0.23542857142857143,0.5028571428571429
979,1214007,2973,104,568,289,2869,2973,1.0,0.03498150016818029,0.9650184998318198,2116,0.19105280861083082,0.09720820719811638,0.7117389841910529
980,1214008,1827,132,514,274,1695,1827,1.0,0.0722495894909688,0.9277504105090312,1039,0.2813355227148331,0.1499726327312534,0.5686918445539135
981,1214009,5870,713,998,566,5157,5870,1.0,0.12146507666098807,0.878534923339012,4306,0.17001703577512778,0.09642248722316865,0.7335604770017036
982,1214010,2420,340,400,447,2080,2420,1.0,0.14049586776859505,0.859504132231405,1573,0.1652892561983471,0.1847107438016529,0.65
983,1214011,8049,2157,1578,806,5892,8049,1.0,0.26798360044726055,0.7320163995527394,5665,0.1960491986582184,0.1001366629394956,0.703814138402286
984,1214012,2531,176,259,425,2355,2531,1.0,0.06953773212169104,0.930462267878309,1847,0.10233109442907941,0.1679178190438562,0.7297510865270644
985,1214013,359,29,45,13,330,359,1.0,0.0807799442896936,0.9192200557103064,301,0.12534818941504178,0.036211699164345405,0.8384401114206128
986,1214014,3199,590,470,124,2609,3199,1.0,0.18443263519849953,0.8155673648015005,2605,0.14692091278524538,0.03876211316036261,0.814316974054392
987,1214015,1465,110,192,149,1355,1465,1.0,0.07508532423208192,0.9249146757679181,1124,0.1310580204778157,0.10170648464163823,0.7672354948805461
988,1214016,7,0,1,1,7,7,1.0,0.0,1.0,5,0.14285714285714285,0.14285714285714285,0.7142857142857143
989,1214017,4128,62,373,2091,4066,4128,1.0,0.015019379844961241,0.9849806201550387,1664,0.09035852713178294,0.5065406976744186,0.40310077519379844
990,1214018,2345,68,222,854,2277,2345,1.0,0.028997867803837955,0.971002132196162,1269,0.09466950959488273,0.3641791044776119,0.5411513859275053
991,1214019,232,5,40,105,227,232,1.0,0.021551724137931036,0.978448275862069,87,0.1724137931034483,0.4525862068965517,0.375
992,1214020,988,21,134,508,967,988,1.0,0.02125506072874494,0.978744939271255,346,0.13562753036437247,0.5141700404858299,0.35020242914979755
993,1214021,2229,35,148,892,2194,2229,1.0,0.01570210856886496,0.984297891431135,1189,0.06639748766262898,0.40017945266935845,0.5334230596680125
994,1214022,2317,64,289,1383,2253,2317,1.0,0.02762192490289167,0.9723780750971083,645,0.1247302546396202,0.5968925334484246,0.27837721191195514
995,1214023A,2797,138,328,1500,2659,2797,1.0,0.0493385770468359,0.9506614229531641,969,0.11726850196639256,0.5362888809438684,0.346442617089739
997,1214024,3020,85,481,1589,2935,3020,1.0,0.028145695364238412,0.9718543046357616,950,0.15927152317880794,0.526158940397351,0.31456953642384106
998,1214025,3284,72,601,1371,3212,3284,1.0,0.02192448233861145,0.9780755176613886,1312,0.18300852618757613,0.4174786845310597,0.3995127892813642
999,1214026,1669,0,232,660,1669,1669,1.0,0.0,1.0,777,0.1390053924505692,0.39544637507489516,0.46554823247453564
1000,1214027,3772,83,652,1861,3689,3772,1.0,0.02200424178154825,0.9779957582184517,1259,0.1728525980911983,0.493372216330859,0.3337751855779427
1001,1214028,4427,92,495,2035,4335,4427,1.0,0.020781567653038176,0.9792184323469618,1897,0.11181386943754236,0.45967924102100743,0.42850688954145016
1002,1214029,199,4,12,43,195,199,1.0,0.020100502512562814,0.9798994974874372,144,0.06030150753768844,0.21608040201005024,0.7236180904522613
1003,1214030,609,25,71,233,584,609,1.0,0.041050903119868636,0.9589490968801314,305,0.11658456486042693,0.3825944170771757,0.5008210180623974
1004,1214031,3575,74,579,2295,3501,3575,1.0,0.0206993006993007,0.9793006993006993,701,0.16195804195804195,0.641958041958042,0.1960839160839161
1005,1214032,3476,65,424,1541,3411,3476,1.0,0.018699654775604143,0.9813003452243959,1511,0.12197928653624857,0.4433256616800921,0.43469505178365936
1006,1214033,3580,135,399,1079,3445,3580,1.0,0.03770949720670391,0.9622905027932961,2102,0.11145251396648044,0.30139664804469274,0.5871508379888268
1007,1214034,3958,309,539,1422,3649,3958,1.0,0.07806973218797372,0.9219302678120262,1997,0.13617988883274382,0.3592723597776655,0.5045477513895907
1008,1214035,2281,109,170,594,2172,2281,1.0,0.04778605874616396,0.9522139412538361,1517,0.07452871547566857,0.2604120999561596,0.6650591845681718
1009,1214036,2980,27,252,1014,2953,2980,1.0,0.009060402684563758,0.9909395973154362,1714,0.08456375838926175,0.3402684563758389,0.5751677852348993
1010,1214037,2418,357,402,252,2061,2418,1.0,0.14764267990074442,0.8523573200992556,1764,0.1662531017369727,0.10421836228287841,0.7295285359801489
1011,1214038,407,2,30,130,405,407,1.0,0.004914004914004914,0.995085995085995,247,0.07371007371007371,0.3194103194103194,0.6068796068796068
1012,1214039,3238,391,597,214,2847,3238,1.0,0.12075355157504633,0.8792464484249537,2427,0.18437306979617046,0.06609017912291539,0.7495367510809141
1013,1214040,1655,14,349,472,1641,1655,1.0,0.008459214501510574,0.9915407854984895,834,0.2108761329305136,0.2851963746223565,0.5039274924471299
1014,1214041,2473,172,222,373,2301,2473,1.0,0.06955115244642135,0.9304488475535786,1878,0.08976951071572989,0.15082895268904165,0.7594015365952285
1015,1214042,56,0,3,17,56,56,1.0,0.0,1.0,36,0.05357142857142857,0.30357142857142855,0.6428571428571429
1016,1214043,2723,61,315,1194,2662,2723,1.0,0.022401762761659935,0.97759823723834,1214,0.11568123393316196,0.43848696290855677,0.4458318031582813
1017,1214044,2726,38,316,1258,2688,2726,1.0,0.013939838591342627,0.9860601614086574,1152,0.11592076302274394,0.4614820249449743,0.42259721203228173
1018,1214045,6483,803,1046,538,5680,6483,1.0,0.12386240937837421,0.8761375906216258,4899,0.16134505630109516,0.08298627178775259,0.7556686719111523
1019,1214047,2383,116,160,432,2267,2383,1.0,0.04867813680234998,0.95132186319765,1791,0.06714225765841376,0.18128409567771717,0.751573646663869
1020,1214048,2286,159,264,699,2127,2286,1.0,0.06955380577427822,0.9304461942257218,1323,0.11548556430446194,0.30577427821522307,0.5787401574803149
1021,1214049,2818,15,210,812,2803,2818,1.0,0.00532292405961675,0.9946770759403832,1796,0.0745209368346345,0.2881476224272534,0.6373314407381121
1022,1230101,3301,421,170,755,2880,3301,1.0,0.12753710996667678,0.8724628900333232,2376,0.051499545592244775,0.22871857013026356,0.7197818842774917
1023,1230102,1864,578,375,157,1286,1864,1.0,0.31008583690987124,0.6899141630901288,1332,0.20118025751072963,0.0842274678111588,0.7145922746781116
1024,1230201,581,47,35,244,534,581,1.0,0.08089500860585198,0.919104991394148,302,0.060240963855421686,0.4199655765920826,0.5197934595524957
1025,1230202,1368,50,132,522,1318,1368,1.0,0.03654970760233918,0.9634502923976608,714,0.09649122807017543,0.3815789473684211,0.5219298245614035
1026,1230203,1133,71,92,455,1062,1133,1.0,0.06266548984995587,0.9373345101500441,586,0.08120035304501325,0.40158870255957635,0.5172109443954104
1027,1230301,1469,42,105,499,1427,1469,1.0,0.02859087814840027,0.9714091218515998,865,0.07147719537100068,0.33968686181075564,0.5888359428182437
1028,1230302,1348,72,191,675,1276,1348,1.0,0.05341246290801187,0.9465875370919882,482,0.14169139465875372,0.5007418397626113,0.35756676557863504
1029,1230303,391,7,38,183,384,391,1.0,0.017902813299232736,0.9820971867007673,170,0.09718670076726342,0.4680306905370844,0.43478260869565216
1030,1230401,2430,193,263,1020,2237,2430,1.0,0.0794238683127572,0.9205761316872428,1147,0.10823045267489712,0.41975308641975306,0.4720164609053498
1031,1230402,1218,13,66,612,1205,1218,1.0,0.010673234811165846,0.9893267651888341,540,0.054187192118226604,0.5024630541871922,0.4433497536945813
1032,1250001,122,0,15,80,122,122,1.0,0.0,1.0,27,0.12295081967213115,0.6557377049180327,0.22131147540983606
1033,1250002,128,0,21,68,128,128,1.0,0.0,1.0,39,0.1640625,0.53125,0.3046875
1034,1250003A,464,26,37,171,438,464,1.0,0.05603448275862069,0.9439655172413793,256,0.07974137931034483,0.36853448275862066,0.5517241379310345
1035,1250003B,68,3,5,25,65,68,1.0,0.04411764705882353,0.9558823529411765,38,0.07352941176470588,0.36764705882352944,0.5588235294117647
1036,1250004A,318,14,55,106,304,318,1.0,0.0440251572327044,0.9559748427672956,157,0.17295597484276728,0.3333333333333333,0.4937106918238994
1037,1250004B,13,0,3,5,13,13,1.0,0.0,1.0,5,0.23076923076923078,0.38461538461538464,0.38461538461538464
1038,1250005,238,1,34,138,237,238,1.0,0.004201680672268907,0.9957983193277311,66,0.14285714285714285,0.5798319327731093,0.2773109243697479
1039,1250006,279,11,46,200,268,279,1.0,0.03942652329749104,0.9605734767025089,33,0.16487455197132617,0.7168458781362007,0.11827956989247312
1040,1270001,1811,0,407,263,1811,1811,1.0,0.0,1.0,1141,0.22473771397018222,0.14522363335173938,0.6300386526780785
1041,1270002,1741,0,568,180,1741,1741,1.0,0.0,1.0,993,0.3262492820218265,0.10338885697874785,0.5703618609994257
1042,1270003,725,0,177,52,725,725,1.0,0.0,1.0,496,0.24413793103448275,0.07172413793103448,0.6841379310344827
1043,1270004,150,0,26,30,150,150,1.0,0.0,1.0,94,0.17333333333333334,0.2,0.6266666666666667
1044,1270005,805,4,440,57,801,805,1.0,0.004968944099378882,0.9950310559006211,308,0.546583850931677,0.07080745341614907,0.3826086956521739
1045,1270006,1268,1,306,121,1267,1268,1.0,0.0007886435331230284,0.999211356466877,841,0.24132492113564669,0.09542586750788644,0.6632492113564669
1046,1270007,568,1,217,59,567,568,1.0,0.0017605633802816902,0.9982394366197183,292,0.38204225352112675,0.10387323943661972,0.5140845070422535
1047,1290101,407,21,27,150,386,407,1.0,0.051597051597051594,0.9484029484029484,230,0.06633906633906633,0.36855036855036855,0.5651105651105651
1048,1290102,336,7,36,157,329,336,1.0,0.020833333333333332,0.9791666666666666,143,0.10714285714285714,0.46726190476190477,0.4255952380952381
1049,1290201,750,44,64,394,706,750,1.0,0.058666666666666666,0.9413333333333334,292,0.08533333333333333,0.5253333333333333,0.3893333333333333
1050,1290301,229,9,8,139,220,229,1.0,0.039301310043668124,0.9606986899563319,82,0.034934497816593885,0.6069868995633187,0.35807860262008734
1051,1290303,366,0,34,174,366,366,1.0,0.0,1.0,158,0.09289617486338798,0.47540983606557374,0.43169398907103823
1052,1290401,571,42,57,272,529,571,1.0,0.07355516637478109,0.9264448336252189,242,0.09982486865148861,0.4763572679509632,0.4238178633975482
1053,1310001,1621,24,960,175,1597,1621,1.0,0.014805675508945095,0.9851943244910549,486,0.5922270203578038,0.107958050586058,0.2998149290561382
1054,1310002,1526,0,692,108,1526,1526,1.0,0.0,1.0,726,0.4534731323722149,0.07077326343381389,0.47575360419397117
1055,1310003,559,0,190,52,559,559,1.0,0.0,1.0,317,0.33989266547406083,0.09302325581395349,0.5670840787119857
1056,1310004,353,0,66,49,353,353,1.0,0.0,1.0,238,0.18696883852691218,0.1388101983002833,0.6742209631728046
1057,1310005,422,41,132,46,381,422,1.0,0.0971563981042654,0.9028436018957346,244,0.3127962085308057,0.10900473933649289,0.5781990521327014
1058,1310006,232,0,73,21,232,232,1.0,0.0,1.0,138,0.3146551724137931,0.09051724137931035,0.5948275862068966
1059,1310007,120,0,34,39,120,120,1.0,0.0,1.0,47,0.2833333333333333,0.325,0.39166666666666666
1060,1310008,1770,10,649,402,1760,1770,1.0,0.005649717514124294,0.9943502824858758,719,0.36666666666666664,0.2271186440677966,0.4062146892655367
1061,1310009,1493,77,535,88,1416,1493,1.0,0.05157401205626256,0.9484259879437374,870,0.3583389149363697,0.058941728064300064,0.5827193569993302
1062,1330001,3244,69,258,1425,3175,3244,1.0,0.02127003699136868,0.9787299630086314,1561,0.07953144266337854,0.43927250308261406,0.4811960542540074
1063,1330002,490,0,31,183,490,490,1.0,0.0,1.0,276,0.06326530612244897,0.373469387755102,0.563265306122449
1064,1330003,2449,169,132,669,2280,2449,1.0,0.0690077582686811,0.9309922417313189,1648,0.05389955083707636,0.273172723560637,0.6729277256022866
1065,1330004,364,0,8,66,364,364,1.0,0.0,1.0,290,0.02197802197802198,0.1813186813186813,0.7967032967032966
1066,1330005,844,0,58,323,844,844,1.0,0.0,1.0,463,0.06872037914691943,0.38270142180094785,0.5485781990521327
1067,1330006,282,0,18,148,282,282,1.0,0.0,1.0,116,0.06382978723404255,0.524822695035461,0.41134751773049644
1068,1330007,2295,105,154,1025,2190,2295,1.0,0.0457516339869281,0.954248366013072,1116,0.06710239651416122,0.4466230936819172,0.48627450980392156
1069,1330008,3627,205,262,1356,3422,3627,1.0,0.05652054039150813,0.9434794596084919,2009,0.07223600771987869,0.3738626964433416,0.5539012958367797
1070,1330009,566,0,49,249,566,566,1.0,0.0,1.0,268,0.08657243816254417,0.43992932862190814,0.4734982332155477
1071,1350101,5680,178,368,1309,5502,5680,1.0,0.031338028169014084,0.9686619718309859,4003,0.0647887323943662,0.23045774647887324,0.7047535211267606
1072,1350102,4105,69,297,741,4036,4105,1.0,0.016808769792935444,0.9831912302070646,3067,0.07235079171741779,0.1805115712545676,0.7471376370280146
1073,1350103,2253,0,142,471,2253,2253,1.0,0.0,1.0,1640,0.06302707501109632,0.20905459387483355,0.7279183311140701
1074,1350104,579,126,27,105,453,579,1.0,0.21761658031088082,0.7823834196891192,447,0.046632124352331605,0.18134715025906736,0.772020725388601
1075,1350106,2011,274,151,638,1737,2011,1.0,0.13625062158130283,0.8637493784186971,1222,0.07508702138239681,0.31725509696668325,0.6076578816509199
1076,1350107,1645,101,67,406,1544,1645,1.0,0.06139817629179331,0.9386018237082067,1172,0.04072948328267477,0.24680851063829787,0.7124620060790273
1077,1350108,3134,40,212,1089,3094,3134,1.0,0.012763241863433313,0.9872367581365666,1833,0.06764518187619656,0.3474792597319719,0.5848755583918315
1078,1350109,217,3,15,108,214,217,1.0,0.013824884792626729,0.9861751152073732,94,0.06912442396313365,0.4976958525345622,0.43317972350230416
1079,1350110,4680,10,211,1023,4670,4680,1.0,0.002136752136752137,0.9978632478632479,3446,0.045085470085470085,0.2185897435897436,0.7363247863247864
1080,1350111,1134,208,90,201,926,1134,1.0,0.18342151675485008,0.8165784832451499,843,0.07936507936507936,0.17724867724867724,0.7433862433862434
1081,1350201,6117,166,357,2513,5951,6117,1.0,0.02713748569560242,0.9728625143043976,3247,0.05836194212849436,0.41082229851234264,0.530815759359163
1082,1350202,3334,73,283,1518,3261,3334,1.0,0.021895620875824834,0.9781043791241751,1533,0.08488302339532093,0.4553089382123575,0.45980803839232154
1083,1350203,3543,139,276,1547,3404,3543,1.0,0.03923228902060401,0.960767710979396,1720,0.07790008467400508,0.4366356195314705,0.48546429579452444
1084,1350204,1826,0,158,763,1826,1826,1.0,0.0,1.0,905,0.08652792990142388,0.4178532311062432,0.49561883899233294
1085,1350205,2615,130,193,980,2485,2615,1.0,0.0497131931166348,0.9502868068833652,1442,0.07380497131931166,0.37476099426386233,0.551434034416826
1086,1350206,378,46,32,315,332,378,1.0,0.12169312169312169,0.8783068783068783,31,0.08465608465608465,0.8333333333333334,0.082010582010582
1087,1350207,1605,100,97,938,1505,1605,1.0,0.06230529595015576,0.9376947040498442,570,0.06043613707165109,0.584423676012461,0.35514018691588783
1088,1350208,6282,348,376,1774,5934,6282,1.0,0.055396370582617004,0.944603629417383,4132,0.05985354982489653,0.28239414199299584,0.6577523081821076
1089,1350209,2167,75,137,549,2092,2167,1.0,0.03461005999077065,0.9653899400092294,1481,0.06322104291647439,0.2533456391324412,0.6834333179510844
1090,1350301,3375,25,345,831,3350,3375,1.0,0.007407407407407408,0.9925925925925926,2199,0.10222222222222223,0.24622222222222223,0.6515555555555556
1091,1350302,1341,16,160,353,1325,1341,1.0,0.011931394481730051,0.9880686055182699,828,0.11931394481730052,0.2632363907531693,0.6174496644295302
1092,1350303,3271,112,260,545,3159,3271,1.0,0.0342402934882299,0.9657597065117701,2466,0.07948639559767655,0.16661571384897586,0.7538978905533475
1093,1350304,981,63,84,107,918,981,1.0,0.06422018348623854,0.9357798165137615,790,0.0856269113149847,0.109072375127421,0.8053007135575942
1094,1350305,1139,22,84,95,1117,1139,1.0,0.019315188762071993,0.9806848112379281,960,0.07374890254609306,0.08340649692712906,0.8428446005267779
1095,1350306,2330,279,190,285,2051,2330,1.0,0.11974248927038626,0.8802575107296138,1855,0.0815450643776824,0.1223175965665236,0.796137339055794
1096,1350307,3776,145,290,638,3631,3776,1.0,0.03840042372881356,0.9615995762711864,2848,0.07680084745762712,0.16896186440677965,0.7542372881355932
1097,1350308,1491,0,106,423,1491,1491,1.0,0.0,1.0,962,0.07109322602280349,0.2837022132796781,0.6452045606975184
1098,1350309,1732,0,160,539,1732,1732,1.0,0.0,1.0,1033,0.09237875288683603,0.3112009237875289,0.5964203233256351
1099,1350311,1363,35,155,344,1328,1363,1.0,0.025678650036683785,0.9743213499633162,864,0.11371973587674249,0.2523844460748349,0.6338958180484225
1100,1350312,1691,0,151,635,1691,1691,1.0,0.0,1.0,905,0.0892962743938498,0.37551744529863984,0.5351862803075104
1101,1350401,1787,41,121,236,1746,1787,1.0,0.02294348069390039,0.9770565193060996,1430,0.06771124790151091,0.13206491326245104,0.8002238388360381
1102,1350402,3303,746,488,130,2557,3303,1.0,0.22585528307599154,0.7741447169240084,2685,0.14774447471995156,0.039358159249167426,0.812897366030881
1103,1350403,4047,513,715,231,3534,4047,1.0,0.1267605633802817,0.8732394366197183,3101,0.17667407956510997,0.05707931801334322,0.7662466024215469
1104,1350404,1668,11,175,278,1657,1668,1.0,0.006594724220623501,0.9934052757793765,1215,0.10491606714628297,0.16666666666666666,0.7284172661870504
1105,1350405,1591,193,247,102,1398,1591,1.0,0.1213073538654934,0.8786926461345066,1242,0.1552482715273413,0.06411062225015714,0.7806411062225016
1106,1350406,4894,197,426,497,4697,4894,1.0,0.04025337147527585,0.9597466285247241,3971,0.08704536166734778,0.10155292194523907,0.8114017163874132
1107,1350407,1890,0,109,339,1890,1890,1.0,0.0,1.0,1442,0.05767195767195767,0.17936507936507937,0.762962962962963
1108,1350408,994,10,117,103,984,994,1.0,0.01006036217303823,0.9899396378269618,774,0.11770623742454728,0.10362173038229376,0.778672032193159
1109,1350409,1215,59,141,167,1156,1215,1.0,0.048559670781893,0.951440329218107,907,0.11604938271604938,0.1374485596707819,0.7465020576131687
1110,1350412,1511,19,105,144,1492,1511,1.0,0.01257445400397088,0.9874255459960292,1262,0.06949040370615486,0.09530112508272667,0.8352084712111185
1111,1370001,424,0,72,79,424,424,1.0,0.0,1.0,273,0.16981132075471697,0.18632075471698112,0.6438679245283019
1112,1370002,390,0,48,262,390,390,1.0,0.0,1.0,80,0.12307692307692308,0.6717948717948717,0.20512820512820512
1113,1370003,422,0,52,190,422,422,1.0,0.0,1.0,180,0.12322274881516587,0.45023696682464454,0.4265402843601896
1114,1370004,450,0,60,111,450,450,1.0,0.0,1.0,279,0.13333333333333333,0.24666666666666667,0.62
1115,1390101,3077,275,435,1338,2802,3077,1.0,0.08937276568085797,0.910627234319142,1304,0.14137146571335715,0.43483912902177446,0.42378940526486836
1116,1390102,5124,317,363,1588,4807,5124,1.0,0.06186572989851678,0.9381342701014832,3173,0.07084309133489461,0.30991412958626074,0.6192427790788446
1117,1390103,4367,262,336,1679,4105,4367,1.0,0.059995420196931534,0.9400045798030685,2352,0.07694069155026334,0.3844744675978933,0.5385848408518433
1118,1390104,3336,93,262,1366,3243,3336,1.0,0.02787769784172662,0.9721223021582733,1708,0.07853717026378897,0.4094724220623501,0.511990407673861
1119,1390105,3448,93,218,1530,3355,3448,1.0,0.02697215777262181,0.9730278422273781,1700,0.06322505800464037,0.4437354988399072,0.49303944315545245
1120,1390106,3033,68,277,1542,2965,3033,1.0,0.02242004615891856,0.9775799538410814,1214,0.09132871744147708,0.5084075173095944,0.4002637652489284
1121,1390107,3155,300,328,1412,2855,3155,1.0,0.09508716323296355,0.9049128367670365,1415,0.10396196513470682,0.4475435816164818,0.44849445324881143
1122,1390108,3013,155,298,1286,2858,3013,1.0,0.05144374377696648,0.9485562562230335,1429,0.09890474610023232,0.42681712578825093,0.47427812811151676
1123,1390109,1993,331,265,1033,1662,1993,1.0,0.16608128449573506,0.8339187155042649,695,0.13296537882589063,0.518314099347717,0.34872052182639235
1124,1390110,4282,736,733,1340,3546,4282,1.0,0.17188229799159271,0.8281177020084073,2209,0.1711816907986922,0.31293787949556284,0.515880429705745
1125,1390111,1436,77,116,671,1359,1436,1.0,0.05362116991643454,0.9463788300835655,649,0.0807799442896936,0.4672701949860724,0.451949860724234
1126,1390112,2281,55,161,718,2226,2281,1.0,0.024112231477422183,0.9758877685225779,1402,0.07058307759754494,0.31477422183252957,0.6146427005699254
1127,1390113,2184,1154,779,139,1030,2184,1.0,0.5283882783882784,0.4716117216117216,1266,0.3566849816849817,0.06364468864468864,0.5796703296703297
1128,1390114,2018,308,235,599,1710,2018,1.0,0.15262636273538158,0.8473736372646185,1184,0.11645193260654113,0.2968285431119921,0.5867195242814668
1129,1390115,1813,240,246,616,1573,1813,1.0,0.13237727523441808,0.8676227247655819,951,0.13568670711527855,0.33976833976833976,0.5245449531163817
1130,1390116,2370,99,253,819,2271,2370,1.0,0.04177215189873418,0.9582278481012658,1298,0.10675105485232067,0.34556962025316457,0.5476793248945148
1131,1390117,3723,195,336,1166,3528,3723,1.0,0.052377115229653506,0.9476228847703465,2221,0.09024979854955681,0.31318828901423584,0.5965619124362074
1132,1390118,3649,354,421,1133,3295,3649,1.0,0.09701288024116196,0.902987119758838,2095,0.1153740750890655,0.3104960263085777,0.5741298986023569
1133,1390119,1515,126,185,592,1389,1515,1.0,0.08316831683168317,0.9168316831683169,738,0.12211221122112212,0.39075907590759074,0.4871287128712871
1134,1390120,831,26,64,215,805,831,1.0,0.031287605294825514,0.9687123947051745,552,0.07701564380264742,0.25872442839951865,0.6642599277978339
1135,1390121,2253,172,304,997,2081,2253,1.0,0.07634265423879272,0.9236573457612073,952,0.1349312028406569,0.44252108300044385,0.42254771415889925
1136,1390122,1429,131,163,564,1298,1429,1.0,0.09167249825052484,0.9083275017494752,702,0.11406578026592022,0.3946815955213436,0.4912526242127362
1137,1390123,1497,1004,421,49,493,1497,1.0,0.6706746826987308,0.3293253173012692,1027,0.28122912491649965,0.032732130928523714,0.6860387441549766
1138,1390124,2331,589,449,209,1742,2331,1.0,0.2526812526812527,0.7473187473187474,1673,0.19262119262119262,0.08966108966108965,0.7177177177177178
1139,1390125,4336,214,460,1460,4122,4336,1.0,0.04935424354243542,0.9506457564575646,2416,0.10608856088560886,0.3367158671586716,0.5571955719557196
1140,1390126,1559,57,158,322,1502,1559,1.0,0.036561898652982684,0.9634381013470174,1079,0.1013470173187941,0.2065426555484285,0.6921103271327774
1141,1390127,652,114,65,165,538,652,1.0,0.17484662576687116,0.8251533742331288,422,0.09969325153374232,0.25306748466257667,0.647239263803681
1142,1390128,260,55,55,36,205,260,1.0,0.21153846153846154,0.7884615384615384,169,0.21153846153846154,0.13846153846153847,0.65
1143,1390129,946,51,118,281,895,946,1.0,0.05391120507399577,0.9460887949260042,547,0.12473572938689217,0.29704016913319237,0.5782241014799154
1144,1390130,729,117,147,217,612,729,1.0,0.16049382716049382,0.8395061728395061,365,0.20164609053497942,0.29766803840877915,0.5006858710562414
1145,1390131,2011,264,313,685,1747,2011,1.0,0.13127797115862755,0.8687220288413725,1013,0.15564395822973645,0.3406265539532571,0.5037294878170064
1146,1390132,625,25,75,220,600,625,1.0,0.04,0.96,330,0.12,0.352,0.528
1147,1390133,683,6,78,203,677,683,1.0,0.008784773060029283,0.9912152269399708,402,0.11420204978038068,0.2972181551976574,0.5885797950219619
1148,1390134,872,13,52,331,859,872,1.0,0.014908256880733946,0.9850917431192661,489,0.05963302752293578,0.3795871559633027,0.5607798165137615
1149,1390135,3690,153,258,1565,3537,3690,1.0,0.041463414634146344,0.9585365853658536,1867,0.06991869918699187,0.4241192411924119,0.5059620596205963
1150,1390136,461,4,60,266,457,461,1.0,0.008676789587852495,0.9913232104121475,135,0.1301518438177874,0.5770065075921909,0.2928416485900217
1151,1390137,1156,4,141,555,1152,1156,1.0,0.0034602076124567475,0.9965397923875432,460,0.12197231833910034,0.4801038062283737,0.39792387543252594
1152,1390138,2031,83,184,723,1948,2031,1.0,0.04086656819300837,0.9591334318069916,1124,0.09059576563269325,0.3559822747415066,0.5534219596258001
1153,1390139,1231,90,130,530,1141,1231,1.0,0.07311129163281885,0.9268887083671812,571,0.10560519902518278,0.4305442729488221,0.46385052802599513
1154,1390140,4694,424,382,1372,4270,4694,1.0,0.09032807839795484,0.9096719216020451,2940,0.08138048572645931,0.29228802726885383,0.6263314870046869
1155,1390141,1839,117,177,778,1722,1839,1.0,0.0636215334420881,0.9363784665579119,884,0.09624796084828711,0.4230560087003806,0.48069603045133225
1156,1390142,2312,105,248,807,2207,2312,1.0,0.04541522491349481,0.9545847750865052,1257,0.10726643598615918,0.3490484429065744,0.5436851211072664
1157,1390143,2876,133,301,1243,2743,2876,1.0,0.04624478442280946,0.9537552155771906,1332,0.10465924895688457,0.43219749652294853,0.4631432545201669
1158,1390144,1477,405,437,494,1072,1477,1.0,0.2742044685172647,0.7257955314827352,546,0.2958700067704807,0.3344617467840217,0.3696682464454976
1159,1390145,4255,1006,657,1010,3249,4255,1.0,0.236427732079906,0.763572267920094,2588,0.154406580493537,0.23736780258519388,0.6082256169212691
1160,1390146,3054,237,436,1008,2817,3054,1.0,0.07760314341846758,0.9223968565815324,1610,0.14276358873608383,0.3300589390962672,0.527177472167649
1161,1390147,4394,441,558,1472,3953,4394,1.0,0.10036413290851161,0.8996358670914884,2364,0.12699135184342286,0.3350022758306782,0.538006372325899
1162,1390148,3068,408,536,758,2660,3068,1.0,0.13298565840938723,0.8670143415906127,1774,0.17470664928292046,0.2470664928292047,0.5782268578878749
1163,1390149,1428,3,207,472,1425,1428,1.0,0.0021008403361344537,0.9978991596638656,749,0.14495798319327732,0.33053221288515405,0.5245098039215687
1164,1410001,3551,138,528,222,3413,3551,1.0,0.03886229231202478,0.9611377076879752,2801,0.14869050971557307,0.06251760067586595,0.788791889608561
1165,1410002,2907,24,765,227,2883,2907,1.0,0.008255933952528379,0.9917440660474717,1915,0.2631578947368421,0.07808737530099759,0.6587547299621603
1166,1410003,2640,0,613,339,2640,2640,1.0,0.0,1.0,1688,0.2321969696969697,0.12840909090909092,0.6393939393939394
1167,1410004,2065,16,538,301,2049,2065,1.0,0.00774818401937046,0.9922518159806295,1226,0.2605326876513317,0.14576271186440679,0.5937046004842615
1168,1410005,6789,97,1163,854,6692,6789,1.0,0.014287818529974959,0.985712181470025,4772,0.17130652526145235,0.1257917219030785,0.7029017528354692
1169,1410006,1606,16,325,630,1590,1606,1.0,0.009962640099626401,0.9900373599003736,651,0.20236612702366127,0.39227895392278955,0.4053549190535492
1170,1410007,2919,25,719,806,2894,2919,1.0,0.00856457690990065,0.9914354230900994,1394,0.24631723192874272,0.276121959575197,0.4775608084960603
1171,1410008,2451,0,508,1230,2451,2451,1.0,0.0,1.0,713,0.2072623419012648,0.5018359853121175,0.2909016727866177
1172,1410009,3229,0,875,918,3229,3229,1.0,0.0,1.0,1436,0.2709817280891917,0.2842985444410034,0.44471972746980487
1173,1410010,4288,9,1074,465,4279,4288,1.0,0.0020988805970149254,0.9979011194029851,2749,0.25046641791044777,0.10844216417910447,0.6410914179104478
1174,1410011,5418,210,1077,792,5208,5418,1.0,0.03875968992248062,0.9612403100775194,3549,0.19878183831672203,0.1461794019933555,0.6550387596899225
1175,1410012,734,45,159,167,689,734,1.0,0.06130790190735695,0.9386920980926431,408,0.21662125340599456,0.22752043596730245,0.555858310626703
1176,1410013,3082,39,815,658,3043,3082,1.0,0.012654120700843608,0.9873458792991564,1609,0.2644386761842959,0.2134977287475665,0.5220635950681376
1177,1410014,4800,222,741,914,4578,4800,1.0,0.04625,0.95375,3145,0.154375,0.19041666666666668,0.6552083333333333
1178,1410015,1817,34,558,852,1783,1817,1.0,0.018712162905888827,0.9812878370941112,407,0.30709961474958725,0.468904788112273,0.2239955971381398
1179,1410016,3261,7,1008,487,3254,3261,1.0,0.0021465808034345293,0.9978534191965654,1766,0.3091076356945722,0.14934069303894512,0.5415516712664826
1180,1410017,1553,22,413,474,1531,1553,1.0,0.014166130070830651,0.9858338699291693,666,0.2659368963296845,0.30521571152607857,0.42884739214423695
1181,1410018,2989,63,787,1086,2926,2989,1.0,0.02107728337236534,0.9789227166276346,1116,0.26329876212780196,0.3633322181331549,0.3733690197390432
1182,1410019,5001,14,902,643,4987,5001,1.0,0.0027994401119776045,0.9972005598880224,3456,0.1803639272145571,0.1285742851429714,0.6910617876424715
1183,1410020,952,0,329,282,952,952,1.0,0.0,1.0,341,0.34558823529411764,0.296218487394958,0.3581932773109244
1184,1410021,1873,13,565,772,1860,1873,1.0,0.0069407367859049655,0.993059263214095,536,0.3016550987720235,0.41217298451681794,0.28617191671115855
1185,1410022,3281,148,727,619,3133,3281,1.0,0.045108198719902466,0.9548918012800975,1935,0.2215787869551966,0.18866199329472721,0.5897592197500762
1186,1410023,1360,7,285,471,1353,1360,1.0,0.005147058823529412,0.9948529411764706,604,0.20955882352941177,0.3463235294117647,0.4441176470588235
1187,1410024,3249,30,757,1107,3219,3249,1.0,0.009233610341643583,0.9907663896583564,1385,0.2329947676208064,0.3407202216066482,0.4262850107725454
1188,1410025,3258,145,616,485,3113,3258,1.0,0.044505831798649476,0.9554941682013505,2157,0.18907305095150398,0.14886433394720688,0.6620626151012892
1189,1410026,1385,36,542,422,1349,1385,1.0,0.025992779783393503,0.9740072202166065,421,0.3913357400722022,0.3046931407942238,0.303971119133574
1190,1410027,1944,33,504,303,1911,1944,1.0,0.016975308641975308,0.9830246913580247,1137,0.25925925925925924,0.1558641975308642,0.5848765432098766
1191,1410028,509,0,138,27,509,509,1.0,0.0,1.0,344,0.27111984282907664,0.05304518664047151,0.6758349705304518
1192,1410029,3240,69,688,393,3171,3240,1.0,0.021296296296296296,0.9787037037037037,2159,0.2123456790123457,0.12129629629629629,0.6663580246913581
1193,1410030,164,0,67,16,164,164,1.0,0.0,1.0,81,0.40853658536585363,0.0975609756097561,0.49390243902439024
1194,1410031,1743,58,302,113,1685,1743,1.0,0.03327596098680436,0.9667240390131956,1328,0.17326448651749857,0.06483075157773953,0.7619047619047619
1195,1410032,1793,0,502,307,1793,1793,1.0,0.0,1.0,984,0.2799776910206358,0.17122141662018964,0.5488008923591746
1196,1410033,1751,0,757,498,1751,1751,1.0,0.0,1.0,496,0.43232438606510565,0.2844089091947459,0.2832667047401485
1197,1410034,1261,30,183,45,1231,1261,1.0,0.023790642347343377,0.9762093576526566,1033,0.14512291831879462,0.035685963521015066,0.8191911181601903
1198,1410035,2235,197,687,464,2038,2235,1.0,0.08814317673378076,0.9118568232662192,1084,0.3073825503355705,0.2076062639821029,0.4850111856823266
1199,1410036,2646,78,653,156,2568,2646,1.0,0.02947845804988662,0.9705215419501134,1837,0.24678760393046106,0.05895691609977324,0.6942554799697657
1200,1410037,2760,101,641,81,2659,2760,1.0,0.036594202898550726,0.9634057971014492,2038,0.2322463768115942,0.029347826086956522,0.7384057971014493
1201,1410038,2922,49,628,142,2873,2922,1.0,0.01676933607118412,0.9832306639288159,2152,0.21492128678986996,0.0485968514715948,0.7364818617385352
1202,1410039,961,45,236,32,916,961,1.0,0.046826222684703434,0.9531737773152965,693,0.24557752341311134,0.03329864724245578,0.7211238293444329
1203,1410040,1235,25,272,48,1210,1235,1.0,0.020242914979757085,0.979757085020243,915,0.2202429149797571,0.038866396761133605,0.7408906882591093
1204,1410041,1300,17,304,70,1283,1300,1.0,0.013076923076923076,0.9869230769230769,926,0.23384615384615384,0.05384615384615385,0.7123076923076923
1205,1410042,2219,30,550,73,2189,2219,1.0,0.013519603424966201,0.9864803965750338,1596,0.24785939612438035,0.032897701667417754,0.7192429022082019
1206,1410043,1979,315,544,603,1664,1979,1.0,0.15917129863567459,0.8408287013643254,832,0.2748863062152602,0.30469934310257707,0.4204143506821627
1207,1410044,6450,875,875,701,5575,6450,1.0,0.13565891472868216,0.8643410852713178,4874,0.13565891472868216,0.10868217054263565,0.7556589147286822
1208,1410045,5442,750,970,589,4692,5442,1.0,0.1378169790518192,0.8621830209481808,3883,0.17824329290701948,0.10823226754869533,0.7135244395442852
1209,1410046,1647,301,424,239,1346,1647,1.0,0.1827565270188221,0.8172434729811779,984,0.25743776563448695,0.14511232544019428,0.5974499089253188
1210,1410047,2492,149,806,602,2343,2492,1.0,0.059791332263242375,0.9402086677367576,1084,0.3234349919743178,0.24157303370786518,0.434991974317817
1211,1410048,1998,95,610,219,1903,1998,1.0,0.047547547547547545,0.9524524524524525,1169,0.3053053053053053,0.10960960960960961,0.585085085085085
1212,1410049,2131,284,370,266,1847,2131,1.0,0.1332707648991084,0.8667292351008916,1495,0.17362740497419052,0.12482402627874238,0.7015485687470671
1213,1410050,6302,611,837,517,5691,6302,1.0,0.09695334814344653,0.9030466518565535,4948,0.13281497937162806,0.08203744842907014,0.7851475721993018
1214,1410051,2665,175,592,512,2490,2665,1.0,0.06566604127579738,0.9343339587242027,1561,0.22213883677298313,0.19212007504690432,0.5857410881801126
1215,1410052,2680,159,661,280,2521,2680,1.0,0.059328358208955226,0.9406716417910448,1739,0.24664179104477613,0.1044776119402985,0.6488805970149254
1216,1410053,3791,622,771,417,3169,3791,1.0,0.16407280400949617,0.8359271959905038,2603,0.20337641783170668,0.10999736217356898,0.6866262199947244
1217,1410054,3204,244,558,241,2960,3204,1.0,0.07615480649188515,0.9238451935081149,2405,0.17415730337078653,0.07521847690387017,0.7506242197253433
1218,1410055,2775,314,684,438,2461,2775,1.0,0.11315315315315315,0.8868468468468469,1653,0.2464864864864865,0.15783783783783784,0.5956756756756757
1219,1410056,2421,52,566,520,2369,2421,1.0,0.0214787277984304,0.9785212722015696,1335,0.23378769103676167,0.214787277984304,0.5514250309789344
1220,1410057,2181,250,404,249,1931,2181,1.0,0.11462631820265932,0.8853736817973407,1528,0.18523613021549748,0.11416781292984869,0.7005960568546539
1221,1410058,2115,245,484,320,1870,2115,1.0,0.11583924349881797,0.8841607565011821,1311,0.22884160756501182,0.15130023640661938,0.6198581560283688
1222,1410059,3361,212,739,328,3149,3361,1.0,0.06307646533769712,0.9369235346623029,2294,0.2198750371913121,0.09759000297530497,0.682534959833383
1223,1410060,2636,390,532,736,2246,2636,1.0,0.1479514415781487,0.8520485584218513,1368,0.20182094081942337,0.27921092564491656,0.5189681335356601
1224,1410061,1574,69,392,336,1505,1574,1.0,0.04383735705209657,0.9561626429479034,846,0.24904701397712833,0.21346886912325286,0.5374841168996188
1225,1410062,2231,132,371,137,2099,2231,1.0,0.05916629314208875,0.9408337068579112,1723,0.16629314208874943,0.061407440609592114,0.7722994173016584
1226,1410063,3434,164,688,245,3270,3434,1.0,0.047757716948165406,0.9522422830518346,2501,0.20034944670937682,0.07134536983110076,0.7283051834595224
1227,1410064,2739,49,789,246,2690,2739,1.0,0.017889740781307048,0.982110259218693,1704,0.28806133625410735,0.08981380065717415,0.6221248630887185
1228,1410065,2776,590,123,109,2186,2776,1.0,0.21253602305475505,0.787463976945245,2544,0.04430835734870317,0.03926512968299712,0.9164265129682997
1229,1410066,2840,249,724,239,2591,2840,1.0,0.08767605633802816,0.9123239436619718,1877,0.2549295774647887,0.08415492957746479,0.6609154929577464
1230,1410067,3688,121,641,260,3567,3688,1.0,0.032809110629067245,0.9671908893709328,2787,0.17380694143167028,0.07049891540130152,0.7556941431670282
1231,1410068,1971,301,174,66,1670,1971,1.0,0.15271435819381024,0.8472856418061897,1731,0.0882800608828006,0.0334855403348554,0.878234398782344
1232,1410069,5168,256,1144,376,4912,5168,1.0,0.04953560371517028,0.9504643962848297,3648,0.22136222910216719,0.07275541795665634,0.7058823529411765
1233,1410070,2391,0,882,241,2391,2391,1.0,0.0,1.0,1268,0.36888331242158096,0.10079464659138436,0.5303220409870347
1234,1410071,1990,3,669,243,1987,1990,1.0,0.001507537688442211,0.9984924623115577,1078,0.33618090452261307,0.1221105527638191,0.5417085427135678
1235,1410072,1675,32,449,110,1643,1675,1.0,0.0191044776119403,0.9808955223880597,1116,0.26805970149253733,0.06567164179104477,0.6662686567164179
1236,1410073,1005,61,398,110,944,1005,1.0,0.06069651741293532,0.9393034825870646,497,0.39601990049751246,0.10945273631840796,0.4945273631840796
1237,1410074,2680,105,669,147,2575,2680,1.0,0.03917910447761194,0.960820895522388,1864,0.2496268656716418,0.054850746268656714,0.6955223880597015
1238,1410075,1543,7,501,251,1536,1543,1.0,0.004536616979909268,0.9954633830200907,791,0.32469215813350616,0.16267012313674659,0.5126377187297473
1239,1410076,1334,22,475,142,1312,1334,1.0,0.01649175412293853,0.9835082458770614,717,0.356071964017991,0.10644677661169415,0.5374812593703149
1240,1410077,3268,35,617,208,3233,3268,1.0,0.010709914320685434,0.9892900856793145,2443,0.18880048959608323,0.06364749082007344,0.7475520195838433
1241,1410078,1019,0,472,136,1019,1019,1.0,0.0,1.0,411,0.4631992149165849,0.13346418056918546,0.40333660451422965
1242,1410079,736,0,218,29,736,736,1.0,0.0,1.0,489,0.296195652173913,0.03940217391304348,0.6644021739130435
1243,1410080,1417,0,491,58,1417,1417,1.0,0.0,1.0,868,0.34650670430486946,0.040931545518701484,0.6125617501764291
1244,1410081,286,0,127,25,286,286,1.0,0.0,1.0,134,0.44405594405594406,0.08741258741258741,0.46853146853146854
1245,1410082,2590,42,676,134,2548,2590,1.0,0.016216216216216217,0.9837837837837838,1780,0.261003861003861,0.051737451737451735,0.6872586872586872
1246,1410083,1207,0,435,76,1207,1207,1.0,0.0,1.0,696,0.3603976801988401,0.06296603148301574,0.5766362883181442
1247,1410084,2401,0,748,114,2401,2401,1.0,0.0,1.0,1539,0.31153685964181593,0.04748021657642649,0.6409829237817576
1248,1410085,2051,4,581,93,2047,2051,1.0,0.0019502681618722574,0.9980497318381277,1377,0.2832764505119454,0.045343734763529986,0.6713798147245246
1249,1410086,943,173,94,77,770,943,1.0,0.18345705196182396,0.8165429480381761,772,0.09968186638388123,0.0816542948038176,0.8186638388123012
1250,1410087,3334,514,0,1,2820,3334,1.0,0.15416916616676665,0.8458308338332333,3333,0.0,0.00029994001199760045,0.9997000599880024
1251,1410089,3717,193,968,327,3524,3717,1.0,0.05192359429647565,0.9480764057035244,2422,0.260425073984396,0.08797417271993543,0.6516007532956686
1252,1410090,1776,30,603,416,1746,1776,1.0,0.016891891891891893,0.9831081081081081,757,0.33952702702702703,0.23423423423423423,0.42623873873873874
1253,1410091,835,0,342,148,835,835,1.0,0.0,1.0,345,0.4095808383233533,0.17724550898203592,0.41317365269461076
1254,1410092,3457,125,876,680,3332,3457,1.0,0.03615851894706393,0.9638414810529361,1901,0.253398900781024,0.19670234307202777,0.5498987561469483
1255,1410093,1657,78,488,306,1579,1657,1.0,0.04707302353651177,0.9529269764634882,863,0.29450814725407365,0.18467109233554616,0.5208207604103802
1256,1410094,3221,79,804,454,3142,3221,1.0,0.02452654455138156,0.9754734554486184,1963,0.2496119217634275,0.14095001552312947,0.609438062713443
1257,1410095,2753,48,805,520,2705,2753,1.0,0.017435524881946968,0.982564475118053,1428,0.29240828187431894,0.1888848528877588,0.5187068652379223
1258,1410096,3459,20,966,690,3439,3459,1.0,0.005782017924255565,0.9942179820757444,1803,0.2792714657415438,0.199479618386817,0.5212489158716392
1259,1410097,2426,106,569,369,2320,2426,1.0,0.043693322341302555,0.9563066776586975,1488,0.2345424567188788,0.15210222588623248,0.6133553173948887
1260,1410098,1910,26,601,507,1884,1910,1.0,0.013612565445026177,0.9863874345549738,802,0.3146596858638743,0.26544502617801047,0.4198952879581152
1261,1410099,2269,90,412,173,2179,2269,1.0,0.03966505068312032,0.9603349493168797,1684,0.18157778757161747,0.07624504186866461,0.742177170559718
1262,1410100,3679,79,878,474,3600,3679,1.0,0.021473226420222886,0.9785267735797771,2327,0.2386518075564012,0.12883935852133732,0.6325088339222615
1263,1410101,2425,20,755,502,2405,2425,1.0,0.008247422680412371,0.9917525773195877,1168,0.311340206185567,0.2070103092783505,0.4816494845360825
1264,1410102,3550,30,725,346,3520,3550,1.0,0.008450704225352112,0.9915492957746479,2479,0.20422535211267606,0.09746478873239436,0.6983098591549296
1265,1410103,2129,127,546,483,2002,2129,1.0,0.05965241897604509,0.9403475810239549,1100,0.2564584311883513,0.22686707374354156,0.5166744950681071
1266,1410104,3230,117,787,566,3113,3230,1.0,0.036222910216718265,0.9637770897832817,1877,0.2436532507739938,0.17523219814241486,0.5811145510835913
1267,1410105,2628,40,881,445,2588,2628,1.0,0.015220700152207,0.984779299847793,1302,0.3352359208523592,0.1693302891933029,0.4954337899543379
1268,1410106,3734,11,949,378,3723,3734,1.0,0.0029459025174076057,0.9970540974825924,2407,0.25415104445634706,0.10123192287091591,0.644617032672737
1269,1410107,1948,54,650,376,1894,1948,1.0,0.027720739219712527,0.9722792607802875,922,0.3336755646817248,0.19301848049281314,0.473305954825462
1270,1410108,1769,121,535,562,1648,1769,1.0,0.06840022611644997,0.93159977388355,672,0.30243075183719614,0.3176936122102883,0.37987563595251556
1271,1410109,2235,38,501,351,2197,2235,1.0,0.017002237136465325,0.9829977628635347,1383,0.22416107382550335,0.15704697986577182,0.6187919463087248
1272,1410110,3555,305,896,503,3250,3555,1.0,0.08579465541490858,0.9142053445850914,2156,0.2520393811533052,0.14149085794655414,0.6064697609001406
1273,1410111,2730,55,517,196,2675,2730,1.0,0.020146520146520148,0.9798534798534798,2017,0.18937728937728937,0.07179487179487179,0.7388278388278389
1274,1410112,4899,250,874,250,4649,4899,1.0,0.05103082261686059,0.9489691773831395,3775,0.1784037558685446,0.05103082261686059,0.7705654215145948
1275,1410113,2960,225,619,303,2735,2960,1.0,0.07601351351351351,0.9239864864864865,2038,0.20912162162162162,0.10236486486486486,0.6885135135135135
1276,1410114,5049,170,1018,417,4879,5049,1.0,0.03367003367003367,0.9663299663299664,3614,0.20162408397702516,0.0825906120023767,0.7157853040205981
1277,1410115,7133,521,1022,506,6612,7133,1.0,0.07304079629889247,0.9269592037011075,5605,0.14327772325809618,0.07093789429412589,0.7857843824477779
1278,1410116,8563,440,1429,644,8123,8563,1.0,0.05138386079644984,0.9486161392035501,6490,0.16688076608665187,0.07520728716571295,0.7579119467476352
1279,1410117,3271,28,886,442,3243,3271,1.0,0.008560073372057475,0.9914399266279426,1943,0.2708651788443901,0.13512687251605013,0.5940079486395597
1280,1410118,2448,44,670,415,2404,2448,1.0,0.017973856209150325,0.9820261437908496,1363,0.27369281045751637,0.16952614379084968,0.556781045751634
1281,1410119,3386,64,650,426,3322,3386,1.0,0.018901358535144713,0.9810986414648553,2310,0.19196692262256349,0.125812167749557,0.6822209096278795
1282,1410120,3379,144,898,364,3235,3379,1.0,0.042616158626812665,0.9573838413731873,2117,0.2657591003255401,0.10772417875110979,0.6265167209233501
1283,1410121,2204,74,665,272,2130,2204,1.0,0.03357531760435572,0.9664246823956443,1267,0.3017241379310345,0.12341197822141561,0.5748638838475499
1284,1410122,4083,145,1115,368,3938,4083,1.0,0.035513103110457994,0.964486896889542,2600,0.2730835170217977,0.09012980651481754,0.6367866764633847
1285,1410123,3924,9,947,303,3915,3924,1.0,0.0022935779816513763,0.9977064220183486,2674,0.24133537206931702,0.077217125382263,0.68144750254842
1286,1410124,3659,20,758,235,3639,3659,1.0,0.005465974309920744,0.9945340256900792,2666,0.20716042634599618,0.06422519814156874,0.7286143755124351
1287,1410125,6067,107,1130,516,5960,6067,1.0,0.017636393604746992,0.982363606395253,4421,0.1862535025548047,0.08505027196307895,0.7286962254821163
1288,1410126,4870,136,1270,823,4734,4870,1.0,0.02792607802874743,0.9720739219712525,2777,0.26078028747433263,0.16899383983572897,0.5702258726899384
1289,1410127,725,91,89,55,634,725,1.0,0.12551724137931033,0.8744827586206897,581,0.12275862068965518,0.07586206896551724,0.8013793103448276
1290,1410128,10308,433,619,375,9875,10308,1.0,0.04200620876988747,0.9579937912301125,9314,0.06005044625533566,0.036379511059371365,0.903570042685293
1291,1410129,301,13,164,79,288,301,1.0,0.04318936877076412,0.9568106312292359,58,0.5448504983388704,0.26245847176079734,0.19269102990033224
1292,1410130,6025,511,938,468,5514,6025,1.0,0.08481327800829876,0.9151867219917013,4619,0.15568464730290457,0.07767634854771784,0.7666390041493776
1293,1410131,951,30,143,54,921,951,1.0,0.031545741324921134,0.9684542586750788,754,0.15036803364879076,0.056782334384858045,0.7928496319663512
1294,1410132,579,21,57,18,558,579,1.0,0.03626943005181347,0.9637305699481865,504,0.09844559585492228,0.031088082901554404,0.8704663212435233
1295,1410133,2630,91,923,170,2539,2630,1.0,0.03460076045627376,0.9653992395437262,1537,0.35095057034220534,0.06463878326996197,0.5844106463878327
1296,1410134,1720,0,401,126,1720,1720,1.0,0.0,1.0,1193,0.23313953488372094,0.07325581395348837,0.6936046511627907
1297,1410135,2654,104,797,153,2550,2654,1.0,0.03918613413715147,0.9608138658628486,1704,0.300301431801055,0.05764883195177091,0.6420497362471741
1298,1410136,2217,0,626,116,2217,2217,1.0,0.0,1.0,1475,0.2823635543527289,0.05232295895354082,0.6653134866937302
1299,1410137,1949,139,698,118,1810,1949,1.0,0.07131862493586455,0.9286813750641355,1133,0.3581323755772191,0.06054386865059005,0.5813237557721909
1300,1410138,2062,52,798,160,2010,2062,1.0,0.02521823472356935,0.9747817652764307,1104,0.38700290979631424,0.07759456838021339,0.5354025218234724
1301,1410139,2020,0,676,184,2020,2020,1.0,0.0,1.0,1160,0.3346534653465347,0.09108910891089109,0.5742574257425742
1302,1410140,2410,0,564,103,2410,2410,1.0,0.0,1.0,1743,0.23402489626556017,0.04273858921161826,0.7232365145228216
1303,1410141,1523,24,417,97,1499,1523,1.0,0.015758371634931056,0.9842416283650689,1009,0.27380170715692714,0.06369008535784636,0.6625082074852265
1304,1410142,1395,0,443,83,1395,1395,1.0,0.0,1.0,869,0.31756272401433694,0.05949820788530466,0.6229390681003584
1305,1410143,2335,0,896,152,2335,2335,1.0,0.0,1.0,1287,0.38372591006423984,0.06509635974304069,0.5511777301927195
1306,1410144,2948,20,870,187,2928,2948,1.0,0.0067842605156037995,0.9932157394843962,1891,0.29511533242876525,0.06343283582089553,0.6414518317503393
1307,1410145,3180,15,657,177,3165,3180,1.0,0.0047169811320754715,0.9952830188679245,2346,0.20660377358490567,0.05566037735849057,0.7377358490566037
1308,1410146,1483,4,448,98,1479,1483,1.0,0.0026972353337828725,0.9973027646662171,937,0.30209035738368173,0.06608226567768037,0.6318273769386379
1309,1410147,1789,0,494,141,1789,1789,1.0,0.0,1.0,1154,0.27613191727221914,0.07881498043599776,0.6450531022917831
1310,1410148,2480,0,764,148,2480,2480,1.0,0.0,1.0,1568,0.30806451612903224,0.05967741935483871,0.632258064516129
1311,1410149,2515,0,882,191,2515,2515,1.0,0.0,1.0,1442,0.3506958250497018,0.07594433399602386,0.5733598409542744
1312,1410150,2408,89,589,133,2319,2408,1.0,0.03696013289036545,0.9630398671096345,1686,0.2446013289036545,0.055232558139534885,0.7001661129568106
1313,1410151,2150,0,682,101,2150,2150,1.0,0.0,1.0,1367,0.3172093023255814,0.04697674418604651,0.6358139534883721
1314,1410152,2187,85,552,67,2102,2187,1.0,0.038866026520347506,0.9611339734796525,1568,0.252400548696845,0.03063557384545039,0.7169638774577046
1315,1410153,2617,0,809,170,2617,2617,1.0,0.0,1.0,1638,0.3091325945739396,0.0649598777225831,0.6259075277034772
1316,1410154,2109,3,701,150,2106,2109,1.0,0.001422475106685633,0.9985775248933144,1258,0.3323850165955429,0.07112375533428165,0.5964912280701754
1317,1410155,910,15,333,97,895,910,1.0,0.016483516483516484,0.9835164835164835,480,0.3659340659340659,0.10659340659340659,0.5274725274725275
1318,1410156,3197,9,938,177,3188,3197,1.0,0.0028151391929934315,0.9971848608070065,2082,0.29340006255864876,0.055364404128870816,0.6512355333124804
1319,1410157,2190,17,585,103,2173,2190,1.0,0.007762557077625571,0.9922374429223745,1502,0.2671232876712329,0.047031963470319633,0.6858447488584475
1320,1410158,7418,127,1259,1007,7291,7418,1.0,0.01712051765974656,0.9828794823402535,5152,0.16972229711512538,0.13575087624696683,0.6945268266379078
1321,1410159,2203,25,464,70,2178,2203,1.0,0.011348161597821153,0.9886518384021789,1669,0.2106218792555606,0.03177485247389923,0.7576032682705401
1322,1410160,2429,0,719,161,2429,2429,1.0,0.0,1.0,1549,0.2960065870728695,0.06628242074927954,0.637710992177851
1323,1410161,1681,0,266,82,1681,1681,1.0,0.0,1.0,1333,0.15823914336704342,0.04878048780487805,0.7929803688280785
1324,1410162,3902,0,817,149,3902,3902,1.0,0.0,1.0,2936,0.20937980522808816,0.03818554587391081,0.752434648898001
1325,1410163,2821,0,716,180,2821,2821,1.0,0.0,1.0,1925,0.2538107054236087,0.06380716058135413,0.6823821339950372
1326,1410164,2955,7,949,181,2948,2955,1.0,0.0023688663282571912,0.9976311336717428,1825,0.32115059221658204,0.06125211505922166,0.6175972927241963
1327,1410165,3595,0,862,169,3595,3595,1.0,0.0,1.0,2564,0.23977746870653685,0.04700973574408901,0.7132127955493741
1328,1410166,3266,19,593,379,3247,3266,1.0,0.005817513778322106,0.9941824862216779,2294,0.18156766687078996,0.11604409063074096,0.7023882424984691
1329,1410167,4491,45,942,159,4446,4491,1.0,0.01002004008016032,0.9899799599198397,3390,0.20975283901135605,0.035404141616566465,0.7548430193720775
1330,1410168,4574,22,618,330,4552,4574,1.0,0.004809794490599038,0.995190205509401,3626,0.135111499781373,0.07214691735898557,0.7927415828596415
1331,1410169,6865,38,1083,317,6827,6865,1.0,0.005535324107793154,0.9944646758922069,5465,0.15775673707210489,0.046176256372906045,0.7960670065549891
1332,1410170,2943,0,660,395,2943,2943,1.0,0.0,1.0,1888,0.22426095820591233,0.13421678559293237,0.6415222562011553
1333,1410171,5674,0,1120,174,5674,5674,1.0,0.0,1.0,4380,0.19739161085653859,0.030666196686640817,0.7719421924568206
1334,1410172,3131,10,1243,302,3121,3131,1.0,0.0031938677738741618,0.9968061322261258,1586,0.3969977642925583,0.09645480677099968,0.506547428936442
1335,1410173,934,0,399,114,934,934,1.0,0.0,1.0,421,0.4271948608137045,0.12205567451820129,0.45074946466809424
1336,1410174,24,0,3,1,24,24,1.0,0.0,1.0,20,0.125,0.041666666666666664,0.8333333333333334
1337,1410175,286,5,74,32,281,286,1.0,0.017482517482517484,0.9825174825174825,180,0.25874125874125875,0.11188811188811189,0.6293706293706294
1338,1410176,1293,3,309,315,1290,1293,1.0,0.002320185614849188,0.9976798143851509,669,0.23897911832946636,0.24361948955916474,0.5174013921113689
1339,1410177,556,4,123,158,552,556,1.0,0.007194244604316547,0.9928057553956835,275,0.22122302158273383,0.2841726618705036,0.49460431654676257
1340,1410178,1400,55,336,204,1345,1400,1.0,0.039285714285714285,0.9607142857142857,860,0.24,0.1457142857142857,0.6142857142857143
1341,1410179,629,0,187,25,629,629,1.0,0.0,1.0,417,0.2972972972972973,0.0397456279809221,0.6629570747217806
1342,1410180,2390,0,379,59,2390,2390,1.0,0.0,1.0,1952,0.15857740585774058,0.024686192468619247,0.8167364016736401
1343,1410181,955,40,21,7,915,955,1.0,0.041884816753926704,0.9581151832460733,927,0.02198952879581152,0.007329842931937173,0.9706806282722513
1344,1410182,4182,617,123,60,3565,4182,1.0,0.14753706360593016,0.8524629363940698,3999,0.029411764705882353,0.014347202295552367,0.9562410329985653
1347,1410185,486,14,177,175,472,486,1.0,0.02880658436213992,0.9711934156378601,134,0.36419753086419754,0.360082304526749,0.2757201646090535
1348,1410186,749,49,230,139,700,749,1.0,0.06542056074766354,0.9345794392523364,380,0.30707610146862485,0.1855807743658211,0.507343124165554
1350,1410188,153,25,25,30,128,153,1.0,0.16339869281045752,0.8366013071895425,98,0.16339869281045752,0.19607843137254902,0.6405228758169934
1354,1430010,2325,68,117,437,2257,2325,1.0,0.02924731182795699,0.970752688172043,1771,0.05032258064516129,0.18795698924731183,0.7617204301075269
1355,1430011,720,29,56,172,691,720,1.0,0.04027777777777778,0.9597222222222223,492,0.07777777777777778,0.2388888888888889,0.6833333333333333
1356,1430012,1484,38,129,642,1446,1484,1.0,0.025606469002695417,0.9743935309973046,713,0.08692722371967655,0.4326145552560647,0.4804582210242588
1357,1430018,1726,5,127,865,1721,1726,1.0,0.0028968713789107765,0.9971031286210892,734,0.07358053302433372,0.5011587485515643,0.42526071842410196
1358,1430019,1843,11,96,611,1832,1843,1.0,0.005968529571351058,0.9940314704286489,1136,0.05208898534997287,0.3315246880086815,0.6163863266413456
1359,1430020,1625,19,95,553,1606,1625,1.0,0.011692307692307693,0.9883076923076923,977,0.05846153846153846,0.3403076923076923,0.6012307692307692
1360,1430021,1563,0,123,619,1563,1563,1.0,0.0,1.0,821,0.07869481765834933,0.3960332693538068,0.5252719129878439
1361,1430023,446,0,46,223,446,446,1.0,0.0,1.0,177,0.1031390134529148,0.5,0.3968609865470852
1362,1430024,1219,8,82,445,1211,1219,1.0,0.006562756357670222,0.9934372436423298,692,0.06726825266611977,0.36505332239540605,0.5676784249384742
1363,1430025,574,0,59,360,574,574,1.0,0.0,1.0,155,0.10278745644599303,0.627177700348432,0.2700348432055749
1364,1430030,849,0,51,335,849,849,1.0,0.0,1.0,463,0.06007067137809187,0.3945818610129564,0.5453474676089517
1365,1430031,1238,0,90,600,1238,1238,1.0,0.0,1.0,548,0.07269789983844911,0.48465266558966075,0.44264943457189015
1366,1430032,2251,17,143,695,2234,2251,1.0,0.007552199022656597,0.9924478009773434,1413,0.06352732119058196,0.30875166592625497,0.6277210128831631
1367,1430033,2206,118,126,371,2088,2206,1.0,0.05349048050770626,0.9465095194922938,1709,0.057116953762466005,0.16817769718948322,0.7747053490480508
1368,1430034,1049,0,71,512,1049,1049,1.0,0.0,1.0,466,0.06768350810295519,0.4880838894184938,0.444232602478551
1369,1430035,749,39,29,34,710,749,1.0,0.0520694259012016,0.9479305740987984,686,0.03871829105473965,0.04539385847797063,0.9158878504672897
1370,1430041,743,0,52,376,743,743,1.0,0.0,1.0,315,0.06998654104979811,0.506056527590848,0.423956931359354
1371,1430044,2312,0,113,823,2312,2312,1.0,0.0,1.0,1376,0.048875432525951557,0.3559688581314879,0.5951557093425606
1372,1430045,2751,203,202,786,2548,2751,1.0,0.0737913486005089,0.926208651399491,1763,0.07342784442021083,0.2857142857142857,0.6408578698655034
1373,1430046,1454,3,69,340,1451,1454,1.0,0.0020632737276478678,0.9979367262723521,1045,0.04745529573590096,0.23383768913342504,0.718707015130674
1374,1430047,1588,3,89,530,1585,1588,1.0,0.001889168765743073,0.9981108312342569,969,0.05604534005037783,0.3337531486146096,0.6102015113350125
1375,1450101,1143,490,183,205,653,1143,1.0,0.42869641294838146,0.5713035870516185,755,0.16010498687664043,0.17935258092738407,0.6605424321959755
1376,1450104,855,94,77,354,761,855,1.0,0.10994152046783626,0.8900584795321638,424,0.09005847953216374,0.41403508771929826,0.495906432748538
1377,1450105,903,193,180,343,710,903,1.0,0.21373200442967885,0.7862679955703211,380,0.19933554817275748,0.3798449612403101,0.42081949058693247
1378,1450201,524,49,68,213,475,524,1.0,0.09351145038167939,0.9064885496183206,243,0.1297709923664122,0.4064885496183206,0.4637404580152672
1379,1450203,962,561,305,19,401,962,1.0,0.5831600831600832,0.41683991683991684,638,0.31704781704781704,0.01975051975051975,0.6632016632016632
1380,1450204,1297,680,431,102,617,1297,1.0,0.5242868157286045,0.47571318427139553,764,0.3323053199691596,0.07864302235929067,0.5890516576715498
1381,1450301,749,84,69,298,665,749,1.0,0.11214953271028037,0.8878504672897196,382,0.09212283044058744,0.3978638184245661,0.5100133511348465
1382,1450302,1562,505,159,339,1057,1562,1.0,0.323303457106274,0.6766965428937259,1064,0.10179257362355953,0.21702944942381563,0.6811779769526248
1383,1450303,507,54,42,331,453,507,1.0,0.10650887573964497,0.893491124260355,134,0.08284023668639054,0.6528599605522682,0.26429980276134124
1384,1450304,1501,167,188,388,1334,1501,1.0,0.11125916055962691,0.8887408394403731,925,0.1252498334443704,0.25849433710859426,0.6162558294470353
1385,1450403,1241,120,121,252,1121,1241,1.0,0.09669621273166801,0.9033037872683319,868,0.09750201450443191,0.20306204673650283,0.6994359387590653
1386,1450404,988,148,124,352,840,988,1.0,0.14979757085020243,0.8502024291497976,512,0.12550607287449392,0.3562753036437247,0.5182186234817814
1387,1450405,714,59,86,160,655,714,1.0,0.08263305322128851,0.9173669467787114,468,0.12044817927170869,0.22408963585434175,0.6554621848739496
1388,1470001,3985,820,200,535,3165,3985,1.0,0.205771643663739,0.794228356336261,3250,0.050188205771643665,0.1342534504391468,0.8155583437892095
1389,1470002,1318,10,113,527,1308,1318,1.0,0.007587253414264037,0.992412746585736,678,0.08573596358118361,0.3998482549317147,0.5144157814871017
1390,1470003,815,175,102,252,640,815,1.0,0.2147239263803681,0.7852760736196319,461,0.12515337423312883,0.30920245398773005,0.5656441717791411
1391,1470004,1725,141,237,470,1584,1725,1.0,0.0817391304347826,0.9182608695652174,1018,0.1373913043478261,0.27246376811594203,0.5901449275362319
1392,1470005,596,19,58,249,577,596,1.0,0.031879194630872486,0.9681208053691275,289,0.09731543624161074,0.41778523489932884,0.4848993288590604
1393,1470006,730,5,66,297,725,730,1.0,0.00684931506849315,0.9931506849315068,367,0.09041095890410959,0.40684931506849314,0.5027397260273972
1394,1470007,656,0,46,222,656,656,1.0,0.0,1.0,388,0.0701219512195122,0.3384146341463415,0.5914634146341463
1395,1470009,1036,58,106,427,978,1036,1.0,0.055984555984555984,0.944015444015444,503,0.10231660231660232,0.41216216216216217,0.4855212355212355
1396,1470010,2314,50,218,940,2264,2314,1.0,0.021607605877268798,0.9783923941227312,1156,0.09420916162489196,0.4062229904926534,0.4995678478824546
1397,1470011,2867,60,215,1006,2807,2867,1.0,0.020927799093128707,0.9790722009068713,1646,0.0749912800837112,0.35088943146145796,0.5741192884548308
1398,1470012,1089,13,154,481,1076,1089,1.0,0.011937557392102846,0.9880624426078971,454,0.1414141414141414,0.44168962350780533,0.41689623507805323
1399,1470013,830,25,98,305,805,830,1.0,0.030120481927710843,0.9698795180722891,427,0.1180722891566265,0.3674698795180723,0.5144578313253012
1400,1470015,1067,17,81,415,1050,1067,1.0,0.015932521087160263,0.9840674789128397,571,0.07591377694470477,0.3889409559512652,0.53514526710403
1401,1470016,311,0,45,148,311,311,1.0,0.0,1.0,118,0.14469453376205788,0.4758842443729904,0.37942122186495175
1402,1470018,4015,307,449,1221,3708,4015,1.0,0.07646326276463263,0.9235367372353673,2345,0.11183063511830635,0.3041095890410959,0.5840597758405978
1403,1470019,2233,160,296,666,2073,2233,1.0,0.07165248544558889,0.9283475145544111,1271,0.13255709807433946,0.29825347066726376,0.5691894312583968
1404,1490002,204,19,26,99,185,204,1.0,0.09313725490196079,0.9068627450980392,79,0.12745098039215685,0.4852941176470588,0.3872549019607843
1405,1490003,495,27,41,216,468,495,1.0,0.05454545454545454,0.9454545454545454,238,0.08282828282828283,0.43636363636363634,0.4808080808080808
1406,1490004,736,33,90,395,703,736,1.0,0.04483695652173913,0.9551630434782609,251,0.12228260869565218,0.5366847826086957,0.34103260869565216
1407,1490005,293,13,21,145,280,293,1.0,0.04436860068259386,0.9556313993174061,127,0.07167235494880546,0.4948805460750853,0.4334470989761092
1408,1490006,516,8,61,251,508,516,1.0,0.015503875968992248,0.9844961240310077,204,0.1182170542635659,0.48643410852713176,0.3953488372093023
1409,1490007,548,5,64,315,543,548,1.0,0.009124087591240875,0.9908759124087592,169,0.11678832116788321,0.5748175182481752,0.3083941605839416
1410,1490008,493,4,31,226,489,493,1.0,0.008113590263691683,0.9918864097363083,236,0.06288032454361055,0.45841784989858014,0.4787018255578093
1411,1490009,299,12,33,138,287,299,1.0,0.04013377926421405,0.959866220735786,128,0.11036789297658862,0.46153846153846156,0.4280936454849498
1412,1490010,647,39,71,324,608,647,1.0,0.06027820710973725,0.9397217928902627,252,0.10973724884080371,0.500772797527048,0.3894899536321484
1413,1490011,368,0,48,243,368,368,1.0,0.0,1.0,77,0.13043478260869565,0.6603260869565217,0.20923913043478262
1414,1490012,593,49,63,180,544,593,1.0,0.08263069139966273,0.9173693086003373,350,0.10623946037099494,0.30354131534569984,0.5902192242833052
1415,1490013,873,68,88,301,805,873,1.0,0.07789232531500573,0.9221076746849943,484,0.10080183276059565,0.3447880870561283,0.5544100801832761
1416,1490014,243,6,14,120,237,243,1.0,0.024691358024691357,0.9753086419753086,109,0.05761316872427984,0.49382716049382713,0.448559670781893
1417,1490015,414,10,39,168,404,414,1.0,0.024154589371980676,0.9758454106280193,207,0.09420289855072464,0.4057971014492754,0.5
1418,1490016,1830,117,247,629,1713,1830,1.0,0.06393442622950819,0.9360655737704918,954,0.13497267759562842,0.3437158469945355,0.521311475409836
1419,1490017,483,0,43,245,483,483,1.0,0.0,1.0,195,0.08902691511387163,0.5072463768115942,0.40372670807453415
1420,149001E,1302,46,125,447,1256,1302,1.0,0.03533026113671275,0.9646697388632872,730,0.09600614439324116,0.3433179723502304,0.5606758832565284
1421,149001N,2260,166,383,962,2094,2260,1.0,0.07345132743362832,0.9265486725663716,915,0.16946902654867257,0.42566371681415927,0.40486725663716816
1422,149001W,1023,16,101,401,1007,1023,1.0,0.015640273704789834,0.9843597262952102,521,0.09872922776148582,0.3919843597262952,0.509286412512219
1423,1490020,801,53,78,382,748,801,1.0,0.066167290886392,0.9338327091136079,341,0.09737827715355805,0.4769038701622971,0.4257178526841448
1424,1490021,257,7,30,138,250,257,1.0,0.027237354085603113,0.9727626459143969,89,0.11673151750972763,0.5369649805447471,0.3463035019455253
1425,1490022,173,0,26,99,173,173,1.0,0.0,1.0,48,0.15028901734104047,0.5722543352601156,0.2774566473988439
1426,1490023,250,0,33,121,250,250,1.0,0.0,1.0,96,0.132,0.484,0.384
1427,1490024,281,0,28,137,281,281,1.0,0.0,1.0,116,0.099644128113879,0.4875444839857651,0.4128113879003559
1428,1490025,3078,328,428,1152,2750,3078,1.0,0.10656270305393112,0.8934372969460689,1498,0.13905133203378817,0.3742690058479532,0.4866796621182586
1429,1490026,612,53,103,272,559,612,1.0,0.08660130718954248,0.9133986928104575,237,0.16830065359477125,0.4444444444444444,0.3872549019607843
1430,1510001,783,34,130,294,749,783,1.0,0.04342273307790549,0.9565772669220945,359,0.16602809706257982,0.37547892720306514,0.45849297573435505
1431,1510004,928,26,131,317,902,928,1.0,0.028017241379310345,0.9719827586206896,480,0.1411637931034483,0.3415948275862069,0.5172413793103449
1432,1510010,564,16,106,238,548,564,1.0,0.028368794326241134,0.9716312056737588,220,0.1879432624113475,0.4219858156028369,0.3900709219858156
1433,1510012,687,26,145,245,661,687,1.0,0.03784570596797671,0.9621542940320232,297,0.21106259097525473,0.35662299854439594,0.43231441048034935
1434,1530001,1158,12,120,620,1146,1158,1.0,0.010362694300518135,0.9896373056994818,418,0.10362694300518134,0.5354058721934369,0.3609671848013817
1435,1530009,109,0,11,66,109,109,1.0,0.0,1.0,32,0.10091743119266056,0.6055045871559633,0.29357798165137616
1436,1530018,1055,8,132,522,1047,1055,1.0,0.007582938388625593,0.9924170616113744,401,0.12511848341232226,0.4947867298578199,0.3800947867298578
1437,1530023,855,39,136,195,816,855,1.0,0.0456140350877193,0.9543859649122807,524,0.15906432748538013,0.22807017543859648,0.6128654970760234
1438,1530024,438,9,74,99,429,438,1.0,0.02054794520547945,0.9794520547945206,265,0.1689497716894977,0.22602739726027396,0.6050228310502284
1439,153024BA,297,44,78,21,253,297,1.0,0.14814814814814814,0.8518518518518519,198,0.26262626262626265,0.0707070707070707,0.6666666666666666
1440,153024BB,1,0,0,0,1,1,1.0,0.0,1.0,1,0.0,0.0,1.0
1441,1550101,216,1,24,64,215,216,1.0,0.004629629629629629,0.9953703703703703,128,0.1111111111111111,0.2962962962962963,0.5925925925925926
1442,1550201,288,2,36,106,286,288,1.0,0.006944444444444444,0.9930555555555556,146,0.125,0.3680555555555556,0.5069444444444444
1443,1550301,310,2,45,98,308,310,1.0,0.0064516129032258064,0.9935483870967742,167,0.14516129032258066,0.3161290322580645,0.5387096774193548
1444,1550401,294,2,35,80,292,294,1.0,0.006802721088435374,0.9931972789115646,179,0.11904761904761904,0.272108843537415,0.608843537414966
1445,1571001,4443,677,312,853,3766,4443,1.0,0.15237452171955887,0.8476254782804411,3278,0.07022282241728561,0.1919873959036687,0.7377897816790457
1446,1571002,859,482,366,27,377,859,1.0,0.5611175785797439,0.43888242142025613,466,0.42607683352735737,0.03143189755529686,0.5424912689173458
1447,1571003,3279,1586,846,198,1693,3279,1.0,0.48368405001524856,0.5163159499847515,2235,0.25800548947849955,0.06038426349496798,0.6816102470265325
1448,1571152,4901,1004,332,486,3897,4901,1.0,0.20485615180575392,0.7951438481942461,4083,0.06774127729034891,0.09916343603346256,0.8330952866761885
1449,1571008,928,79,133,409,849,928,1.0,0.08512931034482758,0.9148706896551724,386,0.14331896551724138,0.44073275862068967,0.41594827586206895
1450,1571010,4237,241,490,1753,3996,4237,1.0,0.05687986783101251,0.9431201321689875,1994,0.11564786405475572,0.4137361340571159,0.4706160018881284
1451,1571012,4004,294,596,684,3710,4004,1.0,0.07342657342657342,0.9265734265734266,2724,0.14885114885114886,0.17082917082917082,0.6803196803196803
1452,1571013,3516,403,526,846,3113,3516,1.0,0.11461888509670079,0.8853811149032992,2144,0.1496018202502844,0.24061433447098976,0.6097838452787259
1453,1571015,1678,113,155,568,1565,1678,1.0,0.06734207389749702,0.932657926102503,955,0.09237187127532777,0.33849821215733017,0.569129916567342
1454,1571018,2546,12,153,898,2534,2546,1.0,0.004713275726630008,0.99528672427337,1495,0.0600942655145326,0.3527101335428123,0.5871956009426551
1455,1571021,734,1,60,424,733,734,1.0,0.0013623978201634877,0.9986376021798365,250,0.08174386920980926,0.5776566757493188,0.3405994550408719
1456,1571024,1359,128,103,435,1231,1359,1.0,0.094186902133922,0.905813097866078,821,0.07579102281089035,0.3200883002207506,0.6041206769683591
1457,1571025,3852,369,513,826,3483,3852,1.0,0.09579439252336448,0.9042056074766355,2513,0.13317757009345793,0.21443406022845274,0.6523883696780893
1458,1571037,3299,178,538,852,3121,3299,1.0,0.053955744164898456,0.9460442558351015,1909,0.16307972112761443,0.25826007881176116,0.5786602000606245
1459,1571040,3711,722,780,191,2989,3711,1.0,0.19455672325518727,0.8054432767448128,2740,0.21018593371059013,0.051468606844516304,0.7383454594448936
1460,1571048,2944,777,555,296,2167,2944,1.0,0.2639266304347826,0.7360733695652174,2093,0.18851902173913043,0.10054347826086957,0.7109375
1461,1571054,807,89,86,141,718,807,1.0,0.11028500619578686,0.8897149938042132,580,0.10656753407682776,0.17472118959107807,0.7187112763320942
1462,1571058,951,275,230,106,676,951,1.0,0.2891692954784437,0.7108307045215563,615,0.24185068349106204,0.11146161934805468,0.6466876971608833
1463,1571067,3654,1419,856,637,2235,3654,1.0,0.38834154351395733,0.6116584564860427,2161,0.23426382047071703,0.1743295019157088,0.5914066776135741
1464,1571068,521,2,25,238,519,521,1.0,0.003838771593090211,0.9961612284069098,258,0.04798464491362764,0.45681381957773515,0.4952015355086372
1465,1571072,68,0,12,49,68,68,1.0,0.0,1.0,7,0.17647058823529413,0.7205882352941176,0.10294117647058823
1466,1571073,1290,225,231,546,1065,1290,1.0,0.1744186046511628,0.8255813953488372,513,0.17906976744186046,0.4232558139534884,0.39767441860465114
1467,1571074,4054,770,789,800,3284,4054,1.0,0.18993586581154415,0.8100641341884558,2465,0.1946225949679329,0.1973359644795264,0.6080414405525407
1468,1571076,6036,1198,1507,1084,4838,6036,1.0,0.19847581179589133,0.8015241882041086,3445,0.24966865473823724,0.17958913187541417,0.5707422133863486
1469,1571085,3611,494,746,1001,3117,3611,1.0,0.136804209360288,0.863195790639712,1864,0.20659097202990861,0.27720852949321517,0.5162004984768762
1470,1571087,1995,105,348,929,1890,1995,1.0,0.05263157894736842,0.9473684210526315,718,0.17443609022556392,0.4656641604010025,0.3598997493734336
1471,1571094,17,5,5,3,12,17,1.0,0.29411764705882354,0.7058823529411765,9,0.29411764705882354,0.17647058823529413,0.5294117647058824
1472,1571097,5290,1517,1129,1795,3773,5290,1.0,0.2867674858223062,0.7132325141776937,2366,0.21342155009451796,0.3393194706994329,0.4472589792060491
1473,1571103,5861,1254,590,1863,4607,5861,1.0,0.21395666268554855,0.7860433373144514,3408,0.10066541545811294,0.3178638457601092,0.5814707387817779
1474,1571109,1061,303,208,251,758,1061,1.0,0.2855796418473139,0.7144203581526861,602,0.19604147031102734,0.236569274269557,0.5673892554194157
1475,1571114,4780,3202,2320,173,1578,4780,1.0,0.6698744769874477,0.3301255230125523,2287,0.48535564853556484,0.03619246861924686,0.4784518828451883
1476,1571118,4386,1244,1009,1755,3142,4386,1.0,0.2836297309621523,0.7163702690378477,1622,0.23005015959872321,0.40013679890560877,0.369813041495668
1477,1571120,2796,253,500,1722,2543,2796,1.0,0.09048640915593706,0.9095135908440629,574,0.17882689556509299,0.6158798283261803,0.20529327610872675
1478,1571128,3954,493,554,1738,3461,3954,1.0,0.12468386444107234,0.8753161355589276,1662,0.14011127971674253,0.4395548811330298,0.4203338391502276
1479,1571134,3128,1191,452,274,1937,3128,1.0,0.3807544757033248,0.6192455242966752,2402,0.1445012787723785,0.08759590792838874,0.7679028132992327
1480,1571141,505,89,87,62,416,505,1.0,0.17623762376237623,0.8237623762376237,356,0.17227722772277226,0.12277227722772277,0.7049504950495049
1481,1571007,2016,361,773,1126,1655,2016,1.0,0.17906746031746032,0.8209325396825397,117,0.3834325396825397,0.558531746031746,0.05803571428571429
1482,1571153,2654,2088,1197,94,566,2654,1.0,0.7867370007535796,0.2132629992464205,1363,0.45101733232856067,0.03541823662396383,0.5135644310474755
1483,1571154,3267,483,409,638,2784,3267,1.0,0.14784205693296604,0.852157943067034,2220,0.12519130700948883,0.19528619528619529,0.6795224977043158
1484,1572016,4139,516,948,1051,3623,4139,1.0,0.1246677941531771,0.8753322058468229,2140,0.2290408311186277,0.25392606909881615,0.5170330997825562
1485,1572017,2359,1788,1610,49,571,2359,1.0,0.7579482831708351,0.2420517168291649,700,0.6824925816023739,0.020771513353115726,0.29673590504451036
1486,1572022,3436,381,748,1372,3055,3436,1.0,0.1108847497089639,0.8891152502910361,1316,0.21769499417927823,0.39930151338766007,0.3830034924330617
1487,1572023,2887,1593,1152,161,1294,2887,1.0,0.5517838586768271,0.44821614132317283,1574,0.39903013508832696,0.05576723242119848,0.5452026324904745
1488,1572031,2786,1623,1696,55,1163,2786,1.0,0.5825556353194544,0.4174443646805456,1035,0.6087580760947595,0.01974156496769562,0.37150035893754485
1489,1572033,1023,208,579,214,815,1023,1.0,0.20332355816226785,0.7966764418377321,230,0.5659824046920822,0.20918866080156404,0.22482893450635386
1490,1572034,4203,3425,1396,86,778,4203,1.0,0.814894123245301,0.18510587675469903,2721,0.33214370687604095,0.020461575065429456,0.6473947180585297
1491,1572036,941,726,729,38,215,941,1.0,0.7715196599362381,0.22848034006376194,174,0.7747077577045696,0.040382571732199786,0.1849096705632306
1492,1572043,1122,283,267,115,839,1122,1.0,0.2522281639928699,0.7477718360071302,740,0.23796791443850268,0.10249554367201426,0.6595365418894831
1493,1572050,2935,2558,1962,69,377,2935,1.0,0.8715502555366269,0.1284497444633731,904,0.6684838160136286,0.023509369676320273,0.3080068143100511
1494,1572051,2230,2037,1412,35,193,2230,1.0,0.9134529147982062,0.08654708520179372,783,0.6331838565022422,0.01569506726457399,0.35112107623318384
1495,1572052,2395,1814,1592,64,581,2395,1.0,0.7574112734864301,0.24258872651356994,739,0.6647181628392484,0.026722338204592903,0.30855949895615864
1496,1572055,1265,1135,648,19,130,1265,1.0,0.8972332015810277,0.10276679841897234,598,0.5122529644268775,0.015019762845849802,0.4727272727272727
1497,1572056,1005,407,288,103,598,1005,1.0,0.40497512437810945,0.5950248756218905,614,0.2865671641791045,0.10248756218905472,0.6109452736318408
1498,1572059,2723,1898,1476,85,825,2723,1.0,0.6970253396988616,0.30297466030113845,1162,0.5420492104296731,0.031215571061329415,0.4267352185089974
1499,1572060,4515,1711,1160,446,2804,4515,1.0,0.37895902547065335,0.6210409745293466,2909,0.25692137320044295,0.09878183831672203,0.644296788482835
1500,1572061,2379,626,486,466,1753,2379,1.0,0.26313577133249266,0.7368642286675073,1427,0.2042875157629256,0.1958806221101303,0.5998318621269441
1501,1572066,5886,2599,1751,562,3287,5886,1.0,0.44155623513421677,0.5584437648657832,3573,0.29748555895344886,0.09548080190282025,0.6070336391437309
1502,1572070,2110,723,422,403,1387,2110,1.0,0.34265402843601894,0.657345971563981,1285,0.2,0.1909952606635071,0.6090047393364929
1503,1572075,2605,2061,1153,95,544,2605,1.0,0.7911708253358926,0.2088291746641075,1357,0.44261036468330134,0.036468330134357005,0.5209213051823417
1504,1572077,2588,1952,1086,123,636,2588,1.0,0.7542503863987635,0.24574961360123648,1379,0.419629057187017,0.047527047913446675,0.5328438948995363
1505,1572078,273,85,205,67,188,273,1.0074074074074073,0.31135531135531136,0.6886446886446886,1,0.7509157509157509,0.2454212454212454,0.003663003663003663
1506,1572081,1588,819,437,237,769,1588,1.0,0.5157430730478589,0.48425692695214106,914,0.2751889168765743,0.14924433249370278,0.575566750629723
1507,1572088,3315,1536,1102,514,1779,3315,1.0,0.4633484162895928,0.5366515837104072,1699,0.3324283559577677,0.155052790346908,0.5125188536953242
1508,1572089,1347,1125,832,27,222,1347,1.0,0.8351893095768375,0.16481069042316257,488,0.6176688938381588,0.0200445434298441,0.36228656273199705
1509,1572090,683,129,219,302,554,683,1.0,0.18887262079062958,0.8111273792093704,162,0.3206442166910688,0.44216691068814057,0.23718887262079064
1510,1572091,627,162,321,139,465,627,1.0,0.2583732057416268,0.7416267942583732,167,0.5119617224880383,0.22169059011164274,0.266347687400319
1511,1572092,561,69,313,244,492,561,1.0,0.12299465240641712,0.8770053475935828,4,0.5579322638146168,0.43493761140819964,0.0071301247771836
1512,1572093,609,86,175,85,523,609,1.0,0.1412151067323481,0.8587848932676518,349,0.28735632183908044,0.13957307060755336,0.5730706075533661
1513,1572096,4383,1408,890,480,2975,4383,1.0,0.32124115902349987,0.6787588409765001,3013,0.2030572667122975,0.10951403148528405,0.6874287018024184
1514,1572099,4216,1103,1151,731,3113,4216,1.0,0.2616223908918406,0.7383776091081594,2334,0.2730075901328273,0.17338709677419356,0.5536053130929791
1515,1572100,2968,1146,888,520,1822,2968,1.0,0.3861185983827493,0.6138814016172507,1560,0.2991913746630728,0.1752021563342318,0.5256064690026954
1516,1572101,4791,1725,1294,472,3066,4791,1.0,0.3600500939261115,0.6399499060738886,3025,0.2700897516176164,0.09851805468586934,0.6313921936965143
1517,1572106,7478,2004,1423,575,5474,7478,1.0,0.2679860925381118,0.7320139074618882,5480,0.190291521797272,0.07689221717036641,0.7328162610323616
1518,1572108,5657,2965,1845,701,2692,5657,1.0,0.5241293972070001,0.4758706027929998,3111,0.3261445996111013,0.12391727063814743,0.5499381297507513
1519,1572112,796,146,127,36,650,796,1.0,0.18341708542713567,0.8165829145728644,633,0.15954773869346733,0.04522613065326633,0.7952261306532663
1520,1572115,1557,673,795,290,884,1557,1.0,0.43224149004495827,0.5677585099550417,472,0.5105973025048169,0.18625561978163135,0.3031470777135517
1521,1572116,1919,1615,1496,64,304,1919,1.0,0.8415841584158416,0.15841584158415842,359,0.7795726941115164,0.03335070349140177,0.18707660239708182
1522,1572123,2005,1496,1101,31,509,2005,1.0,0.7461346633416459,0.2538653366583541,873,0.5491271820448878,0.015461346633416459,0.4354114713216958
1523,1572136,356,275,162,82,81,356,1.0,0.7724719101123596,0.22752808988764045,112,0.4550561797752809,0.2303370786516854,0.3146067415730337
1524,1572137,879,177,166,87,702,879,1.0,0.20136518771331058,0.7986348122866894,626,0.18885096700796358,0.09897610921501707,0.7121729237770194
1525,1572151,3040,797,615,595,2243,3040,1.0,0.26217105263157897,0.7378289473684211,1830,0.20230263157894737,0.19572368421052633,0.6019736842105263
1526,1572157,2259,592,452,436,1667,2259,1.0,0.26206285967242143,0.7379371403275786,1371,0.20008853474988933,0.19300575475874282,0.6069057104913679
1527,1573004,3466,320,683,1606,3146,3466,1.0,0.09232544720138489,0.9076745527986151,1177,0.19705712637045586,0.4633583381419504,0.33958453548759376
1528,1573005,3497,345,407,1261,3152,3497,1.0,0.0986559908492994,0.9013440091507006,1829,0.11638547326279668,0.36059479553903345,0.5230197311981699
1529,1573006,3085,206,183,871,2879,3085,1.0,0.06677471636952999,0.93322528363047,2031,0.0593192868719611,0.28233387358184764,0.6583468395461912
1530,1573014,6759,565,418,1754,6194,6759,1.0,0.08359224737387187,0.9164077526261282,4587,0.061843467968634415,0.2595058440597722,0.6786506879715934
1531,1573019,1558,51,126,566,1507,1558,1.0,0.03273427471116817,0.9672657252888318,866,0.08087291399229782,0.3632862644415918,0.5558408215661104
1532,1573032,2957,734,823,537,2223,2957,1.0,0.24822455191072032,0.7517754480892797,1597,0.2783226242813662,0.1816029759891782,0.5400743997294555
1533,1573038,6517,1274,754,2156,5243,6517,1.0,0.19548872180451127,0.8045112781954887,3607,0.11569740678226177,0.3308270676691729,0.5534755255485653
1534,1573041,2770,181,277,1125,2589,2770,1.0,0.06534296028880866,0.9346570397111913,1368,0.1,0.40613718411552346,0.49386281588447656
1535,1573053,143,18,0,1,125,143,1.0,0.1258741258741259,0.8741258741258742,142,0.0,0.006993006993006993,0.993006993006993
1536,1573057,4256,429,435,1501,3827,4256,1.0,0.10079887218045112,0.8992011278195489,2320,0.10220864661654136,0.35267857142857145,0.5451127819548872
1537,1573063,3261,78,445,1890,3183,3261,1.0,0.02391904323827047,0.9760809567617296,926,0.13646120821833793,0.5795768169273229,0.28396197485433916
1538,1573069,375,1,100,182,374,375,1.0,0.0026666666666666666,0.9973333333333333,93,0.26666666666666666,0.48533333333333334,0.248
1539,1573083,4885,1309,891,617,3576,4885,1.0,0.26796315250767655,0.7320368474923235,3377,0.18239508700102355,0.1263050153531218,0.6912998976458546
1540,1573095,1273,125,252,369,1148,1273,1.0,0.09819324430479183,0.9018067556952082,652,0.19795758051846032,0.2898664571877455,0.5121759622937941
1541,1573098,2967,630,657,580,2337,2967,1.0,0.2123356926188069,0.7876643073811931,1730,0.22143579373104147,0.19548365352207617,0.5830805527468824
1542,1573104,4051,356,609,2281,3695,4051,1.0,0.08787953591705752,0.9121204640829425,1161,0.15033325104912368,0.5630708467045175,0.28659590224635895
1543,1573113,4841,1491,1644,327,3350,4841,1.0,0.3079942160710597,0.6920057839289403,2870,0.3395992563519934,0.06754802726709358,0.5928527163809131
1544,1573122,3443,111,529,2140,3332,3443,1.0,0.03223932616903863,0.9677606738309613,774,0.15364507696776067,0.6215509729886727,0.22480395004356665
1545,1573130,4340,184,719,1859,4156,4340,1.0,0.0423963133640553,0.9576036866359448,1762,0.16566820276497696,0.4283410138248848,0.4059907834101382
1546,1573132,3590,319,802,2011,3271,3590,1.0,0.08885793871866295,0.911142061281337,777,0.2233983286908078,0.5601671309192201,0.21643454038997215
1547,1573133,3013,95,519,1938,2918,3013,1.0,0.031530036508463324,0.9684699634915367,556,0.17225356787255228,0.6432127447726519,0.1845336873547959
1548,1573142,6814,366,706,1727,6448,6814,1.0,0.05371294393894922,0.9462870560610508,4381,0.10361021426474905,0.2534487819195773,0.6429410038156737
1549,1573144,4593,190,588,1840,4403,4593,1.0,0.04136729806226867,0.9586327019377313,2165,0.1280209013716525,0.400609623339865,0.4713694752884825
1550,1573145,2380,68,402,1035,2312,2380,1.0,0.02857142857142857,0.9714285714285714,943,0.1689075630252101,0.43487394957983194,0.39621848739495796
1551,1573146,7818,664,981,2413,7154,7818,1.0,0.08493220772576106,0.915067792274239,4424,0.1254796623177283,0.30864671271424915,0.5658736249680225
1552,1573148,5490,366,342,1597,5124,5490,1.0,0.06666666666666667,0.9333333333333333,3551,0.06229508196721312,0.29089253187613845,0.6468123861566485
1553,1573149,3907,224,465,2177,3683,3907,1.0,0.05733299206552342,0.9426670079344766,1265,0.11901714870744817,0.5572050166368058,0.3237778346557461
1554,1573150,8664,2322,1583,1113,6342,8664,1.0,0.268005540166205,0.731994459833795,5968,0.1827100646352724,0.12846260387811634,0.6888273314866112
1555,1573156,1673,114,299,1230,1559,1673,1.0,0.06814106395696354,0.9318589360430365,144,0.17872086072922894,0.7352062163777645,0.08607292289300658
1556,1573159,2316,197,289,713,2119,2316,1.0,0.08506044905008636,0.9149395509499136,1314,0.12478411053540588,0.3078583765112263,0.5673575129533679
1557,1573160,2429,331,368,859,2098,2429,1.0,0.13627006998764923,0.8637299300123508,1202,0.15150267599835324,0.35364347468093865,0.4948538493207081
1558,1574011,1489,205,343,775,1284,1489,1.0,0.13767629281396912,0.8623237071860309,371,0.23035594358629952,0.5204835460040296,0.2491605104096709
1559,1574020,3541,238,474,1549,3303,3541,1.0,0.06721265179327873,0.9327873482067213,1518,0.13386049138661396,0.4374470488562553,0.4286924597571308
1560,1574026,2827,141,697,1345,2686,2827,1.0,0.04987619384506544,0.9501238061549345,785,0.24655111425539442,0.47576936681995047,0.2776795189246551
1562,1574028,2565,737,644,909,1828,2565,1.0,0.28732943469785577,0.7126705653021442,1012,0.2510721247563353,0.3543859649122807,0.394541910331384
1563,1574029,2142,75,354,1036,2067,2142,1.0,0.0350140056022409,0.9649859943977591,752,0.16526610644257703,0.48366013071895425,0.3510737628384687
1564,1574030,2462,421,678,1294,2041,2462,1.0,0.1709991876523152,0.8290008123476849,490,0.27538586515028435,0.5255889520714866,0.1990251827782291
1565,1574035,1786,265,389,554,1521,1786,1.0,0.14837625979843225,0.8516237402015677,843,0.21780515117581187,0.3101903695408735,0.4720044792833147
1566,1574039,1001,241,271,260,760,1001,1.0,0.24075924075924077,0.7592407592407593,470,0.2707292707292707,0.2597402597402597,0.4695304695304695
1567,1574042,1446,55,122,448,1391,1446,1.0,0.03803596127247579,0.9619640387275242,876,0.08437067773167359,0.30982019363762103,0.6058091286307054
1568,1574044,3280,345,330,490,2935,3280,1.0,0.10518292682926829,0.8948170731707317,2460,0.10060975609756098,0.14939024390243902,0.75
1569,1574045,1907,366,506,608,1541,1907,1.0,0.19192448872574724,0.8080755112742527,793,0.26533822758259046,0.3188253801782905,0.41583639223911906
1570,1574046,3439,134,784,1227,3305,3439,1.0,0.038964815353300375,0.9610351846466996,1428,0.22797324803722013,0.35678976446641464,0.41523698749636523
1571,1574047,750,20,201,336,730,750,1.0,0.02666666666666667,0.9733333333333334,213,0.268,0.448,0.284
1572,1574062,2937,750,1098,1181,2187,2937,1.0,0.2553626149131767,0.7446373850868233,658,0.3738508682328907,0.4021109976166156,0.2240381341504937
1573,1574064,1250,210,235,503,1040,1250,1.0,0.168,0.832,512,0.188,0.4024,0.4096
1574,1574065,4608,676,1109,1395,3932,4608,1.0,0.1467013888888889,0.8532986111111112,2104,0.2406684027777778,0.302734375,0.4565972222222222
1575,1574071,171,46,65,97,125,171,1.0,0.26900584795321636,0.7309941520467836,9,0.38011695906432746,0.5672514619883041,0.05263157894736842
1576,1574079,383,13,113,179,370,383,1.0,0.033942558746736295,0.9660574412532638,91,0.2950391644908616,0.46736292428198434,0.23759791122715404
1577,1574080,918,64,262,311,854,918,1.0,0.06971677559912855,0.9302832244008714,345,0.28540305010893247,0.33877995642701525,0.3758169934640523
1578,1574082,5800,872,1041,2033,4928,5800,1.0,0.1503448275862069,0.8496551724137931,2726,0.17948275862068966,0.35051724137931034,0.47
1579,1574084,1895,44,386,615,1851,1895,1.0,0.02321899736147757,0.9767810026385224,894,0.20369393139841688,0.3245382585751979,0.47176781002638524
1580,1574086,3242,573,779,447,2669,3242,1.0,0.17674275138803208,0.8232572486119679,2016,0.2402837754472548,0.1378778531770512,0.621838371375694
1581,1574102,3336,69,621,629,3267,3336,1.0,0.02068345323741007,0.97931654676259,2086,0.18615107913669066,0.18854916067146282,0.6252997601918465
1582,1574105,1439,51,332,438,1388,1439,1.0,0.035441278665740095,0.9645587213342599,669,0.23071577484364142,0.30437804030576787,0.4649061848505907
1583,1574107,1911,10,379,1015,1901,1911,1.0,0.0052328623757195184,0.9947671376242805,517,0.19832548403976977,0.5311355311355311,0.2705389848246991
1584,1574110,2866,166,647,1000,2700,2866,1.0,0.05792044661549198,0.942079553384508,1219,0.22575017445917656,0.34891835310537334,0.4253314724354501
1585,1574111,1491,54,348,586,1437,1491,1.0,0.03621730382293763,0.9637826961770624,557,0.23340040241448692,0.39302481556002683,0.3735747820254863
1586,1574117,2874,770,529,557,2104,2874,1.0,0.26791927627000695,0.732080723729993,1788,0.18406402226861518,0.19380654140570633,0.6221294363256785
1587,1574119,2954,37,611,1752,2917,2954,1.0,0.012525389302640487,0.9874746106973595,591,0.20683818551117128,0.5930941096817874,0.2000677048070413
1588,1574121,1155,45,197,193,1110,1155,1.0,0.03896103896103896,0.961038961038961,765,0.17056277056277055,0.1670995670995671,0.6623376623376623
1589,1574124,6660,1081,986,1008,5579,6660,1.0,0.1623123123123123,0.8376876876876876,4666,0.14804804804804805,0.15135135135135136,0.7006006006006006
1590,1574125,5335,810,1142,959,4525,5335,1.0,0.15182755388940955,0.8481724461105904,3234,0.214058106841612,0.17975632614807874,0.6061855670103092
1591,1574126,3430,865,752,592,2565,3430,1.0,0.2521865889212828,0.7478134110787172,2086,0.21924198250728863,0.17259475218658893,0.6081632653061224
1592,1574127,3016,795,885,907,2221,3016,1.0,0.2635941644562334,0.7364058355437666,1224,0.29343501326259946,0.30072944297082227,0.40583554376657827
1593,1574129,4029,342,611,1421,3687,4029,1.0,0.08488458674609084,0.9151154132539091,1997,0.15165053363117398,0.352692975924547,0.49565649044427895
1594,1574131,1642,68,431,898,1574,1642,1.0,0.04141291108404385,0.9585870889159561,313,0.2624847746650426,0.5468940316686967,0.19062119366626065
1595,1574135,6556,333,1416,1796,6223,6556,1.0,0.05079316656497865,0.9492068334350213,3344,0.21598535692495424,0.27394752898108604,0.5100671140939598
1596,1574140,3388,63,750,1318,3325,3388,1.0,0.01859504132231405,0.981404958677686,1320,0.22136953955135774,0.38902007083825263,0.38961038961038963
1597,1574147,1799,498,309,244,1301,1799,1.0,0.2768204558087827,0.7231795441912173,1246,0.1717620900500278,0.1356309060589216,0.6926070038910506
1598,1574155,3508,432,841,665,3076,3508,1.0,0.12314709236031927,0.8768529076396807,2002,0.23973774230330672,0.1895667046750285,0.5706955530216647
1599,1574158,1401,64,233,296,1337,1401,1.0,0.04568165596002855,0.9543183440399714,872,0.16630977872947894,0.21127765881513205,0.622412562455389
1600,1590101,1450,148,145,593,1302,1450,1.0,0.10206896551724139,0.8979310344827586,712,0.1,0.4089655172413793,0.4910344827586207
1601,1590102,516,11,56,258,505,516,1.0,0.02131782945736434,0.9786821705426356,202,0.10852713178294573,0.5,0.39147286821705424
1602,1590201,599,38,44,303,561,599,1.0,0.06343906510851419,0.9365609348914858,252,0.07345575959933222,0.5058430717863105,0.42070116861435725
1603,1590202,1151,132,174,385,1019,1151,1.0,0.11468288444830582,0.8853171155516942,592,0.15117289313640314,0.3344917463075586,0.5143353605560382
1604,1590301,756,9,82,426,747,756,1.0,0.011904761904761904,0.9880952380952381,248,0.10846560846560846,0.5634920634920635,0.328042328042328
1605,1590302,962,0,68,348,962,962,1.0,0.0,1.0,546,0.07068607068607069,0.36174636174636177,0.5675675675675675
1606,1590401,1178,0,104,701,1178,1178,1.0,0.0,1.0,373,0.08828522920203735,0.5950764006791172,0.3166383701188455
1607,1590402,917,0,77,432,917,917,1.0,0.0,1.0,408,0.08396946564885496,0.47110141766630315,0.44492911668484186
1608,1610001,2956,436,279,1621,2520,2956,1.0,0.14749661705006767,0.8525033829499323,1056,0.09438430311231394,0.5483761840324763,0.3572395128552097
1609,1610002,1706,503,394,623,1203,1706,1.0,0.29484173505275496,0.705158264947245,689,0.2309495896834701,0.36518171160609614,0.40386869871043374
1610,1610003,201,21,14,77,180,201,1.0,0.1044776119402985,0.8955223880597015,110,0.06965174129353234,0.38308457711442784,0.5472636815920398
1611,1610004,425,2,41,189,423,425,1.0,0.004705882352941176,0.9952941176470588,195,0.09647058823529411,0.4447058823529412,0.4588235294117647
1612,1610005,3880,484,413,963,3396,3880,1.0,0.12474226804123711,0.8752577319587629,2504,0.10644329896907216,0.2481958762886598,0.6453608247422681
1613,1610006,508,39,48,270,469,508,1.0,0.07677165354330709,0.9232283464566929,190,0.09448818897637795,0.531496062992126,0.37401574803149606
1614,1610007,1009,233,134,354,776,1009,1.0,0.2309217046580773,0.7690782953419227,521,0.13280475718533202,0.3508424182358771,0.5163528245787908
1615,1610008,575,144,46,309,431,575,1.0,0.25043478260869567,0.7495652173913043,220,0.08,0.5373913043478261,0.3826086956521739
1616,1610009,546,86,61,254,460,546,1.0,0.1575091575091575,0.8424908424908425,231,0.11172161172161173,0.4652014652014652,0.4230769230769231
1617,1610010,357,26,15,209,331,357,1.0,0.07282913165266107,0.927170868347339,133,0.04201680672268908,0.5854341736694678,0.37254901960784315
1618,1610011,710,174,245,159,536,710,1.0,0.24507042253521127,0.7549295774647887,306,0.34507042253521125,0.223943661971831,0.4309859154929577
1619,1610012,214,52,32,63,162,214,1.0,0.24299065420560748,0.7570093457943925,119,0.14953271028037382,0.29439252336448596,0.5560747663551402
1620,1610013,376,66,27,178,310,376,1.0,0.17553191489361702,0.824468085106383,171,0.07180851063829788,0.4734042553191489,0.45478723404255317
1621,1610014,529,119,55,245,410,529,1.0,0.22495274102079396,0.775047258979206,229,0.10396975425330812,0.46313799621928164,0.43289224952741023
1622,1610015,279,27,46,132,252,279,1.0,0.0967741935483871,0.9032258064516129,101,0.16487455197132617,0.4731182795698925,0.36200716845878134
1623,1630001,1618,53,373,191,1565,1618,1.0,0.032756489493201486,0.9672435105067985,1054,0.23053152039555005,0.1180469715698393,0.6514215080346106
1624,1630002,1399,0,301,59,1399,1399,1.0,0.0,1.0,1039,0.21515368120085776,0.04217298070050036,0.7426733380986419
1625,1630003,1085,0,332,53,1085,1085,1.0,0.0,1.0,700,0.30599078341013825,0.04884792626728111,0.6451612903225806
1626,1630004A,2024,44,291,362,1980,2024,1.0,0.021739130434782608,0.9782608695652174,1371,0.14377470355731226,0.17885375494071146,0.6773715415019763
1627,1630004B,30,0,1,3,30,30,1.0,0.0,1.0,26,0.03333333333333333,0.1,0.8666666666666667
1628,1630005,439,0,72,210,439,439,1.0,0.0,1.0,157,0.16400911161731208,0.4783599088838269,0.357630979498861
1629,1630006,470,0,91,153,470,470,1.0,0.0,1.0,226,0.19361702127659575,0.32553191489361705,0.4808510638297872
1630,1630008,1730,0,314,117,1730,1730,1.0,0.0,1.0,1299,0.1815028901734104,0.0676300578034682,0.7508670520231214
1631,1630009,1175,0,397,123,1175,1175,1.0,0.0,1.0,655,0.33787234042553194,0.1046808510638298,0.5574468085106383
1632,1630010,2654,380,199,281,2274,2654,1.0,0.14318010550113036,0.8568198944988696,2174,0.07498116051243406,0.10587792012057272,0.8191409193669932
1633,1650002,1984,28,108,779,1956,1984,1.0,0.014112903225806451,0.9858870967741935,1097,0.05443548387096774,0.39264112903225806,0.5529233870967742
1634,1650003,2826,20,93,1177,2806,2826,1.0,0.007077140835102618,0.9929228591648974,1556,0.032908704883227176,0.4164897381457891,0.5506015569709837
1635,1650004,2036,106,98,522,1930,2036,1.0,0.05206286836935167,0.9479371316306483,1416,0.0481335952848723,0.25638506876227896,0.6954813359528488
1636,1650005,221,3,10,146,218,221,1.0,0.013574660633484163,0.9864253393665159,65,0.04524886877828054,0.6606334841628959,0.29411764705882354
1637,1650006,341,0,19,99,341,341,1.0,0.0,1.0,223,0.05571847507331378,0.2903225806451613,0.6539589442815249
1638,1650007,678,29,103,111,649,678,1.0,0.04277286135693215,0.9572271386430679,464,0.15191740412979352,0.16371681415929204,0.6843657817109144
1639,1650008,843,36,71,402,807,843,1.0,0.042704626334519574,0.9572953736654805,370,0.08422301304863583,0.47686832740213525,0.4389086595492289
1640,1650009,1234,41,33,248,1193,1234,1.0,0.03322528363047002,0.9667747163695299,953,0.02674230145867099,0.20097244732576985,0.7722852512155591
1641,1670103,985,4,155,442,981,985,1.0,0.0040609137055837565,0.9959390862944163,388,0.15736040609137056,0.44873096446700506,0.39390862944162436
1642,1670104,789,5,99,313,784,789,1.0,0.0063371356147021544,0.9936628643852978,377,0.12547528517110265,0.39670468948035487,0.47782002534854245
1643,1670105,1364,141,28,57,1223,1364,1.0,0.10337243401759531,0.8966275659824047,1279,0.020527859237536656,0.041788856304985335,0.9376832844574781
1644,1670142,3297,659,631,740,2638,3297,1.0,0.19987867758568395,0.800121322414316,1926,0.1913861085835608,0.22444646648468305,0.5841674249317561
1645,1670144,2670,251,403,976,2419,2670,1.0,0.09400749063670412,0.9059925093632959,1291,0.15093632958801498,0.36554307116104867,0.4835205992509363
1646,1670146,2989,538,618,937,2451,2989,1.0,0.1799933087989294,0.8200066912010706,1434,0.2067581130812981,0.31348277015724324,0.47975911676145866
1647,1670148,4788,681,753,1292,4107,4788,1.0,0.14223057644110276,0.8577694235588973,2743,0.15726817042606517,0.2698412698412698,0.572890559732665
1648,1670150,2725,272,491,873,2453,2725,1.0,0.09981651376146788,0.9001834862385321,1361,0.18018348623853211,0.3203669724770642,0.49944954128440366
1649,1670151,4102,227,404,1131,3875,4102,1.0,0.0553388590931253,0.9446611409068747,2567,0.098488542174549,0.2757191613846904,0.6257922964407606
1650,1670152,5011,113,691,2451,4898,5011,1.0,0.022550389143883458,0.9774496108561166,1869,0.1378966274196767,0.4891239273598084,0.37297944522051485
1651,1670159,6066,131,602,1197,5935,6066,1.0,0.021595779756017144,0.9784042202439829,4267,0.0992416749093307,0.19732937685459942,0.7034289482360699
1652,1670165,2915,94,339,949,2821,2915,1.0,0.03224699828473413,0.9677530017152659,1627,0.11629502572898799,0.32555746140651803,0.558147512864494
1653,1670166,3273,87,499,1333,3186,3273,1.0,0.026581118240146653,0.9734188817598534,1441,0.15245951726245036,0.40727161625420105,0.4402688664833486
1654,1670167,6834,475,735,2360,6359,6834,1.0,0.06950541410594088,0.9304945858940591,3739,0.10755048287971905,0.3453321627158326,0.5471173544044483
1657,1670170,2857,536,446,1353,2321,2857,1.0,0.18760938046902345,0.8123906195309766,1058,0.15610780539026953,0.4735736786839342,0.3703185159257963
1658,1670172,1009,233,88,216,776,1009,1.0,0.2309217046580773,0.7690782953419227,705,0.08721506442021804,0.21407333994053518,0.6987115956392468
1659,1670192,1036,137,89,294,899,1036,1.0,0.13223938223938225,0.8677606177606177,653,0.0859073359073359,0.28378378378378377,0.6303088803088803
1660,1670193,3659,340,352,1041,3319,3659,1.0,0.09292156326865264,0.9070784367313474,2266,0.09620114785460508,0.2845039628313747,0.6192948893140202
1661,1670197,1513,220,127,311,1293,1513,1.0,0.14540647719762062,0.8545935228023793,1075,0.08393919365499009,0.20555188367481825,0.7105089226701917
1662,1670218,3042,330,950,961,2712,3042,1.0,0.10848126232741617,0.8915187376725838,1131,0.31229454306377386,0.3159105851413544,0.3717948717948718
1663,1670219,1796,275,401,455,1521,1796,1.0,0.15311804008908686,0.8468819599109132,940,0.2232739420935412,0.25334075723830735,0.5233853006681515
1664,1670220,5277,309,691,1479,4968,5277,1.0,0.05855599772598067,0.9414440022740194,3107,0.13094561303771082,0.2802728823194997,0.5887815046427894
1665,1670221,1653,3,294,868,1650,1653,1.0,0.0018148820326678765,0.9981851179673321,491,0.17785843920145192,0.5251058681185723,0.2970356926799758
1666,1670223,3452,806,758,810,2646,3452,1.0,0.23348783314020857,0.7665121668597914,1884,0.21958285052143686,0.23464658169177288,0.5457705677867902
1667,1670224,4246,554,811,895,3692,4246,1.0,0.1304757418747056,0.8695242581252944,2540,0.1910032972209138,0.21078662270372114,0.598210080075365
1668,1670226,3277,459,529,859,2818,3277,1.0,0.14006713457430578,0.8599328654256942,1889,0.16142813548977725,0.2621299969484284,0.5764418675617943
1669,1670227,3800,53,335,1376,3747,3800,1.0,0.013947368421052632,0.9860526315789474,2089,0.0881578947368421,0.36210526315789476,0.5497368421052632
1670,1670228,3927,136,315,1550,3791,3927,1.0,0.03463203463203463,0.9653679653679653,2062,0.08021390374331551,0.3947033358798065,0.5250827603768781
1671,1670232,2210,344,489,587,1866,2210,1.0,0.15565610859728507,0.8443438914027149,1134,0.22126696832579185,0.2656108597285068,0.5131221719457013
1672,1670258,2612,0,236,1035,2612,2612,1.0,0.0,1.0,1341,0.0903522205206738,0.3962480857580398,0.5133996937212864
1673,1670263,6569,439,760,2495,6130,6569,1.0,0.06682904551682144,0.9331709544831785,3314,0.11569493073527173,0.3798142791901355,0.5044907900745927
1674,1670274,734,0,116,383,734,734,1.0,0.0,1.0,235,0.15803814713896458,0.5217983651226158,0.3201634877384196
1675,1670275,321,0,48,171,321,321,1.0,0.0,1.0,102,0.14953271028037382,0.5327102803738317,0.3177570093457944
1676,1670276,2498,61,467,650,2437,2498,1.0,0.0244195356285028,0.9755804643714971,1381,0.18694955964771817,0.2602081665332266,0.5528422738190553
1677,1670277,3153,134,273,1121,3019,3153,1.0,0.04249920710434507,0.9575007928956549,1759,0.08658420551855375,0.355534411671424,0.5578813828100222
1678,1670278,3299,0,285,1228,3299,3299,1.0,0.0,1.0,1786,0.08638981509548348,0.3722340103061534,0.5413761745983632
1679,1670279,1257,0,103,533,1257,1257,1.0,0.0,1.0,621,0.08194112967382657,0.42402545743834524,0.49403341288782815
1680,1670280,154,4,15,74,150,154,1.0,0.025974025974025976,0.974025974025974,65,0.09740259740259741,0.4805194805194805,0.42207792207792205
1681,1670281,432,22,35,100,410,432,1.0,0.05092592592592592,0.9490740740740741,297,0.08101851851851852,0.23148148148148148,0.6875
1682,1670283,4123,238,576,1227,3885,4123,1.0,0.057724957555178265,0.9422750424448217,2320,0.1397040989570701,0.29759883579917534,0.5626970652437545
1683,1670301,1648,331,290,193,1317,1648,1.0,0.2008495145631068,0.7991504854368932,1165,0.17597087378640777,0.1171116504854369,0.7069174757281553
1684,1670306,5403,757,1295,873,4646,5403,1.0,0.14010734776975753,0.8598926522302425,3235,0.2396816583379604,0.16157690172126596,0.5987414399407737
1685,1670309,228,83,31,15,145,228,1.0,0.36403508771929827,0.6359649122807017,182,0.13596491228070176,0.06578947368421052,0.7982456140350878
1686,1670311,3328,1426,506,56,1902,3328,1.0,0.4284855769230769,0.5715144230769231,2766,0.15204326923076922,0.016826923076923076,0.8311298076923077
1687,1670312,33,6,0,0,27,33,1.0,0.18181818181818182,0.8181818181818182,33,0.0,0.0,1.0
1688,1670314,4318,1472,1780,410,2846,4318,1.0,0.34089856415006947,0.6591014358499305,2128,0.412227883279296,0.09495136637332098,0.49282075034738304
1689,1670315,4416,804,1338,632,3612,4416,1.0,0.18206521739130435,0.8179347826086957,2446,0.3029891304347826,0.1431159420289855,0.5538949275362319
1690,1670316A,2747,591,639,288,2156,2747,1.0,0.21514379322897706,0.784856206771023,1820,0.23261740080087367,0.10484164543137969,0.6625409537677467
1692,1670330,3431,1320,1098,544,2111,3431,1.0,0.3847274846983387,0.6152725153016613,1789,0.32002331681725443,0.15855435733022444,0.5214223258525211
1693,1670331,2763,1739,1244,305,1024,2763,1.0,0.6293883460007238,0.37061165399927615,1214,0.4502352515381831,0.11038726022439377,0.43937748823742306
1694,1670334,1659,687,713,64,972,1659,1.0,0.4141048824593128,0.5858951175406871,882,0.42977697408077153,0.038577456298975285,0.5316455696202531
1695,1670336,4986,3387,2366,236,1599,4986,1.0,0.6793020457280385,0.3206979542719615,2384,0.47452868030485357,0.047332531087043724,0.47813878860810266
1696,1670338,4557,1275,1247,688,3282,4557,1.0,0.27978933508887427,0.7202106649111257,2622,0.2736449418477068,0.1509765196401141,0.575378538512179
1697,1670340,672,345,312,31,327,672,1.0,0.5133928571428571,0.48660714285714285,329,0.4642857142857143,0.046130952380952384,0.4895833333333333
1698,1670341,2571,392,301,341,2179,2571,1.0,0.15246985608712563,0.8475301439128744,1929,0.11707506806690005,0.13263321664721897,0.750291715285881
1699,1670343,3306,565,681,426,2741,3306,1.0,0.17090139140955837,0.8290986085904416,2199,0.20598911070780399,0.12885662431941924,0.6651542649727767
1700,1670345,1445,712,476,50,733,1445,1.0,0.49273356401384083,0.5072664359861592,919,0.32941176470588235,0.03460207612456748,0.6359861591695501
1701,1670347,2816,1016,571,176,1800,2816,1.0,0.36079545454545453,0.6392045454545454,2069,0.20276988636363635,0.0625,0.7347301136363636
1702,1670389,791,156,242,114,635,791,1.0,0.1972187104930468,0.8027812895069533,435,0.3059418457648546,0.14412136536030343,0.549936788874842
1703,1670391,260,33,42,41,227,260,1.0,0.12692307692307692,0.8730769230769231,177,0.16153846153846155,0.1576923076923077,0.6807692307692308
1704,1670394,51,8,12,6,43,51,1.0,0.1568627450980392,0.8431372549019608,33,0.23529411764705882,0.11764705882352941,0.6470588235294118
1705,1670398,582,97,113,107,485,582,1.0,0.16666666666666666,0.8333333333333334,362,0.19415807560137457,0.18384879725085912,0.6219931271477663
1706,1670399,577,31,69,45,546,577,1.0,0.053726169844020795,0.9462738301559792,463,0.1195840554592721,0.0779896013864818,0.8024263431542461
1707,1670401,17,0,0,0,17,17,1.0,0.0,1.0,17,0.0,0.0,1.0
1708,1670439,4210,560,678,1587,3650,4210,1.0,0.1330166270783848,0.8669833729216152,1945,0.16104513064133016,0.37695961995249405,0.46199524940617576
1709,1670453,4746,146,574,1450,4600,4746,1.0,0.03076274757690687,0.9692372524230931,2722,0.12094395280235988,0.3055204382638011,0.573535608933839
1710,1670454,5535,782,776,1605,4753,5535,1.0,0.14128274616079495,0.858717253839205,3154,0.14019873532068655,0.2899728997289973,0.5698283649503162
1711,1670455,2816,57,390,885,2759,2816,1.0,0.020241477272727272,0.9797585227272727,1541,0.13849431818181818,0.3142755681818182,0.5472301136363636
1712,1670456,3359,55,382,2019,3304,3359,1.0,0.01637392080976481,0.9836260791902351,958,0.11372432271509378,0.6010717475439119,0.28520392974099434
1713,1670457,3935,25,469,2355,3910,3935,1.0,0.0063532401524777635,0.9936467598475223,1111,0.11918678526048285,0.5984752223634053,0.2823379923761118
1714,1670460,4803,89,601,2955,4714,4803,1.0,0.018530085363314595,0.9814699146366854,1247,0.12513012700395587,0.6152404747033104,0.2596293982927337
1715,1670461,3658,84,408,1921,3574,3658,1.0,0.022963367960634227,0.9770366320393657,1329,0.11153635866593767,0.5251503553854565,0.3633132859486058
1716,1670462,3647,0,360,1844,3647,3647,1.0,0.0,1.0,1443,0.09871126953660543,0.5056210584041678,0.39566767205922676
1717,1670464,3165,174,429,1487,2991,3165,1.0,0.054976303317535544,0.9450236966824644,1249,0.13554502369668248,0.469826224328594,0.3946287519747235
1718,1670471,2333,195,334,802,2138,2333,1.0,0.08358336905272182,0.9164166309472782,1197,0.14316330904414917,0.3437633947706815,0.5130732961851693
1719,1670482,278,14,7,48,264,278,1.0,0.050359712230215826,0.9496402877697842,223,0.025179856115107913,0.17266187050359713,0.802158273381295
1720,1670487,5707,274,752,1956,5433,5707,1.0,0.04801121429823024,0.9519887857017697,2999,0.13176800420536183,0.3427369896618188,0.5254950061328193
1721,1670488,3692,335,663,1818,3357,3692,1.0,0.09073672806067172,0.9092632719393283,1211,0.1795774647887324,0.4924160346695558,0.3280065005417118
1722,1670490,4814,385,577,1815,4429,4814,1.0,0.07997507270461154,0.9200249272953884,2422,0.11985874532613211,0.3770253427503116,0.5031159119235563
1723,1671051,727,14,118,173,713,727,1.0,0.01925722145804677,0.9807427785419532,436,0.1623108665749656,0.23796423658872076,0.5997248968363136
1727,1672323,398,76,77,125,322,398,1.0,0.19095477386934673,0.8090452261306532,196,0.1934673366834171,0.314070351758794,0.49246231155778897
1731,1673311,400,111,137,61,289,400,1.0,0.2775,0.7225,202,0.3425,0.1525,0.505
1732,1674391,39,7,3,3,32,39,1.0,0.1794871794871795,0.8205128205128205,33,0.07692307692307693,0.07692307692307693,0.8461538461538461
1733,1690001,755,37,39,315,718,755,1.0,0.04900662251655629,0.9509933774834437,401,0.051655629139072845,0.41721854304635764,0.5311258278145695
1734,1690002,936,43,50,401,893,936,1.0,0.045940170940170943,0.9540598290598291,485,0.053418803418803416,0.4284188034188034,0.5181623931623932
1735,1690003,800,104,106,259,696,800,1.0,0.13,0.87,435,0.1325,0.32375,0.54375
1736,1690004,536,32,63,162,504,536,1.0,0.05970149253731343,0.9402985074626866,311,0.11753731343283583,0.30223880597014924,0.5802238805970149
1737,1690005,111,0,13,68,111,111,1.0,0.0,1.0,30,0.11711711711711711,0.6126126126126126,0.2702702702702703
1738,1690006,77,0,8,58,77,77,1.0,0.0,1.0,11,0.1038961038961039,0.7532467532467533,0.14285714285714285
1739,1710001,2176,0,297,1207,2176,2176,1.0,0.0,1.0,672,0.13648897058823528,0.5546875,0.3088235294117647
1740,1710002,1225,3,165,583,1222,1225,1.0,0.0024489795918367346,0.9975510204081632,477,0.1346938775510204,0.47591836734693876,0.3893877551020408
1741,1710003,1556,0,135,637,1556,1556,1.0,0.0,1.0,784,0.08676092544987146,0.40938303341902316,0.5038560411311054
1742,1710004,3033,4,448,1574,3029,3033,1.0,0.0013188262446422684,0.9986811737553577,1011,0.14770853939993406,0.5189581272667326,0.3333333333333333
1743,1710005,1606,0,132,850,1606,1606,1.0,0.0,1.0,624,0.0821917808219178,0.5292652552926526,0.38854296388542964
1744,1710006,564,6,63,321,558,564,1.0,0.010638297872340425,0.9893617021276596,180,0.11170212765957446,0.5691489361702128,0.3191489361702128
1745,1710007,2609,8,216,1485,2601,2609,1.0,0.0030663089306247606,0.9969336910693752,908,0.08279034112686853,0.5691835952472212,0.3480260636259103
1746,1710008,396,0,30,168,396,396,1.0,0.0,1.0,198,0.07575757575757576,0.42424242424242425,0.5
1747,1710009,193,0,7,119,193,193,1.0,0.0,1.0,67,0.03626943005181347,0.616580310880829,0.3471502590673575
1748,1710010,1050,0,89,532,1050,1050,1.0,0.0,1.0,429,0.08476190476190476,0.5066666666666667,0.4085714285714286
1749,1710012,2537,0,216,1284,2537,2537,1.0,0.0,1.0,1037,0.08513992905005913,0.5061095782420181,0.40875049270792274
1750,1710013,1576,0,135,1099,1576,1576,1.0,0.0,1.0,342,0.08565989847715735,0.6973350253807107,0.217005076142132
1751,1710015,921,0,122,447,921,921,1.0,0.0,1.0,352,0.13246471226927253,0.48534201954397393,0.38219326818675353
1752,1730001,215,0,5,166,215,215,1.0,0.0,1.0,44,0.023255813953488372,0.772093023255814,0.20465116279069767
1753,1730002,209,0,19,110,209,209,1.0,0.0,1.0,80,0.09090909090909091,0.5263157894736842,0.3827751196172249
1754,1730003,207,0,8,107,207,207,1.0,0.0,1.0,92,0.03864734299516908,0.5169082125603864,0.4444444444444444
1755,1730004,222,0,12,143,222,222,1.0,0.0,1.0,67,0.05405405405405406,0.6441441441441441,0.30180180180180183
1756,1750011,1042,82,326,235,960,1042,1.0,0.07869481765834933,0.9213051823416507,481,0.31285988483685223,0.2255278310940499,0.4616122840690979
1757,1750012,386,36,45,205,350,386,1.0,0.09326424870466321,0.9067357512953368,136,0.11658031088082901,0.5310880829015544,0.35233160621761656
1758,1750021,981,60,332,323,921,981,1.0,0.06116207951070336,0.9388379204892966,326,0.3384301732925586,0.3292558613659531,0.33231396534148827
1759,1750022,300,0,96,76,300,300,1.0,0.0,1.0,128,0.32,0.25333333333333335,0.4266666666666667
1760,1750031,852,28,133,372,824,852,1.0,0.03286384976525822,0.9671361502347418,347,0.15610328638497653,0.43661971830985913,0.4072769953051643
1761,1750032,638,13,63,349,625,638,1.0,0.02037617554858934,0.9796238244514106,226,0.0987460815047022,0.5470219435736677,0.3542319749216301
1762,1750041,367,17,38,200,350,367,1.0,0.04632152588555858,0.9536784741144414,129,0.10354223433242507,0.5449591280653951,0.35149863760217986
1763,1750042,744,11,48,322,733,744,1.0,0.01478494623655914,0.9852150537634409,374,0.06451612903225806,0.4327956989247312,0.5026881720430108
1764,1750043,461,19,46,212,442,461,1.0,0.04121475054229935,0.9587852494577006,203,0.09978308026030369,0.4598698481561822,0.4403470715835141
1765,1770001,2880,234,377,1031,2646,2880,1.0,0.08125,0.91875,1472,0.13090277777777778,0.3579861111111111,0.5111111111111111
1766,1770002,1840,369,333,534,1471,1840,1.0,0.20054347826086957,0.7994565217391304,973,0.18097826086956523,0.2902173913043478,0.528804347826087
1767,1770003,2040,107,231,526,1933,2040,1.0,0.052450980392156864,0.9475490196078431,1283,0.11323529411764706,0.257843137254902,0.628921568627451
1768,1770005,692,15,92,256,677,692,1.0,0.02167630057803468,0.9783236994219653,344,0.1329479768786127,0.3699421965317919,0.49710982658959535
1769,1770007,382,15,27,200,367,382,1.0,0.03926701570680628,0.9607329842931938,155,0.07068062827225131,0.5235602094240838,0.40575916230366493
1770,1770008,311,16,32,159,295,311,1.0,0.05144694533762058,0.9485530546623794,120,0.10289389067524116,0.5112540192926045,0.3858520900321543
1771,1770009,1074,100,275,300,974,1074,1.0,0.0931098696461825,0.9068901303538175,499,0.25605214152700184,0.27932960893854747,0.46461824953445063
1772,1770010,748,3,76,238,745,748,1.0,0.004010695187165776,0.9959893048128342,434,0.10160427807486631,0.3181818181818182,0.5802139037433155
1773,1770011,226,20,23,122,206,226,1.0,0.08849557522123894,0.911504424778761,81,0.10176991150442478,0.5398230088495575,0.3584070796460177
1774,1770012,206,8,19,109,198,206,1.0,0.038834951456310676,0.9611650485436893,78,0.09223300970873786,0.529126213592233,0.3786407766990291
1775,1770013,288,10,36,148,278,288,1.0,0.034722222222222224,0.9652777777777778,104,0.125,0.5138888888888888,0.3611111111111111
1776,1770014,87,3,5,58,84,87,1.0,0.034482758620689655,0.9655172413793104,24,0.05747126436781609,0.6666666666666666,0.27586206896551724
1777,1770015,385,13,23,173,372,385,1.0,0.033766233766233764,0.9662337662337662,189,0.05974025974025974,0.44935064935064933,0.4909090909090909
1778,17704/6,1926,83,227,362,1843,1926,1.0,0.043094496365524405,0.9569055036344756,1337,0.11786085150571132,0.18795430944963656,0.6941848390446521
1779,1790001,549,32,25,253,517,549,1.0,0.058287795992714025,0.941712204007286,271,0.04553734061930783,0.46083788706739526,0.4936247723132969
1780,1790002,4120,508,143,1239,3612,4120,1.0,0.12330097087378641,0.8766990291262136,2738,0.03470873786407767,0.30072815533980585,0.6645631067961165
1781,1790003,138,10,4,73,128,138,1.0,0.07246376811594203,0.927536231884058,61,0.028985507246376812,0.5289855072463768,0.4420289855072464
1782,1790004,817,18,44,410,799,817,1.0,0.022031823745410038,0.97796817625459,363,0.05385556915544676,0.5018359853121175,0.44430844553243576
1783,1790005,3058,45,221,1841,3013,3058,1.0,0.014715500327011119,0.9852844996729889,996,0.0722694571615435,0.6020274689339438,0.32570307390451275
1784,1790006,3252,71,205,1671,3181,3252,1.0,0.02183271832718327,0.9781672816728167,1376,0.06303813038130382,0.5138376383763837,0.4231242312423124
1785,1790007,3491,226,244,956,3265,3491,1.0,0.06473789745058722,0.9352621025494128,2291,0.06989401317674018,0.27384703523345744,0.6562589515898023
1786,1810101,5259,672,775,1019,4587,5259,1.0,0.127780946948089,0.872219053051911,3465,0.1473664194713824,0.19376307282753374,0.6588705077010839
1787,1810102,3454,820,761,396,2634,3454,1.0,0.2374059061957151,0.7625940938042849,2297,0.2203242617255356,0.11464968152866242,0.665026056745802
1788,1810103,557,16,64,268,541,557,1.0,0.02872531418312388,0.9712746858168761,225,0.11490125673249552,0.48114901256732495,0.40394973070017953
1789,1810104,817,4,88,468,813,817,1.0,0.004895960832313341,0.9951040391676866,261,0.10771113831089352,0.572827417380661,0.31946144430844553
1790,1810105,5984,237,457,2067,5747,5984,1.0,0.03960561497326203,0.960394385026738,3460,0.07637032085561497,0.3454211229946524,0.5782085561497327
1791,1810106,3070,0,229,1079,3070,3070,1.0,0.0,1.0,1762,0.0745928338762215,0.35146579804560263,0.5739413680781759
1792,1810107,2086,28,173,882,2058,2086,1.0,0.013422818791946308,0.9865771812080537,1031,0.08293384467881112,0.4228187919463087,0.4942473633748802
1793,1810201,3997,323,534,1246,3674,3997,1.0,0.08081060795596698,0.919189392044033,2217,0.1336002001501126,0.3117338003502627,0.5546659994996247
1794,1810202,4236,176,483,1206,4060,4236,1.0,0.04154863078375826,0.9584513692162417,2547,0.11402266288951841,0.2847025495750708,0.6012747875354107
1795,1810203,1623,189,254,230,1434,1623,1.0,0.11645101663585952,0.8835489833641405,1139,0.15650030807147258,0.14171287738755392,0.7017868145409735
1796,1810204,911,2,100,500,909,911,1.0,0.0021953896816684962,0.9978046103183315,311,0.10976948408342481,0.5488474204171241,0.3413830954994512
1797,1810205A,4345,57,430,1705,4288,4345,1.0,0.013118527042577675,0.9868814729574223,2210,0.09896432681242807,0.3924050632911392,0.5086306098964327
1799,1810206,1510,55,194,663,1455,1510,1.0,0.03642384105960265,0.9635761589403974,653,0.12847682119205298,0.4390728476821192,0.4324503311258278
1800,1810207,1154,30,86,430,1124,1154,1.0,0.025996533795493933,0.9740034662045061,638,0.07452339688041594,0.37261698440207974,0.5528596187175043
1801,1810208,1620,120,197,570,1500,1620,1.0,0.07407407407407407,0.9259259259259259,853,0.12160493827160494,0.35185185185185186,0.5265432098765432
1802,1810209,1168,37,149,515,1131,1168,1.0,0.031678082191780824,0.9683219178082192,504,0.12756849315068494,0.4409246575342466,0.4315068493150685
1803,1810210,2074,51,200,852,2023,2074,1.0,0.02459016393442623,0.9754098360655737,1022,0.09643201542912247,0.4108003857280617,0.4927675988428158
1804,1810301,2492,434,271,501,2058,2492,1.0,0.17415730337078653,0.8258426966292135,1720,0.10874799357945425,0.20104333868378813,0.6902086677367576
1805,1810302,6682,331,806,1846,6351,6682,1.0,0.04953606704579467,0.9504639329542053,4030,0.12062256809338522,0.27626459143968873,0.603112840466926
1806,1810303,1017,19,110,483,998,1017,1.0,0.018682399213372666,0.9813176007866273,424,0.10816125860373647,0.4749262536873156,0.4169124877089479
1807,1810304,3705,549,494,1181,3156,3705,1.0,0.14817813765182186,0.8518218623481781,2030,0.13333333333333333,0.31875843454790825,0.5479082321187584
1808,1810305,1627,22,125,600,1605,1627,1.0,0.013521819299323909,0.986478180700676,902,0.07682851874615858,0.36877688998156116,0.5543945912722803
1809,1810306,4788,33,378,1742,4755,4788,1.0,0.006892230576441102,0.9931077694235589,2668,0.07894736842105263,0.3638262322472849,0.5572263993316625
1810,1810307,2132,5,174,866,2127,2132,1.0,0.0023452157598499064,0.9976547842401501,1092,0.08161350844277673,0.40619136960600377,0.5121951219512195
1811,1810308,1096,0,103,475,1096,1096,1.0,0.0,1.0,518,0.09397810218978102,0.4333941605839416,0.4726277372262774
1812,1810309,759,7,76,393,752,759,1.0,0.00922266139657444,0.9907773386034255,290,0.10013175230566534,0.5177865612648221,0.3820816864295125
1813,1810401,2516,430,426,391,2086,2516,1.0,0.17090620031796502,0.829093799682035,1699,0.16931637519872814,0.1554054054054054,0.6752782193958664
1814,1810402,2873,122,430,1019,2751,2873,1.0,0.042464323007309436,0.9575356769926906,1424,0.1496693351896972,0.3546815175774452,0.49564914723285763
1815,1810403,3095,0,380,1240,3095,3095,1.0,0.0,1.0,1475,0.12277867528271405,0.40064620355411956,0.4765751211631664
1816,1810404,3676,11,379,1583,3665,3676,1.0,0.0029923830250272033,0.9970076169749728,1714,0.10310119695321002,0.4306311207834603,0.4662676822633297
1817,1810405,966,40,93,187,926,966,1.0,0.041407867494824016,0.9585921325051759,686,0.09627329192546584,0.19358178053830227,0.7101449275362319
1818,1810406,3061,7,275,1129,3054,3061,1.0,0.0022868343678536427,0.9977131656321464,1657,0.08983992159425025,0.36883371447239466,0.5413263639333551
1819,1810407,607,67,45,53,540,607,1.0,0.11037891268533773,0.8896210873146623,509,0.07413509060955518,0.08731466227347612,0.8385502471169687
1820,1810408A,1454,52,141,476,1402,1454,1.0,0.03576341127922971,0.9642365887207703,837,0.0969738651994498,0.32737276478679506,0.5756533700137552
1821,1810408B,112,3,9,36,109,112,1.0,0.026785714285714284,0.9732142857142857,67,0.08035714285714286,0.32142857142857145,0.5982142857142857
1822,1810409,4130,222,659,1881,3908,4130,1.0,0.05375302663438257,0.9462469733656175,1590,0.1595641646489104,0.45544794188861987,0.38498789346246975
1823,1830001,2325,615,237,813,1710,2325,1.0,0.2645161290322581,0.7354838709677419,1275,0.10193548387096774,0.3496774193548387,0.5483870967741935
1824,1830002,4549,888,526,1835,3661,4549,1.0,0.19520773796438778,0.8047922620356123,2188,0.11562980874917564,0.40338535941965264,0.4809848318311717
1825,1830003,5084,904,510,1563,4180,5084,1.0,0.1778127458693942,0.8221872541306058,3011,0.1003147128245476,0.30743509047993706,0.5922501966955154
1826,1830004,2657,301,388,1566,2356,2657,1.0,0.11328566051938277,0.8867143394806173,703,0.14602935641701167,0.5893865261573202,0.26458411742566806
1827,1830005,4379,693,390,1723,3686,4379,1.0,0.15825530943137703,0.841744690568623,2266,0.0890614295501256,0.3934688284996575,0.517469741950217
1828,1830006,2563,317,180,1286,2246,2563,1.0,0.12368318376902068,0.8763168162309793,1097,0.07023019898556379,0.5017557549746391,0.4280140460397971
1829,1830007,3503,443,278,1576,3060,3503,1.0,0.12646303168712533,0.8735369683128746,1649,0.07936054810162718,0.44990008564087924,0.4707393662574936
1830,1830008,4920,574,500,2029,4346,4920,1.0,0.11666666666666667,0.8833333333333333,2391,0.1016260162601626,0.41239837398373985,0.48597560975609755
1831,1830009,4403,724,614,2060,3679,4403,1.0,0.16443334090392914,0.8355666590960709,1729,0.1394503747444924,0.46786282080399727,0.39268680445151033
1832,1830010,6530,1290,706,1602,5240,6530,1.0,0.19754977029096477,0.8024502297090352,4222,0.10811638591117917,0.2453292496171516,0.6465543644716693
1833,1830011,5020,402,523,2120,4618,5020,1.0,0.0800796812749004,0.9199203187250996,2377,0.10418326693227091,0.42231075697211157,0.4735059760956175
1834,1830012,4730,217,288,2392,4513,4730,1.0,0.04587737843551797,0.954122621564482,2050,0.06088794926004228,0.505708245243129,0.4334038054968288
1835,1830013,3981,735,413,1260,3246,3981,1.0,0.18462697814619441,0.8153730218538056,2308,0.10374277819643306,0.3165033911077619,0.5797538306958051
1836,1830014,4335,306,485,2218,4029,4335,1.0,0.07058823529411765,0.9294117647058824,1632,0.1118800461361015,0.5116493656286044,0.3764705882352941
1837,1830015,1774,251,253,450,1523,1774,1.0,0.1414881623449831,0.8585118376550169,1071,0.14261555806087936,0.25366403607666294,0.6037204058624577
1838,1830016,5904,753,349,2073,5151,5904,1.0,0.12754065040650406,0.8724593495934959,3482,0.05911246612466125,0.3511178861788618,0.589769647696477
1839,1830017,1346,642,294,149,704,1346,1.0,0.4769687964338782,0.5230312035661219,903,0.21842496285289748,0.11069836552748885,0.6708766716196136
1840,1830018,3095,1205,1183,1005,1890,3095,1.0,0.3893376413570275,0.6106623586429726,907,0.3822294022617124,0.3247172859450727,0.29305331179321487
1841,1830019,5064,2978,1841,262,2086,5064,1.0,0.5880726698262243,0.4119273301737757,2961,0.36354660347551343,0.05173775671406003,0.5847156398104265
1842,1830020,4027,2098,1268,348,1929,4027,1.0,0.520983362304445,0.479016637695555,2411,0.31487459647380184,0.08641668736031785,0.5987087161658803
1843,1830021,4212,1709,1172,412,2503,4212,1.0,0.4057454890788224,0.5942545109211775,2628,0.27825261158594494,0.09781576448243115,0.6239316239316239
1844,1850001,1818,215,218,829,1603,1818,1.0,0.11826182618261827,0.8817381738173817,771,0.11991199119911991,0.455995599559956,0.4240924092409241
1845,1850002,612,4,69,405,608,612,1.0,0.006535947712418301,0.9934640522875817,138,0.11274509803921569,0.6617647058823529,0.22549019607843138
1846,1850003,2216,833,600,141,1383,2216,1.0,0.3759025270758123,0.6240974729241877,1475,0.27075812274368233,0.06362815884476535,0.6656137184115524
1847,1850004,1405,236,130,596,1169,1405,1.0,0.16797153024911032,0.8320284697508897,679,0.09252669039145907,0.42419928825622777,0.4832740213523132
1848,1850005,4456,1268,232,581,3188,4456,1.0,0.2845601436265709,0.7154398563734291,3643,0.05206463195691203,0.13038599640933574,0.8175493716337523
1849,1850006,2582,239,403,733,2343,2582,1.0,0.09256390395042603,0.907436096049574,1446,0.15608055770720372,0.2838884585592564,0.5600309837335399
1850,1850007,1401,88,133,507,1313,1401,1.0,0.06281227694503926,0.9371877230549608,761,0.09493219129193434,0.3618843683083512,0.5431834403997144
1851,1850008,513,73,68,212,440,513,1.0,0.14230019493177387,0.8576998050682261,233,0.13255360623781676,0.41325536062378165,0.45419103313840153
1852,1850009,324,46,58,193,278,324,1.0,0.1419753086419753,0.8580246913580247,73,0.17901234567901234,0.595679012345679,0.22530864197530864
1853,1850010,1319,26,68,548,1293,1319,1.0,0.019711902956785442,0.9802880970432145,703,0.05155420773313116,0.41546626231993933,0.5329795299469295
1854,1850011,225,32,14,124,193,225,1.0,0.14222222222222222,0.8577777777777778,87,0.06222222222222222,0.5511111111111111,0.38666666666666666
1855,1850012,817,175,140,407,642,817,1.0,0.2141982864137087,0.7858017135862914,270,0.17135862913096694,0.4981640146878825,0.33047735618115054
1856,1850014,1492,53,150,606,1439,1492,1.0,0.035522788203753354,0.9644772117962467,736,0.10053619302949061,0.4061662198391421,0.4932975871313673
1857,1850015,679,12,56,260,667,679,1.0,0.017673048600883652,0.9823269513991163,363,0.08247422680412371,0.38291605301914583,0.5346097201767305
1858,1870101,922,31,119,332,891,922,1.0,0.033622559652928416,0.9663774403470716,471,0.12906724511930587,0.3600867678958785,0.5108459869848156
1859,1870102A,1040,12,197,456,1028,1040,1.0,0.011538461538461539,0.9884615384615385,387,0.18942307692307692,0.43846153846153846,0.3721153846153846
1860,1870102B,16,0,3,8,16,16,1.0,0.0,1.0,5,0.1875,0.5,0.3125
1861,1870103,1035,105,127,325,930,1035,1.0,0.10144927536231885,0.8985507246376812,583,0.12270531400966184,0.3140096618357488,0.5632850241545894
1862,1870104,1628,62,214,311,1566,1628,1.0,0.038083538083538086,0.961916461916462,1103,0.13144963144963145,0.19103194103194104,0.6775184275184275
1863,1870105,3354,29,351,1130,3325,3354,1.0,0.0086463923673226,0.9913536076326774,1873,0.10465116279069768,0.33691115086463924,0.5584376863446631
1864,1870106,2692,127,417,1232,2565,2692,1.0,0.04717682020802377,0.9528231797919762,1043,0.1549034175334324,0.4576523031203566,0.387444279346211
1865,1870107,1128,0,120,518,1128,1128,1.0,0.0,1.0,490,0.10638297872340426,0.4592198581560284,0.43439716312056736
1866,1870108,805,10,143,265,795,805,1.0,0.012422360248447204,0.9875776397515528,397,0.17763975155279504,0.32919254658385094,0.493167701863354
1867,1870109,607,0,51,246,607,607,1.0,0.0,1.0,310,0.08401976935749589,0.4052718286655684,0.5107084019769358
1868,1870110,226,14,46,81,212,226,1.0,0.061946902654867256,0.9380530973451328,99,0.20353982300884957,0.3584070796460177,0.43805309734513276
1869,1870111,237,5,51,31,232,237,1.0,0.02109704641350211,0.9789029535864979,155,0.21518987341772153,0.1308016877637131,0.6540084388185654
1870,1870112,735,51,18,16,684,735,1.0,0.06938775510204082,0.9306122448979591,701,0.024489795918367346,0.021768707482993196,0.9537414965986395
1871,1870113,1371,41,139,442,1330,1371,1.0,0.029905178701677606,0.9700948212983224,790,0.10138584974471189,0.3223924142961342,0.5762217359591539
1872,1870114,1312,13,121,269,1299,1312,1.0,0.009908536585365854,0.9900914634146342,922,0.09222560975609756,0.20503048780487804,0.7027439024390244
1873,1870115,189,2,29,138,187,189,1.0,0.010582010582010581,0.9894179894179894,22,0.15343915343915343,0.7301587301587301,0.1164021164021164
1874,1870116,2788,53,303,994,2735,2788,1.0,0.019010043041606885,0.9809899569583931,1491,0.10868005738880918,0.3565279770444763,0.5347919655667145
1875,1870117,3248,4,350,1360,3244,3248,1.0,0.0012315270935960591,0.9987684729064039,1538,0.10775862068965517,0.4187192118226601,0.4735221674876847
1876,1870118,96,3,12,30,93,96,1.0,0.03125,0.96875,54,0.125,0.3125,0.5625
1877,1870119,1834,42,233,873,1792,1834,1.0,0.022900763358778626,0.9770992366412213,728,0.12704471101417666,0.47600872410032713,0.3969465648854962
1878,1870120,1393,129,138,531,1264,1393,1.0,0.09260588657573582,0.9073941134242641,724,0.0990667623833453,0.3811916726489591,0.5197415649676956
1879,1870121,179,6,15,64,173,179,1.0,0.0335195530726257,0.9664804469273743,100,0.08379888268156424,0.3575418994413408,0.5586592178770949
1880,1870122,37,1,7,17,36,37,1.0,0.02702702702702703,0.972972972972973,13,0.1891891891891892,0.4594594594594595,0.35135135135135137
1882,1870124,5,0,1,4,5,5,1.6666666666666667,0.0,1.0,0,0.2,0.8,0.0
1883,1870125,207,5,22,120,202,207,1.0,0.024154589371980676,0.9758454106280193,65,0.10628019323671498,0.5797101449275363,0.3140096618357488
1884,1870126,23,0,8,15,23,23,1.2105263157894737,0.0,1.0,0,0.34782608695652173,0.6521739130434783,0.0
1885,1870127,7,0,4,3,7,7,1.0,0.0,1.0,0,0.5714285714285714,0.42857142857142855,0.0
1886,1870201,986,39,132,122,947,986,1.0,0.03955375253549696,0.960446247464503,732,0.13387423935091278,0.12373225152129817,0.742393509127789
1887,1870202,1488,214,420,153,1274,1488,1.0,0.14381720430107528,0.8561827956989247,915,0.28225806451612906,0.1028225806451613,0.6149193548387096
1888,1870203,1835,284,138,57,1551,1835,1.0,0.15476839237057222,0.8452316076294278,1640,0.07520435967302452,0.03106267029972752,0.8937329700272479
1889,1870204,2364,221,431,240,2143,2364,1.0,0.09348561759729272,0.9065143824027073,1693,0.1823181049069374,0.10152284263959391,0.7161590524534687
1890,1870205,1234,30,153,454,1204,1234,1.0,0.024311183144246355,0.9756888168557536,627,0.1239870340356564,0.3679092382495948,0.5081037277147488
1891,1870206,3897,82,492,370,3815,3897,1.0,0.021041827046445985,0.978958172953554,3035,0.1262509622786759,0.0949448293559148,0.7788042083654093
1892,1870207,1669,141,303,166,1528,1669,1.0,0.08448172558418214,0.9155182744158179,1200,0.18154583582983821,0.09946075494307968,0.7189934092270821
1893,1870208,3753,72,350,1382,3681,3753,1.0,0.019184652278177457,0.9808153477218226,2021,0.09325872635225153,0.36823874233946174,0.5385025313082867
1894,1870209,1703,157,302,69,1546,1703,1.0,0.09219025249559601,0.907809747504404,1332,0.17733411626541398,0.040516735173223725,0.7821491485613623
1895,1870210,958,3,206,278,955,958,1.0,0.003131524008350731,0.9968684759916493,474,0.2150313152400835,0.29018789144050106,0.49478079331941544
1896,1870211,112,5,16,58,107,112,1.0,0.044642857142857144,0.9553571428571429,38,0.14285714285714285,0.5178571428571429,0.3392857142857143
1897,1870212,244,5,44,22,239,244,1.0,0.020491803278688523,0.9795081967213115,178,0.18032786885245902,0.09016393442622951,0.7295081967213115
1898,1870213,2114,25,134,474,2089,2114,1.0,0.011825922421948912,0.9881740775780511,1506,0.06338694418164617,0.22421948912015138,0.7123935666982024
1899,1870214,581,10,89,224,571,581,1.0,0.01721170395869191,0.9827882960413081,268,0.153184165232358,0.3855421686746988,0.4612736660929432
1900,1870215,197,7,37,108,190,197,1.0,0.03553299492385787,0.9644670050761421,52,0.18781725888324874,0.5482233502538071,0.2639593908629442
1901,1870216,42,0,12,30,42,42,1.1666666666666667,0.0,1.0,0,0.2857142857142857,0.7142857142857143,0.0
1902,1870217,293,10,31,33,283,293,1.0,0.034129692832764506,0.9658703071672355,229,0.10580204778156997,0.11262798634812286,0.7815699658703071
1903,1870218,172,3,24,19,169,172,1.0,0.01744186046511628,0.9825581395348837,129,0.13953488372093023,0.11046511627906977,0.75
1904,1870219,151,3,21,25,148,151,1.0,0.019867549668874173,0.9801324503311258,105,0.1390728476821192,0.16556291390728478,0.695364238410596
1905,1870220,173,3,25,15,170,173,1.0,0.017341040462427744,0.9826589595375722,133,0.14450867052023122,0.08670520231213873,0.7687861271676301
1906,1870221,50,2,5,9,48,50,1.0,0.04,0.96,36,0.1,0.18,0.72
1907,1870222,15,0,0,0,15,15,1.0,0.0,1.0,15,0.0,0.0,1.0
1908,1870223,308,1,58,79,307,308,1.0,0.003246753246753247,0.9967532467532467,171,0.18831168831168832,0.2564935064935065,0.5551948051948052
1909,1870224,225,26,47,16,199,225,1.0,0.11555555555555555,0.8844444444444445,162,0.2088888888888889,0.07111111111111111,0.72
1910,1870225,40,0,9,3,40,40,1.0,0.0,1.0,28,0.225,0.075,0.7
1911,1870226,322,3,55,98,319,322,1.0,0.009316770186335404,0.9906832298136646,169,0.17080745341614906,0.30434782608695654,0.5248447204968945
1912,1870301,2837,206,320,769,2631,2837,1.0,0.07261191399365527,0.9273880860063447,1748,0.11279520620373634,0.27106097990835387,0.6161438138879097
1913,1870302,5693,998,728,1198,4695,5693,1.0,0.17530300368874055,0.8246969963112595,3767,0.1278763393641314,0.21043386615141402,0.6616897944844546
1914,1870303,1623,290,336,576,1333,1623,1.0,0.1786814540973506,0.8213185459026494,711,0.20702402957486138,0.35489833641404805,0.43807763401109057
1915,1870304,3976,367,779,1769,3609,3976,1.0,0.09230382293762575,0.9076961770623743,1428,0.1959255533199195,0.4449195171026157,0.3591549295774648
1916,1870305,3847,650,670,1210,3197,3847,1.0,0.1689628281778009,0.8310371718221992,1967,0.17416168442942553,0.31453080322329086,0.5113075123472836
1917,1870306,3980,499,864,1683,3481,3980,1.0,0.12537688442211056,0.8746231155778894,1433,0.21708542713567838,0.4228643216080402,0.36005025125628143
1918,1870307,4761,795,965,1676,3966,4761,1.0,0.16698172652804033,0.8330182734719597,2120,0.20268851081705525,0.35202688510817054,0.4452846040747742
1919,1870308,2221,140,443,1007,2081,2221,1.0,0.0630346690679874,0.9369653309320126,771,0.19945970283656012,0.45339936965330935,0.3471409275101306
1920,1870401,1765,68,187,536,1697,1765,1.0,0.038526912181303115,0.9614730878186969,1042,0.10594900849858357,0.3036827195467422,0.5903682719546742
1921,1870402,2641,84,365,582,2557,2641,1.0,0.03180613404013631,0.9681938659598637,1694,0.13820522529344945,0.2203710715638016,0.641423703142749
1922,1870403,4301,581,538,918,3720,4301,1.0,0.13508486398511974,0.8649151360148802,2845,0.12508718902580795,0.2134387351778656,0.6614740757963264
1923,1870404,4009,598,541,1101,3411,4009,1.0,0.14916438014467448,0.8508356198553255,2367,0.13494637066600149,0.27463207782489396,0.5904215515091045
1924,1870405,2400,29,214,894,2371,2400,1.0,0.012083333333333333,0.9879166666666667,1292,0.08916666666666667,0.3725,0.5383333333333333
1925,1870406,1998,46,156,998,1952,1998,1.0,0.023023023023023025,0.9769769769769769,844,0.07807807807807808,0.4994994994994995,0.42242242242242245
1926,1870407,1683,137,201,732,1546,1683,1.0,0.0814022578728461,0.9185977421271538,750,0.11942959001782531,0.43493761140819964,0.44563279857397503
1927,1870408,3165,86,396,1102,3079,3165,1.0,0.027172195892575038,0.972827804107425,1667,0.12511848341232226,0.3481832543443918,0.526698262243286
1928,1870409,3713,664,676,826,3049,3713,1.0,0.17883113385402638,0.8211688661459736,2211,0.18206302181524373,0.22246162133046055,0.5954753568542958
1929,1870410,151,0,27,67,151,151,1.0,0.0,1.0,57,0.17880794701986755,0.44370860927152317,0.37748344370860926
1930,1870411,3316,477,563,1153,2839,3316,1.0,0.14384800965018094,0.856151990349819,1600,0.1697828709288299,0.347708082026538,0.4825090470446321
1931,1890101,501,18,48,160,483,501,1.0,0.03592814371257485,0.9640718562874252,293,0.09580838323353294,0.3193612774451098,0.5848303393213573
1932,1890102,289,19,10,54,270,289,1.0,0.0657439446366782,0.9342560553633218,225,0.03460207612456748,0.18685121107266436,0.7785467128027682
1933,1890103,702,4,118,118,698,702,1.0,0.005698005698005698,0.9943019943019943,466,0.16809116809116809,0.16809116809116809,0.6638176638176638
1934,1890104,1038,33,102,157,1005,1038,1.0,0.031791907514450865,0.9682080924855492,779,0.09826589595375723,0.151252408477842,0.7504816955684007
1935,1890105,401,30,29,80,371,401,1.0,0.07481296758104738,0.9251870324189526,292,0.07231920199501247,0.19950124688279303,0.7281795511221946
1936,1890110,350,11,27,233,339,350,1.0,0.03142857142857143,0.9685714285714285,90,0.07714285714285714,0.6657142857142857,0.2571428571428571
1937,1890111,1228,56,96,290,1172,1228,1.0,0.04560260586319218,0.9543973941368078,842,0.0781758957654723,0.23615635179153094,0.6856677524429967
1938,1890112,2070,348,41,337,1722,2070,1.0,0.1681159420289855,0.8318840579710145,1692,0.019806763285024155,0.16280193236714977,0.8173913043478261
1939,1890202,489,80,96,52,409,489,1.0,0.16359918200409,0.83640081799591,341,0.19631901840490798,0.10633946830265849,0.6973415132924335
1940,1890203,763,14,124,80,749,763,1.0,0.01834862385321101,0.981651376146789,559,0.16251638269986893,0.10484927916120576,0.7326343381389253
1941,1890204,927,60,115,183,867,927,1.0,0.06472491909385113,0.9352750809061489,629,0.12405609492988134,0.19741100323624594,0.6785329018338727
1942,1890205,268,31,34,23,237,268,1.0,0.11567164179104478,0.8843283582089553,211,0.12686567164179105,0.08582089552238806,0.7873134328358209
1943,1890206,223,1,21,15,222,223,1.0,0.004484304932735426,0.9955156950672646,187,0.09417040358744394,0.06726457399103139,0.8385650224215246
1944,1890213,412,11,41,68,401,412,1.0,0.02669902912621359,0.9733009708737864,303,0.09951456310679611,0.1650485436893204,0.7354368932038835
1945,1890214,832,13,151,290,819,832,1.0,0.015625,0.984375,391,0.1814903846153846,0.3485576923076923,0.4699519230769231
1946,1890215,529,0,49,117,529,529,1.0,0.0,1.0,363,0.09262759924385633,0.22117202268431002,0.6862003780718336
1947,1890304,1036,22,87,441,1014,1036,1.0,0.021235521235521235,0.9787644787644788,508,0.08397683397683398,0.42567567567567566,0.49034749034749037
1948,1890305,1121,103,97,625,1018,1121,1.0,0.09188224799286351,0.9081177520071365,399,0.08652988403211419,0.5575379125780553,0.3559322033898305
1949,1890306,149,0,26,32,149,149,1.0,0.0,1.0,91,0.174496644295302,0.21476510067114093,0.610738255033557
1950,1890307,894,106,60,157,788,894,1.0,0.1185682326621924,0.8814317673378076,677,0.06711409395973154,0.1756152125279642,0.7572706935123042
1951,1890308,50,0,8,27,50,50,1.0,0.0,1.0,15,0.16,0.54,0.3
1952,1890316,1346,20,176,440,1326,1346,1.0,0.014858841010401188,0.9851411589895989,730,0.13075780089153047,0.32689450222882616,0.5423476968796433
1953,1890317,142,0,17,72,142,142,1.0,0.0,1.0,53,0.11971830985915492,0.5070422535211268,0.3732394366197183
1954,1890318,1289,0,122,467,1289,1289,1.0,0.0,1.0,700,0.09464701318851823,0.36229635376260666,0.5430566330488751
1955,1890406,1435,76,187,197,1359,1435,1.0,0.0529616724738676,0.9470383275261324,1051,0.13031358885017422,0.1372822299651568,0.732404181184669
1956,1890407,1182,58,142,755,1124,1182,1.0,0.049069373942470386,0.9509306260575296,285,0.12013536379018612,0.6387478849407784,0.24111675126903553
1957,1890408,945,12,78,387,933,945,1.0,0.012698412698412698,0.9873015873015873,480,0.08253968253968254,0.4095238095238095,0.5079365079365079
1958,1890409,1079,41,116,296,1038,1079,1.0,0.037998146431881374,0.9620018535681186,667,0.10750695088044486,0.2743280815569972,0.6181649675625579
1959,1890419,329,0,6,127,329,329,1.0,0.0,1.0,196,0.0182370820668693,0.3860182370820669,0.5957446808510638
1960,1890420,432,0,19,210,432,432,1.0,0.0,1.0,203,0.04398148148148148,0.4861111111111111,0.4699074074074074
1961,1910101,530,43,70,165,487,530,1.0,0.08113207547169811,0.9188679245283019,295,0.1320754716981132,0.3113207547169811,0.5566037735849056
1962,1910201,108,11,26,35,97,108,1.0,0.10185185185185185,0.8981481481481481,47,0.24074074074074073,0.32407407407407407,0.4351851851851852
1963,1910202,455,29,49,149,426,455,1.0,0.06373626373626373,0.9362637362637363,257,0.1076923076923077,0.3274725274725275,0.5648351648351648
1964,1910301,113,11,18,52,102,113,1.0,0.09734513274336283,0.9026548672566371,43,0.1592920353982301,0.46017699115044247,0.3805309734513274
1965,1910302,416,49,29,157,367,416,1.0,0.11778846153846154,0.8822115384615384,230,0.06971153846153846,0.37740384615384615,0.5528846153846154
1966,1910401,296,30,51,204,266,296,1.0,0.10135135135135136,0.8986486486486487,41,0.17229729729729729,0.6891891891891891,0.13851351351351351
1967,1910402,210,18,22,70,192,210,1.0,0.08571428571428572,0.9142857142857143,118,0.10476190476190476,0.3333333333333333,0.5619047619047619
1968,1930001,917,2,87,458,915,917,1.0,0.0021810250817884407,0.9978189749182116,372,0.09487459105779716,0.4994547437295529,0.40567066521264994
1969,1930004,127,1,15,62,126,127,1.0,0.007874015748031496,0.9921259842519685,50,0.11811023622047244,0.4881889763779528,0.3937007874015748
1970,1930005,110,1,16,93,109,110,1.0,0.00909090909090909,0.990909090909091,1,0.14545454545454545,0.8454545454545455,0.00909090909090909
1971,1930007,1609,12,165,668,1597,1609,1.0,0.0074580484773151025,0.9925419515226849,776,0.10254816656308266,0.4151646985705407,0.48228713486637664
1972,1930009,241,0,18,125,241,241,1.0,0.0,1.0,98,0.07468879668049792,0.5186721991701245,0.4066390041493776
1973,1930012,145,1,14,126,144,145,1.0,0.006896551724137931,0.993103448275862,5,0.09655172413793103,0.8689655172413793,0.034482758620689655
1974,1930014,227,0,14,122,227,227,1.0,0.0,1.0,91,0.06167400881057269,0.5374449339207048,0.4008810572687225
1975,1930015,172,0,20,94,172,172,1.0,0.0,1.0,58,0.11627906976744186,0.5465116279069767,0.3372093023255814
1976,1930017,249,0,12,98,249,249,1.0,0.0,1.0,139,0.04819277108433735,0.39357429718875503,0.5582329317269076
1977,1930022,1347,7,128,623,1340,1347,1.0,0.005196733481811433,0.9948032665181886,596,0.09502598366740905,0.46250927988121754,0.4424647364513734
1978,1930023,1174,3,102,449,1171,1174,1.0,0.002555366269165247,0.9974446337308348,623,0.0868824531516184,0.38245315161839866,0.530664395229983
1979,1950001,760,1,46,423,759,760,1.0,0.0013157894736842105,0.9986842105263158,291,0.060526315789473685,0.5565789473684211,0.3828947368421053
1980,1950002,52,0,6,41,52,52,1.0,0.0,1.0,5,0.11538461538461539,0.7884615384615384,0.09615384615384616
1981,1950003,221,0,5,175,221,221,1.0,0.0,1.0,41,0.02262443438914027,0.7918552036199095,0.18552036199095023
1982,1950004,560,0,28,353,560,560,1.0,0.0,1.0,179,0.05,0.6303571428571428,0.3196428571428571
1983,1950005,539,1,19,296,538,539,1.0,0.0018552875695732839,0.9981447124304267,224,0.03525046382189239,0.549165120593692,0.4155844155844156
1984,1950006,807,0,44,397,807,807,1.0,0.0,1.0,366,0.05452292441140025,0.4919454770755886,0.45353159851301117
1985,1950007,32,0,0,32,32,32,1.103448275862069,0.0,1.0,0,0.0,1.0,0.0
1986,1950009,90,0,11,71,90,90,1.0,0.0,1.0,8,0.12222222222222222,0.7888888888888889,0.08888888888888889
1987,1970001,632,98,84,340,534,632,1.0,0.1550632911392405,0.8449367088607594,208,0.13291139240506328,0.5379746835443038,0.3291139240506329
1988,1970002,663,22,58,263,641,663,1.0,0.033182503770739065,0.9668174962292609,342,0.08748114630467571,0.39668174962292607,0.5158371040723982
1989,1970003,717,40,70,282,677,717,1.0,0.05578800557880056,0.9442119944211994,365,0.09762900976290098,0.39330543933054396,0.5090655509065551
1990,1970004,813,47,90,291,766,813,1.0,0.05781057810578106,0.942189421894219,432,0.11070110701107011,0.35793357933579334,0.5313653136531366
1991,1990001,1735,182,320,610,1553,1735,1.0,0.10489913544668587,0.8951008645533142,805,0.1844380403458213,0.3515850144092219,0.46397694524495675
1992,1990002,5899,164,349,2317,5735,5899,1.0,0.027801322258009832,0.9721986777419902,3233,0.059162569927106286,0.3927784370232243,0.5480589930496694
1993,1990003,718,0,30,367,718,718,1.0,0.0,1.0,321,0.04178272980501393,0.5111420612813371,0.44707520891364905
1994,1990004,907,0,47,467,907,907,1.0,0.0,1.0,393,0.05181918412348401,0.5148842337375965,0.43329658213891953
1995,1990005,740,9,32,338,731,740,1.0,0.012162162162162163,0.9878378378378379,370,0.043243243243243246,0.45675675675675675,0.5
1996,1990006,5206,208,294,1982,4998,5206,1.0,0.039953899346907414,0.9600461006530926,2930,0.05647330003841721,0.3807145601229351,0.5628121398386478
1997,1990007,910,4,49,353,906,910,1.0,0.004395604395604396,0.9956043956043956,508,0.05384615384615385,0.3879120879120879,0.5582417582417583
1998,1990008,1069,47,88,459,1022,1069,1.0,0.04396632366697849,0.9560336763330215,522,0.0823199251637044,0.4293732460243218,0.4883068288119738
1999,1990009,2693,361,374,1206,2332,2693,1.0,0.13405124396583737,0.8659487560341627,1113,0.1388785740809506,0.44782770144819906,0.41329372447085033
2000,1990010,2427,819,649,411,1608,2427,1.0,0.3374536464771323,0.6625463535228677,1367,0.26740832303255047,0.16934487021013597,0.5632468067573135
2001,1990011,1149,6,86,444,1143,1149,1.0,0.005221932114882507,0.9947780678851175,619,0.07484769364664925,0.38642297650130547,0.5387293298520452
2002,1990012,1229,231,86,448,998,1229,1.0,0.18795768917819367,0.8120423108218063,695,0.06997558991049634,0.3645240032546786,0.565500406834825
2003,1990013,2958,6,138,1260,2952,2958,1.0,0.002028397565922921,0.9979716024340771,1560,0.04665314401622718,0.4259634888438134,0.5273833671399595
2004,1990014,1626,37,96,899,1589,1626,1.0,0.022755227552275523,0.9772447724477245,631,0.05904059040590406,0.552890528905289,0.3880688806888069
2005,1990015,2092,110,166,963,1982,2092,1.0,0.052581261950286805,0.9474187380497132,963,0.07934990439770555,0.46032504780114725,0.46032504780114725
2006,1990016,2975,0,122,1170,2975,2975,1.0,0.0,1.0,1683,0.041008403361344536,0.39327731092436974,0.5657142857142857
2007,1990017,1199,16,52,540,1183,1199,1.0,0.013344453711426188,0.9866555462885738,607,0.043369474562135114,0.45037531276063386,0.5062552126772311
2008,1990018,5084,23,321,3012,5061,5084,1.0,0.004523996852871755,0.9954760031471283,1751,0.06313926042486231,0.5924468922108576,0.3444138473642801
2009,1990019,1282,4,60,500,1278,1282,1.0,0.0031201248049922,0.9968798751950078,722,0.046801872074883,0.39001560062402496,0.5631825273010921
2010,2010002,2626,93,566,559,2533,2626,1.0,0.03541507996953541,0.9645849200304646,1501,0.21553693830921553,0.21287128712871287,0.5715917745620716
2011,2010003,1517,23,609,478,1494,1517,1.0,0.015161502966381015,0.984838497033619,430,0.4014502307185234,0.3150955833882663,0.2834541858932103
2012,2010004,1563,13,707,457,1550,1563,1.0,0.008317338451695458,0.9916826615483045,399,0.4523352527191299,0.2923864363403711,0.255278310940499
2013,2010005,1727,24,551,405,1703,1727,1.0,0.013896931094383324,0.9861030689056167,771,0.31905037637521716,0.23451071221771858,0.44643891140706427
2014,2010006,5000,1280,889,1092,3720,5000,1.0,0.256,0.744,3019,0.1778,0.2184,0.6038
2015,2010007,859,710,591,15,149,859,1.0,0.8265424912689173,0.17345750873108265,253,0.6880093131548312,0.017462165308498253,0.29452852153667053
2016,2010008,2432,138,518,550,2294,2432,1.0,0.05674342105263158,0.9432565789473685,1364,0.21299342105263158,0.22615131578947367,0.5608552631578947
2017,2010009,1926,643,620,199,1283,1926,1.0,0.333852544132918,0.666147455867082,1107,0.32191069574247144,0.10332294911734165,0.5747663551401869
2018,2010010,1686,53,521,185,1633,1686,1.0,0.03143534994068802,0.968564650059312,980,0.30901542111506525,0.10972716488730723,0.5812574139976275
2019,2010011,2311,146,565,147,2165,2311,1.0,0.06317611423626136,0.9368238857637387,1599,0.2444829078321073,0.06360882734746863,0.6919082648204241
2020,2010012,906,250,145,203,656,906,1.0,0.27593818984547464,0.7240618101545254,558,0.1600441501103753,0.2240618101545254,0.6158940397350994
2021,2010013,4400,1120,444,1101,3280,4400,1.0,0.2545454545454545,0.7454545454545455,2855,0.1009090909090909,0.25022727272727274,0.6488636363636363
2022,2010014,1918,59,583,741,1859,1918,1.0,0.030761209593326382,0.9692387904066736,594,0.3039624608967675,0.3863399374348279,0.3096976016684046
2023,2010015,2935,25,815,1303,2910,2935,1.0,0.008517887563884156,0.9914821124361158,817,0.2776831345826235,0.44395229982964224,0.27836456558773426
2024,2010016,2332,458,295,313,1874,2332,1.0,0.19639794168096056,0.8036020583190394,1724,0.12650085763293312,0.1342195540308748,0.7392795883361921
2025,2010017,1321,60,372,266,1261,1321,1.0,0.045420136260408785,0.9545798637395913,683,0.28160484481453446,0.20136260408781226,0.5170325510976533
2026,2010018,1241,3,506,502,1238,1241,1.0,0.0024174053182917004,0.9975825946817083,233,0.40773569701853346,0.40451248992747785,0.18775181305398872
2027,2010019,1606,358,413,245,1248,1606,1.0,0.22291407222914073,0.7770859277708593,948,0.25716064757160645,0.15255292652552926,0.5902864259028643
2028,2010020,2372,341,765,337,2031,2372,1.0,0.14376053962900506,0.856239460370995,1270,0.3225126475548061,0.14207419898819562,0.5354131534569984
2029,2010021,1217,585,483,137,632,1217,1.0,0.4806902218570255,0.5193097781429745,597,0.39687756778964667,0.11257189811010682,0.4905505341002465
2030,2010022,2880,1753,1196,212,1127,2880,1.0,0.6086805555555556,0.39131944444444444,1472,0.4152777777777778,0.07361111111111111,0.5111111111111111
2031,2010023,900,115,126,36,785,900,1.0,0.12777777777777777,0.8722222222222222,738,0.14,0.04,0.82
2032,2010024,775,559,299,41,216,775,1.0,0.7212903225806452,0.2787096774193548,435,0.3858064516129032,0.05290322580645161,0.5612903225806452
2033,2010025,1044,969,519,14,75,1044,1.0,0.9281609195402298,0.07183908045977011,511,0.49712643678160917,0.013409961685823755,0.48946360153256707
2034,2010026,2510,144,652,260,2366,2510,1.0,0.05737051792828685,0.9426294820717132,1598,0.2597609561752988,0.10358565737051793,0.6366533864541832
2035,2010027,4004,184,1071,392,3820,4004,1.0,0.04595404595404595,0.954045954045954,2541,0.2674825174825175,0.0979020979020979,0.6346153846153846
2036,2010028,4050,879,715,1161,3171,4050,1.0,0.21703703703703703,0.782962962962963,2174,0.1765432098765432,0.2866666666666667,0.5367901234567901
2037,2010029,3011,17,626,338,2994,3011,1.0,0.005645964795748921,0.994354035204251,2047,0.2079043507140485,0.11225506476253737,0.6798405845234141
2038,2010030,2911,471,990,359,2440,2911,1.0,0.1618000687049124,0.8381999312950876,1562,0.3400893163861216,0.12332531776021985,0.5365853658536586
2039,2010031,3135,2895,1401,21,240,3135,1.0,0.9234449760765551,0.07655502392344497,1713,0.44688995215311006,0.0066985645933014355,0.5464114832535886
2040,2010032,4005,554,635,665,3451,4005,1.0,0.1383270911360799,0.8616729088639201,2705,0.1585518102372035,0.16604244694132334,0.6754057428214731
2041,2010033,4758,109,1294,945,4649,4758,1.0,0.02290878520386717,0.9770912147961328,2519,0.2719630096679277,0.19861286254728877,0.5294241277847835
2042,2010034,3364,226,1192,485,3138,3364,1.0,0.06718192627824018,0.9328180737217598,1687,0.35434007134363854,0.14417360285374553,0.501486325802616
2043,2010035,20,12,3,1,8,20,1.0,0.6,0.4,16,0.15,0.05,0.8
2044,2010036,3936,1445,1027,403,2491,3936,1.0,0.3671239837398374,0.6328760162601627,2506,0.2609247967479675,0.10238821138211382,0.6366869918699187
2045,2010037,2922,62,811,425,2860,2922,1.0,0.021218343600273786,0.9787816563997263,1686,0.27754962354551677,0.14544832306639288,0.5770020533880903
2046,2010038,3071,41,1135,728,3030,3071,1.0,0.013350700097688049,0.986649299902312,1208,0.36958645392380335,0.2370563334418756,0.39335721263432105
2047,2010039,3306,168,1219,507,3138,3306,1.0,0.050816696914700546,0.9491833030852994,1580,0.3687235329703569,0.15335753176043557,0.4779189352692075
2048,2010040,492,22,163,204,470,492,1.0,0.044715447154471545,0.9552845528455285,125,0.3313008130081301,0.4146341463414634,0.2540650406504065
2049,2010041,2499,423,534,615,2076,2499,1.0,0.16926770708283315,0.8307322929171669,1350,0.21368547418967587,0.2460984393757503,0.5402160864345739
2050,2010042,1025,884,620,14,141,1025,1.0,0.8624390243902439,0.1375609756097561,391,0.6048780487804878,0.013658536585365854,0.38146341463414635
2051,2010043,2715,195,452,434,2520,2715,1.0,0.0718232044198895,0.9281767955801105,1829,0.16648250460405156,0.1598526703499079,0.6736648250460405
2052,2010044,2244,125,582,188,2119,2244,1.0,0.05570409982174688,0.9442959001782532,1474,0.25935828877005346,0.08377896613190731,0.6568627450980392
2053,2010045,9437,4033,2240,507,5404,9437,1.0,0.42736038995443465,0.5726396100455653,6690,0.2373635689308043,0.053724700646391864,0.7089117304228039
2054,2010046,2644,447,759,177,2197,2644,1.0,0.16906202723146746,0.8309379727685325,1708,0.2870650529500756,0.06694402420574887,0.6459909228441755
2055,2010047,1768,976,850,18,792,1768,1.0,0.5520361990950227,0.4479638009049774,900,0.4807692307692308,0.010180995475113122,0.5090497737556561
2056,2010048,982,570,503,53,412,982,1.0,0.5804480651731161,0.4195519348268839,426,0.5122199592668024,0.0539714867617108,0.43380855397148677
2057,2010049,4321,584,505,1339,3737,4321,1.0,0.13515389956028698,0.864846100439713,2477,0.11687109465401527,0.30988197176579496,0.5732469335801897
2058,2010050,5924,1305,1071,1164,4619,5924,1.0,0.22029034436191763,0.7797096556380824,3689,0.18079000675219448,0.19648885887913572,0.6227211343686698
2059,2010051,1786,12,234,748,1774,1786,1.0,0.006718924972004479,0.9932810750279956,804,0.13101903695408734,0.41881298992161253,0.4501679731243001
2060,2010052,3650,223,704,835,3427,3650,1.0,0.061095890410958906,0.9389041095890411,2111,0.19287671232876713,0.22876712328767124,0.5783561643835616
2061,2010053,3119,9,1049,870,3110,3119,1.0,0.0028855402372555306,0.9971144597627445,1200,0.33632574543122795,0.2789355562680346,0.3847386983007374
2062,2010054,1724,64,444,531,1660,1724,1.0,0.037122969837587005,0.962877030162413,749,0.25754060324825984,0.3080046403712297,0.43445475638051045
2063,2010055,2782,305,462,343,2477,2782,1.0,0.10963335729690869,0.8903666427030913,1977,0.16606757728253055,0.12329259525521208,0.7106398274622574
2064,2010056,1013,15,280,543,998,1013,1.0,0.014807502467917079,0.9851924975320829,190,0.2764067127344521,0.5360315893385982,0.18756169792694966
2065,2010057,3462,28,1195,945,3434,3462,1.0,0.008087810514153668,0.9919121894858464,1322,0.34517619872905836,0.2729636048526863,0.38186019641825536
2066,2010058,3903,141,851,720,3762,3903,1.0,0.0361260568793236,0.9638739431206764,2332,0.2180374071227261,0.18447348193697155,0.5974891109403023
2067,2010059,2849,31,901,711,2818,2849,1.0,0.01088101088101088,0.9891189891189891,1237,0.31625131625131625,0.24956124956124956,0.43418743418743416
2068,2010060,3379,110,1002,447,3269,3379,1.0,0.032554010062148565,0.9674459899378515,1930,0.2965374371115715,0.13228765907073098,0.5711749038176975
2069,2010061,2073,104,412,222,1969,2073,1.0,0.05016883743367101,0.949831162566329,1439,0.19874577906415822,0.10709117221418235,0.6941630487216595
2070,2010062,2343,142,663,241,2201,2343,1.0,0.06060606060606061,0.9393939393939394,1439,0.28297055057618437,0.10285958173282117,0.6141698676909945
2071,2010063,2133,354,173,879,1779,2133,1.0,0.1659634317862166,0.8340365682137834,1081,0.08110642287857478,0.4120956399437412,0.5067979371776841
2072,2010064,2184,24,630,170,2160,2184,1.0,0.01098901098901099,0.989010989010989,1384,0.28846153846153844,0.07783882783882784,0.6336996336996337
2073,2010065,2474,15,716,184,2459,2474,1.0,0.006063055780113177,0.9939369442198869,1574,0.28940986257073564,0.07437348423605497,0.6362166531932094
2074,2010066,1230,165,350,82,1065,1230,1.0,0.13414634146341464,0.8658536585365854,798,0.2845528455284553,0.06666666666666667,0.6487804878048781
2075,2010067,4395,664,922,278,3731,4395,1.0,0.15108077360637087,0.8489192263936292,3195,0.20978384527872582,0.06325369738339022,0.726962457337884
2076,2010068,3033,2683,1634,23,350,3033,1.0,0.8846027035938016,0.11539729640619849,1376,0.5387405209363666,0.007583250906693043,0.4536762281569403
2077,2010069,1185,0,381,101,1185,1185,1.0,0.0,1.0,703,0.32151898734177214,0.08523206751054853,0.5932489451476793
2078,2010070,3763,210,880,1567,3553,3763,1.0,0.055806537337230934,0.944193462662769,1316,0.23385596598458677,0.4164230667020994,0.34972096731331387
2079,2010071,6065,418,1081,1233,5647,6065,1.0,0.06892003297609234,0.9310799670239077,3751,0.17823577906018137,0.20329760923330586,0.6184666117065127
2080,2010072,2455,100,658,306,2355,2455,1.0,0.04073319755600815,0.9592668024439919,1491,0.2680244399185336,0.12464358452138492,0.6073319755600814
2081,2010073,1822,82,380,591,1740,1822,1.0,0.04500548847420417,0.9549945115257958,851,0.20856201975850713,0.3243688254665203,0.4670691547749726
2082,2010074,3676,104,520,2172,3572,3676,1.0,0.028291621327529923,0.9717083786724701,984,0.14145810663764963,0.5908596300326442,0.2676822633297062
2083,2010075,1828,6,483,348,1822,1828,1.0,0.0032822757111597373,0.9967177242888403,997,0.26422319474835887,0.19037199124726478,0.5454048140043763
2084,2010076,2713,408,562,782,2305,2713,1.0,0.1503870254330999,0.8496129745669001,1369,0.20715075562108368,0.2882417987467748,0.5046074456321415
2085,2010077,23,0,2,2,23,23,1.0,0.0,1.0,19,0.08695652173913043,0.08695652173913043,0.8260869565217391
2086,2010078,1914,154,439,240,1760,1914,1.0,0.08045977011494253,0.9195402298850575,1235,0.22936259143155696,0.12539184952978055,0.6452455590386625
2087,2010079,3499,414,911,264,3085,3499,1.0,0.11831951986281795,0.881680480137182,2324,0.260360102886539,0.07545012860817377,0.6641897685052872
2088,2010080,3998,1532,1216,380,2466,3998,1.0,0.38319159579789897,0.616808404202101,2402,0.304152076038019,0.09504752376188094,0.6008004002001001
2089,2010081,2448,105,525,297,2343,2448,1.0,0.0428921568627451,0.9571078431372549,1626,0.21446078431372548,0.1213235294117647,0.6642156862745098
2090,2010082,3909,392,512,1664,3517,3909,1.0,0.10028140189306728,0.8997185981069327,1733,0.13097979022767972,0.42568431823995906,0.4433358915323612
2091,2010084,1914,3,189,575,1911,1914,1.0,0.001567398119122257,0.9984326018808778,1150,0.0987460815047022,0.3004179728317659,0.6008359456635318
2092,2010085,2541,2090,1250,18,451,2541,1.0,0.8225108225108225,0.1774891774891775,1273,0.4919323101141283,0.0070838252656434475,0.5009838646202283
2093,2010086,4398,128,884,810,4270,4398,1.0,0.02910413824465666,0.9708958617553434,2704,0.20100045475216008,0.18417462482946795,0.614824920418372
2094,2010087,2342,46,706,1346,2296,2342,1.0,0.01964133219470538,0.9803586678052946,290,0.30145175064047824,0.5747224594363791,0.12382578992314261
2095,2010088,1081,69,125,258,1012,1081,1.0,0.06382978723404255,0.9361702127659575,698,0.11563367252543941,0.23866790009250693,0.6456984273820536
2096,2010089,1003,14,296,475,989,1003,1.0,0.013958125623130608,0.9860418743768694,232,0.2951146560319043,0.47357926221335994,0.2313060817547358
2097,2010090,4065,111,553,1836,3954,4065,1.0,0.02730627306273063,0.9726937269372694,1676,0.13603936039360393,0.45166051660516604,0.41230012300123003
2098,2010091,2210,324,287,489,1886,2210,1.0,0.14660633484162897,0.853393665158371,1434,0.12986425339366517,0.22126696832579185,0.648868778280543
2099,2010092,1709,0,463,1123,1709,1709,1.0,0.0,1.0,123,0.27091866588648333,0.6571094207138678,0.07197191339964892
2100,2010093,4462,82,824,548,4380,4462,1.0,0.018377409233527566,0.9816225907664724,3090,0.184670551322277,0.12281488121918423,0.6925145674585388
2101,2010094,835,0,175,66,835,835,1.0,0.0,1.0,594,0.20958083832335328,0.07904191616766468,0.7113772455089821
2102,2010095,2981,151,652,1662,2830,2981,1.0,0.05065414290506542,0.9493458570949346,667,0.21871855082187186,0.5575310298557531,0.22375041932237505
2103,2010096,1972,951,609,137,1021,1972,1.0,0.48225152129817445,0.5177484787018256,1226,0.3088235294117647,0.06947261663286004,0.6217038539553753
2104,2010097,5631,477,615,1971,5154,5631,1.0,0.08470964304741609,0.9152903569525839,3045,0.10921683537559936,0.3500266382525306,0.54075652637187
2105,2010098,3459,75,238,1352,3384,3459,1.0,0.02168256721595837,0.9783174327840416,1869,0.06880601329864122,0.3908644116796762,0.5403295750216826
2106,2010099,3207,710,450,404,2497,3207,1.0,0.22139070782662926,0.7786092921733707,2353,0.1403180542563143,0.1259744309323355,0.7337075148113502
2107,2010100,2031,175,385,339,1856,2031,1.0,0.08616445100935499,0.913835548990645,1307,0.189561792220581,0.16691285081240767,0.6435253569670113
2108,2010101,1814,759,296,84,1055,1814,1.0,0.418412348401323,0.581587651598677,1434,0.1631753031973539,0.04630650496141125,0.7905181918412348
2109,2010102,2383,440,535,198,1943,2383,1.0,0.18464120856063784,0.8153587914393622,1650,0.22450692404532102,0.08308854385228703,0.692404532102392
2110,2010103,6800,1335,1035,1256,5465,6800,1.0,0.1963235294117647,0.8036764705882353,4509,0.15220588235294116,0.18470588235294116,0.6630882352941176
2111,2010104,1904,1413,1191,24,491,1904,1.0,0.7421218487394958,0.25787815126050423,689,0.6255252100840336,0.012605042016806723,0.36186974789915966
2112,2010105,3239,49,622,257,3190,3239,1.0,0.015128125964803951,0.984871874035196,2360,0.19203457857363385,0.0793454769990738,0.7286199444272924
2113,2010106,755,61,44,39,694,755,1.0,0.08079470198675497,0.919205298013245,672,0.05827814569536424,0.051655629139072845,0.8900662251655629
2114,2010107,2573,524,689,140,2049,2573,1.0,0.20365332296929653,0.7963466770307035,1744,0.26778080062184223,0.054411193159735714,0.6778080062184221
2115,2010108,6062,2922,751,911,3140,6062,1.0,0.48201913559881227,0.5179808644011877,4400,0.12388650610359617,0.15028043549983502,0.7258330583965688
2116,2010109,2495,1882,1546,22,613,2495,1.0,0.754308617234469,0.24569138276553107,927,0.6196392785571142,0.008817635270541082,0.3715430861723447
2117,2010110,3082,616,748,1263,2466,3082,1.0,0.199870214146658,0.8001297858533419,1071,0.2426995457495133,0.4097988319273199,0.3475016223231668
2118,2010111,5012,512,625,2039,4500,5012,1.0,0.10215482841181166,0.8978451715881883,2348,0.12470071827613727,0.40682362330407024,0.4684756584197925
2119,2010112,3499,225,525,1358,3274,3499,1.0,0.06430408688196627,0.9356959131180337,1616,0.15004286939125464,0.3881108888253787,0.4618462417833667
2120,2010113,3429,484,690,984,2945,3429,1.0,0.14114902303878682,0.8588509769612132,1755,0.20122484689413822,0.2869641294838145,0.5118110236220472
2121,2010114,6076,631,381,1574,5445,6076,1.0,0.10385121790651744,0.8961487820934826,4121,0.06270572745227124,0.25905200789993416,0.6782422646477946
2122,2010115,2185,716,776,110,1469,2185,1.0,0.3276887871853547,0.6723112128146453,1299,0.3551487414187643,0.05034324942791762,0.594508009153318
2123,2010116,2950,0,493,1827,2950,2950,1.0,0.0,1.0,630,0.1671186440677966,0.6193220338983051,0.2135593220338983
2124,2010117,2831,206,454,367,2625,2831,1.0,0.07276580713528788,0.9272341928647121,2010,0.16036736135641116,0.12963617096432356,0.7099964676792653
2125,2010118,4845,1750,744,689,3095,4845,1.0,0.36119711042311664,0.6388028895768834,3412,0.15356037151702787,0.14220846233230133,0.7042311661506708
2126,2010119,6308,215,537,2111,6093,6308,1.0,0.034083703233988585,0.9659162967660114,3660,0.08512999365884591,0.3346544071020926,0.5802155992390615
2127,2010120,5084,159,660,1123,4925,5084,1.0,0.03127458693941778,0.9687254130605822,3301,0.12981904012588513,0.22088906372934697,0.6492918961447679
2128,2010121,1886,149,134,285,1737,1886,1.0,0.07900318133616119,0.9209968186638389,1467,0.07104984093319194,0.1511134676564157,0.7778366914103924
2129,2010122,1579,1028,1025,30,551,1579,1.0,0.6510449651678277,0.3489550348321723,524,0.64914502849905,0.018999366687777075,0.3318556048131729
2130,2010123,1888,227,538,222,1661,1888,1.0,0.12023305084745763,0.8797669491525424,1128,0.2849576271186441,0.11758474576271187,0.597457627118644
2131,2010124,9326,666,820,3571,8660,9326,1.0,0.07141325327042676,0.9285867467295732,4935,0.0879262277503753,0.38290799914218315,0.5291657731074415
2132,2010125,3010,696,561,828,2314,3010,1.0,0.23122923588039868,0.7687707641196013,1621,0.18637873754152823,0.2750830564784053,0.5385382059800664
2133,2010126,4253,415,224,1764,3838,4253,1.0,0.09757818010815894,0.902421819891841,2265,0.05266870444392194,0.41476604749588525,0.5325652480601928
2134,2010127,2726,172,279,732,2554,2726,1.0,0.06309611151870873,0.9369038884812912,1715,0.10234776228906824,0.26852531181217903,0.6291269258987527
2135,2010128,2351,34,556,1072,2317,2351,1.0,0.01446193109315185,0.9855380689068481,723,0.2364951084644832,0.45597618034878773,0.30752871118672903
2136,2010129,5930,684,1091,2020,5246,5930,1.0,0.11534569983136593,0.8846543001686341,2819,0.18397976391231027,0.3406408094435076,0.47537942664418215
2137,2010130,2735,72,404,1301,2663,2735,1.0,0.0263254113345521,0.9736745886654479,1030,0.14771480804387568,0.4756855575868373,0.376599634369287
2138,2010131,3410,1295,717,238,2115,3410,1.0,0.37976539589442815,0.6202346041055719,2455,0.21026392961876833,0.06979472140762463,0.7199413489736071
2139,2010132,2097,1931,1465,25,166,2097,1.0,0.9208392942298522,0.07916070577014783,607,0.6986170720076299,0.011921793037672867,0.28946113495469716
2140,2010133,2410,0,731,1254,2410,2410,1.0,0.0,1.0,425,0.3033195020746888,0.5203319502074689,0.17634854771784234
2141,2010134,2099,97,419,367,2002,2099,1.0,0.04621248213434969,0.9537875178656503,1313,0.19961886612672702,0.17484516436398284,0.6255359695092901
2142,2010135,2881,105,657,1366,2776,2881,1.0,0.03644567858382506,0.9635543214161749,858,0.2280458174245054,0.4741409232905241,0.2978132592849705
2143,2010136,2425,1973,1353,44,452,2425,1.0,0.8136082474226805,0.18639175257731957,1028,0.5579381443298969,0.018144329896907216,0.42391752577319586
2144,2010137,2544,279,277,610,2265,2544,1.0,0.10966981132075472,0.8903301886792453,1657,0.10888364779874214,0.23977987421383648,0.6513364779874213
2145,2010138,1565,1286,885,15,279,1565,1.0,0.8217252396166134,0.17827476038338658,665,0.5654952076677316,0.009584664536741214,0.4249201277955272
2146,2010139,4214,50,965,1027,4164,4214,1.0,0.011865211200759373,0.9881347887992407,2222,0.2289985761746559,0.24371143806359752,0.5272899857617466
2147,2010140,3782,1866,1663,287,1916,3782,1.0,0.49338974087784243,0.5066102591221576,1832,0.4397144368059228,0.07588577472236911,0.4843997884717081
2148,2010141,1593,25,104,212,1568,1593,1.0,0.015693659761456372,0.9843063402385436,1277,0.06528562460765851,0.13308223477715003,0.8016321406151915
2149,2010142,1228,40,266,104,1188,1228,1.0,0.03257328990228013,0.9674267100977199,858,0.21661237785016288,0.08469055374592833,0.6986970684039088
2150,2010144,874,725,662,8,149,874,1.0,0.8295194508009154,0.17048054919908467,204,0.7574370709382151,0.009153318077803204,0.2334096109839817
2151,2010145,1618,1521,878,17,97,1618,1.0,0.9400494437577256,0.05995055624227441,723,0.5426452410383189,0.010506798516687269,0.4468479604449938
2152,2010146,2164,297,707,620,1867,2164,1.0,0.13724584103512014,0.8627541589648798,837,0.3267097966728281,0.28650646950092423,0.3867837338262477
2153,2010147,4185,2774,1501,203,1411,4185,1.0,0.6628434886499402,0.33715651135005975,2481,0.35866188769414575,0.048506571087216246,0.592831541218638
2154,2010148,2365,66,1021,773,2299,2365,1.0,0.027906976744186046,0.9720930232558139,571,0.4317124735729387,0.32684989429175476,0.24143763213530656
2155,2010149,5703,1243,805,665,4460,5703,1.0,0.2179554620375241,0.7820445379624759,4233,0.1411537787129581,0.1166052954585306,0.7422409258285113
2156,2010150,1720,1291,717,17,429,1720,1.0,0.7505813953488372,0.24941860465116278,986,0.41686046511627906,0.009883720930232558,0.5732558139534883
2157,2010151,961,702,429,21,259,961,1.0,0.7304890738813735,0.2695109261186264,511,0.4464099895941727,0.021852237252861603,0.5317377731529657
2158,2010152,3814,331,793,242,3483,3814,1.0,0.08678552700576822,0.9132144729942318,2779,0.20791819611955953,0.06345044572627163,0.7286313581541689
2159,2010153,2004,93,526,206,1911,2004,1.0,0.04640718562874251,0.9535928143712575,1272,0.2624750499001996,0.1027944111776447,0.6347305389221557
2160,2010154,2520,0,686,229,2520,2520,1.0,0.0,1.0,1605,0.2722222222222222,0.09087301587301587,0.6369047619047619
2161,2010155,4455,384,861,1880,4071,4455,1.0,0.0861952861952862,0.9138047138047138,1714,0.19326599326599325,0.4219977553310887,0.38473625140291806
2162,2010156,3363,2670,1815,39,693,3363,1.0,0.7939339875111507,0.20606601248884923,1509,0.5396966993755575,0.01159678858162355,0.4487065120428189
2163,2010157,1942,1507,1203,37,435,1942,1.0,0.7760041194644696,0.22399588053553038,702,0.6194644696189495,0.01905252317198764,0.36148300720906285
2164,2010158,3458,3286,1695,20,172,3458,1.0,0.9502602660497398,0.04973973395026027,1743,0.4901677270098323,0.00578368999421631,0.5040485829959515
2165,2010159,912,564,433,58,348,912,1.0,0.618421052631579,0.3815789473684211,421,0.47478070175438597,0.06359649122807018,0.4616228070175439
2166,2010160,1055,747,373,9,308,1055,1.0,0.7080568720379147,0.2919431279620853,673,0.35355450236966823,0.008530805687203791,0.637914691943128
2167,2010161,1134,830,570,6,304,1134,1.0,0.7319223985890653,0.26807760141093473,558,0.5026455026455027,0.005291005291005291,0.49206349206349204
2168,2010162,1699,0,318,156,1699,1699,1.0,0.0,1.0,1225,0.18716892289582107,0.09181871689228958,0.7210123602118893
2169,2010163,4300,115,860,513,4185,4300,1.0,0.026744186046511628,0.9732558139534884,2927,0.2,0.11930232558139535,0.6806976744186046
2170,2010164,1114,829,780,10,285,1114,1.0,0.744165170556553,0.25583482944344704,324,0.7001795332136446,0.008976660682226212,0.29084380610412924
2171,2010165,3173,220,492,936,2953,3173,1.0,0.069335014182162,0.930664985817838,1745,0.15505830444374408,0.29498896942956193,0.549952726126694
2172,2010166,1041,9,371,196,1032,1041,1.0,0.008645533141210375,0.9913544668587896,474,0.356388088376561,0.1882804995196926,0.4553314121037464
2173,2010167,30,18,7,0,12,30,1.0,0.6,0.4,23,0.23333333333333334,0.0,0.7666666666666667
2174,2010168,434,200,304,4,234,434,1.0,0.4608294930875576,0.5391705069124424,126,0.7004608294930875,0.009216589861751152,0.2903225806451613
2175,2010169,3030,2348,1450,20,682,3030,1.0,0.7749174917491749,0.22508250825082507,1560,0.47854785478547857,0.006600660066006601,0.5148514851485149
2176,2010170,3270,219,374,432,3051,3270,1.0,0.06697247706422019,0.9330275229357798,2464,0.11437308868501529,0.13211009174311927,0.7535168195718654
2177,2010171,1768,972,766,26,796,1768,1.0,0.5497737556561086,0.4502262443438914,976,0.4332579185520362,0.014705882352941176,0.5520361990950227
2178,2010172,868,17,191,107,851,868,1.0,0.019585253456221197,0.9804147465437788,570,0.22004608294930875,0.12327188940092165,0.6566820276497696
2179,2010173,4259,117,500,1835,4142,4259,1.0,0.02747123737966659,0.9725287626203334,1924,0.11739845034045551,0.4308523127494717,0.4517492369100728
2180,2010174,3554,183,674,1600,3371,3554,1.0,0.05149127743387732,0.9485087225661227,1280,0.18964546989307823,0.4501969611705121,0.36015756893640966
2181,2010175,2969,61,893,1007,2908,2969,1.0,0.02054563826204109,0.9794543617379589,1069,0.30077467160660154,0.3391714381946783,0.3600538901987201
2182,2010176,1309,20,481,642,1289,1309,1.0,0.015278838808250574,0.9847211611917495,186,0.3674560733384263,0.4904507257448434,0.14209320091673033
2183,2010177,2507,184,398,628,2323,2507,1.0,0.07339449541284404,0.926605504587156,1481,0.1587554846429996,0.25049860390905465,0.5907459114479457
2184,2010178,1844,25,375,878,1819,1844,1.0,0.013557483731019523,0.9864425162689805,591,0.20336225596529284,0.4761388286334056,0.32049891540130154
2185,2010180,3065,2424,1450,34,641,3065,1.0,0.7908646003262643,0.20913539967373573,1581,0.4730831973898858,0.011092985318107667,0.5158238172920065
2186,2010181,2796,4,607,289,2792,2796,1.0,0.001430615164520744,0.9985693848354793,1900,0.2170958512160229,0.10336194563662375,0.6795422031473534
2187,2010182,4067,259,1092,1645,3808,4067,1.0,0.06368330464716007,0.9363166953528399,1330,0.2685025817555938,0.4044750430292599,0.3270223752151463
2188,2010183,2536,43,555,1321,2493,2536,1.0,0.01695583596214511,0.9830441640378549,660,0.21884858044164038,0.5208990536277602,0.26025236593059936
2189,2010184,1386,295,309,144,1091,1386,1.0,0.21284271284271283,0.7871572871572872,933,0.22294372294372294,0.1038961038961039,0.6731601731601732
2190,2010185,2453,373,692,364,2080,2453,1.0,0.15205870362821036,0.8479412963717896,1397,0.28210354667753773,0.1483897268650632,0.5695067264573991
2191,2010186,1400,664,321,41,736,1400,1.0,0.4742857142857143,0.5257142857142857,1038,0.2292857142857143,0.029285714285714286,0.7414285714285714
2192,2010187,495,0,78,30,495,495,1.0,0.0,1.0,387,0.15757575757575756,0.06060606060606061,0.7818181818181819
2193,2010188,2216,11,415,255,2205,2216,1.0,0.004963898916967509,0.9950361010830325,1546,0.18727436823104693,0.11507220216606498,0.6976534296028881
2194,2010189,1527,7,413,517,1520,1527,1.0,0.0045841519318926,0.9954158480681073,597,0.2704649639816634,0.33857236411263913,0.39096267190569745
2195,2010190,2392,58,408,240,2334,2392,1.0,0.024247491638795988,0.975752508361204,1744,0.1705685618729097,0.10033444816053512,0.7290969899665551
2196,2010191,2413,152,303,194,2261,2413,1.0,0.06299212598425197,0.937007874015748,1916,0.1255698300870286,0.08039784500621633,0.7940323249067551
2197,2010192,2280,1504,1018,36,776,2280,1.0,0.6596491228070176,0.34035087719298246,1226,0.44649122807017544,0.015789473684210527,0.537719298245614
2198,2010193,1618,1331,587,11,287,1618,1.0,0.8226205191594561,0.1773794808405439,1020,0.36279357231149567,0.006798516687268232,0.630407911001236
2199,2010194,2067,329,829,348,1738,2067,1.0,0.15916787614900824,0.8408321238509918,890,0.4010643444605709,0.1683599419448476,0.4305757135945815
2200,2010195,1404,1040,914,26,364,1404,1.0,0.7407407407407407,0.25925925925925924,464,0.6509971509971509,0.018518518518518517,0.33048433048433046
2201,2010196,386,95,164,11,291,386,1.0,0.24611398963730569,0.7538860103626943,211,0.42487046632124353,0.02849740932642487,0.5466321243523317
2202,2010197,2644,2126,1553,27,518,2644,1.0,0.8040847201210287,0.19591527987897125,1064,0.5873676248108926,0.01021180030257186,0.40242057488653554
2203,2010198,766,610,294,3,156,766,1.0,0.7963446475195822,0.20365535248041775,469,0.3838120104438642,0.0039164490861618795,0.6122715404699739
2204,2010199,3811,174,545,2007,3637,3811,1.0,0.04565730779323012,0.9543426922067699,1259,0.14300708475465757,0.5266334295460509,0.3303594856992915
2205,2010200,4065,66,1110,1064,3999,4065,1.0,0.016236162361623615,0.9837638376383764,1891,0.2730627306273063,0.26174661746617467,0.4651906519065191
2206,2010201,791,595,337,11,196,791,1.0,0.7522123893805309,0.24778761061946902,443,0.42604298356510745,0.01390644753476612,0.5600505689001264
2207,2010202,1699,1041,794,14,658,1699,1.0,0.6127133608004709,0.38728663919952916,891,0.46733372572101234,0.00824014125956445,0.5244261330194232
2208,2010203,1253,205,318,91,1048,1253,1.0,0.1636073423782921,0.8363926576217079,844,0.25379090183559455,0.07262569832402235,0.6735833998403831
2209,2010204,4544,355,941,1420,4189,4544,1.0,0.078125,0.921875,2183,0.2070862676056338,0.3125,0.4804137323943662
2210,2010205,2235,1910,1027,17,325,2235,1.0,0.854586129753915,0.14541387024608501,1191,0.4595078299776286,0.007606263982102908,0.5328859060402684
2211,2010206,3601,129,854,410,3472,3601,1.0,0.0358233823937795,0.9641766176062205,2337,0.23715634545959455,0.11385726187170231,0.6489863926687032
2212,2010207,1083,7,419,273,1076,1083,1.0,0.006463527239150508,0.9935364727608494,391,0.38688827331486614,0.2520775623268698,0.3610341643582641
2213,2010208,2699,689,801,336,2010,2699,1.0,0.2552797332345313,0.7447202667654687,1562,0.29677658391997036,0.12449055205631715,0.5787328640237125
2215,2010210,2944,1693,1370,158,1251,2944,1.0,0.5750679347826086,0.4249320652173913,1416,0.46535326086956524,0.05366847826086957,0.48097826086956524
2216,2010211,3914,213,832,516,3701,3914,1.0,0.054420030659172204,0.9455799693408278,2566,0.21257026060296372,0.1318344404701073,0.655595298926929
2217,2010212,1611,176,421,93,1435,1611,1.0,0.10924891371818746,0.8907510862818125,1097,0.26132836747361887,0.05772811918063315,0.680943513345748
2218,2010213,3160,0,472,2033,3160,3160,1.0,0.0,1.0,655,0.14936708860759493,0.6433544303797468,0.20727848101265822
2219,2010214,1857,60,478,844,1797,1857,1.0,0.03231017770597738,0.9676898222940227,535,0.25740441572428646,0.4544964997307485,0.288099084544965
2220,2010215,2520,25,597,982,2495,2520,1.0,0.00992063492063492,0.9900793650793651,941,0.2369047619047619,0.3896825396825397,0.3734126984126984
2221,2010216,2615,1490,1001,78,1125,2615,1.0,0.5697896749521989,0.43021032504780116,1536,0.38279158699808796,0.02982791586998088,0.5873804971319312
2222,2010217,2489,130,633,1388,2359,2489,1.0,0.052229811169144234,0.9477701888308557,468,0.25431900361591,0.5576536761751707,0.18802732020891924
2223,2010218,3708,99,844,410,3609,3708,1.0,0.02669902912621359,0.9733009708737864,2454,0.22761596548004315,0.11057173678532901,0.6618122977346278
2224,2010219,2947,2065,1532,134,882,2947,1.0,0.7007125890736342,0.2992874109263658,1281,0.5198506956226672,0.045469969460468274,0.4346793349168646
2225,2010220,3579,0,266,757,3579,3579,1.0,0.0,1.0,2556,0.07432243643475832,0.21151159541771444,0.7141659681475272
2226,2010221,3492,47,691,567,3445,3492,1.0,0.013459335624284079,0.986540664375716,2234,0.19788087056128292,0.16237113402061856,0.6397479954180985
2227,2010222,3050,95,881,887,2955,3050,1.0,0.03114754098360656,0.9688524590163935,1282,0.28885245901639345,0.29081967213114757,0.42032786885245904
2228,2010223,5289,1116,1438,609,4173,5289,1.0,0.21100397050482134,0.7889960294951787,3242,0.27188504443183964,0.11514463981849121,0.6129703157496691
2229,2010224,2657,462,786,725,2195,2657,1.0,0.17388031614602936,0.8261196838539706,1146,0.2958223560406473,0.2728641324802409,0.4313135114791118
2230,2010225,6026,2723,1013,777,3303,6026,1.0,0.4518752074344507,0.5481247925655492,4236,0.1681048788582808,0.12894125456355793,0.7029538665781613
2231,2010226,3348,143,794,251,3205,3348,1.0,0.04271206690561529,0.9572879330943848,2303,0.23715651135005975,0.07497013142174433,0.687873357228196
2232,2010227,1684,0,289,1089,1684,1684,1.0,0.0,1.0,306,0.17161520190023752,0.6466745843230404,0.18171021377672208
2233,2010228,1180,916,705,30,264,1180,1.0,0.7762711864406779,0.22372881355932203,445,0.597457627118644,0.025423728813559324,0.3771186440677966
2234,2010229,1301,153,231,110,1148,1301,1.0,0.11760184473481937,0.8823981552651806,960,0.17755572636433511,0.08455034588777863,0.7378939277478862
2235,2010230,1124,751,543,14,373,1124,1.0,0.6681494661921709,0.3318505338078292,567,0.4830960854092527,0.012455516014234875,0.5044483985765125
2236,2010231,2845,167,752,243,2678,2845,1.0,0.05869947275922671,0.9413005272407733,1850,0.26432337434094905,0.08541300527240774,0.6502636203866432
2237,2010232,1779,53,497,708,1726,1779,1.0,0.029792017987633503,0.9702079820123665,574,0.2793704328274311,0.3979763912310287,0.3226531759415402
2238,2010233,5732,310,1310,1496,5422,5732,1.0,0.05408234473133287,0.9459176552686671,2926,0.22854152128401953,0.26099092812281927,0.5104675505931612
2239,2010234,4046,159,606,2327,3887,4046,1.0,0.03929807217004449,0.9607019278299556,1113,0.14977755808205634,0.5751359367276322,0.2750865051903114
2240,2010235,1450,1280,676,18,170,1450,1.0,0.8827586206896552,0.11724137931034483,756,0.46620689655172415,0.012413793103448275,0.5213793103448275
2241,2010236,2029,1467,1062,30,562,2029,1.0,0.7230162641695417,0.2769837358304584,937,0.523410547067521,0.014785608674223755,0.4618038442582553
2242,2010237,2318,1858,1198,17,460,2318,1.0,0.8015530629853321,0.1984469370146678,1103,0.5168248490077653,0.007333908541846419,0.4758412424503883
2243,2010238,2114,1786,1029,17,328,2114,1.0,0.8448438978240302,0.15515610217596973,1068,0.4867549668874172,0.00804162724692526,0.5052034058656575
2244,2010239,2013,1530,1074,26,483,2013,1.0,0.7600596125186289,0.2399403874813711,913,0.533532041728763,0.012916045702930949,0.453551912568306
2245,2010240,2994,2715,1515,13,279,2994,1.0,0.906813627254509,0.09318637274549098,1466,0.5060120240480962,0.004342017368069473,0.48964595858383436
2246,2010241,3040,45,526,409,2995,3040,1.0,0.014802631578947368,0.9851973684210527,2105,0.1730263157894737,0.13453947368421051,0.6924342105263158
2247,2010242,3230,163,290,376,3067,3230,1.0,0.050464396284829724,0.9495356037151703,2564,0.08978328173374613,0.11640866873065016,0.7938080495356037
2248,2010243,533,508,295,3,25,533,1.0,0.9530956848030019,0.04690431519699812,235,0.5534709193245778,0.005628517823639775,0.44090056285178236
2249,2010244,4215,960,794,920,3255,4215,1.0,0.2277580071174377,0.7722419928825622,2501,0.18837485172004745,0.21826809015421114,0.5933570581257414
2250,2010245,7261,1144,774,1699,6117,7261,1.0,0.1575540559151632,0.8424459440848368,4788,0.10659688748106322,0.23398980856631318,0.6594133039526237
2251,2010246,5211,816,701,1607,4395,5211,1.0,0.15659182498560736,0.8434081750143926,2903,0.13452312416042986,0.30838610631356744,0.5570907695260027
2252,2010247,1521,1204,791,19,317,1521,1.0,0.7915844838921762,0.2084155161078238,711,0.5200525969756739,0.012491781722550954,0.46745562130177515
2253,2010248,2723,355,573,198,2368,2723,1.0,0.1303709144326111,0.8696290855673889,1952,0.2104296731546089,0.07271391847227322,0.7168564083731179
2254,2010249,3899,660,444,1034,3239,3899,1.0,0.16927417286483715,0.8307258271351629,2421,0.1138753526545268,0.2651962041549115,0.6209284431905617
2255,2010250,903,697,529,14,206,903,1.0,0.7718715393133998,0.22812846068660023,360,0.5858250276854928,0.015503875968992248,0.39867109634551495
2256,2010251,2003,1255,1263,56,748,2003,1.0,0.6265601597603595,0.37343984023964055,684,0.6305541687468796,0.027958062905641536,0.3414877683474788
2257,2010252,2130,1850,1415,21,280,2130,1.0,0.8685446009389671,0.13145539906103287,694,0.6643192488262911,0.009859154929577466,0.32582159624413143
2258,2010253,2179,1753,1214,14,426,2179,1.0,0.8044974759063791,0.19550252409362093,951,0.55713630105553,0.006424965580541533,0.4364387333639284
2259,2010254,1952,373,364,123,1579,1952,1.0,0.1910860655737705,0.8089139344262295,1465,0.1864754098360656,0.0630122950819672,0.7505122950819673
2260,2010255,2769,727,927,836,2042,2769,1.0,0.2625496569158541,0.7374503430841459,1006,0.3347778981581798,0.30191404839292163,0.3633080534488985
2261,2010256,3883,120,1023,729,3763,3883,1.0,0.03090394025238218,0.9690960597476178,2131,0.26345609065155806,0.18774143703322174,0.5488024723152202
2262,2010257,6011,1777,1055,376,4234,6011,1.0,0.29562468807186826,0.7043753119281317,4580,0.17551156213608385,0.06255198802195974,0.7619364498419564
2263,2010258,3102,20,607,1825,3082,3102,1.0,0.006447453255963894,0.9935525467440361,670,0.1956802063185042,0.5883301096067054,0.21598968407479047
2264,2010259,1752,1508,1632,19,244,1752,1.0,0.860730593607306,0.13926940639269406,101,0.9315068493150684,0.010844748858447488,0.057648401826484015
2265,2010260,1719,170,314,376,1549,1719,1.0,0.09889470622454916,0.9011052937754508,1029,0.18266433973240256,0.21873182082606166,0.5986038394415357
2266,2010261,2322,177,370,162,2145,2322,1.0,0.07622739018087855,0.9237726098191215,1790,0.15934539190353145,0.06976744186046512,0.7708871662360034
2267,2010262,5135,406,894,1352,4729,5135,1.0,0.07906523855890944,0.9209347614410905,2889,0.17409931840311588,0.26329113924050634,0.5626095423563778
2268,2010263,4304,306,583,1881,3998,4304,1.0,0.07109665427509294,0.9289033457249071,1840,0.1354553903345725,0.4370353159851301,0.4275092936802974
2269,2010264,4208,463,648,869,3745,4208,1.0,0.11002851711026616,0.8899714828897338,2691,0.15399239543726237,0.20651140684410646,0.6394961977186312
2270,2010265,3549,144,608,1946,3405,3549,1.0,0.04057480980557904,0.959425190194421,995,0.17131586362355594,0.5483234714003945,0.2803606649760496
2271,2010266,2490,107,526,526,2383,2490,1.0,0.0429718875502008,0.9570281124497992,1438,0.21124497991967872,0.21124497991967872,0.5775100401606426
2272,2010267,1907,13,290,280,1894,1907,1.0,0.0068169900367068695,0.9931830099632931,1337,0.15207131620346093,0.14682747771368643,0.7011012060828526
2273,2010268,2537,84,610,1095,2453,2537,1.0,0.03310997240835633,0.9668900275916437,832,0.24044146629877808,0.4316121403232164,0.3279463933780055
2274,2010269,1956,56,286,1310,1900,1956,1.0,0.028629856850715747,0.9713701431492843,360,0.14621676891615543,0.6697341513292433,0.18404907975460122
2275,2010270,4647,1005,961,1205,3642,4647,1.0,0.21626856036152356,0.7837314396384765,2481,0.20680008607703895,0.2593070798364536,0.5338928340865075
2276,2010271,2758,2514,1624,13,244,2758,1.0,0.911530094271211,0.08846990572878898,1121,0.5888324873096447,0.004713560551124003,0.4064539521392313
2277,2010272,3129,650,660,404,2479,3129,1.0,0.20773410035155002,0.79226589964845,2065,0.2109300095877277,0.12911473314157879,0.6599552572706935
2278,2010273,2319,17,295,1455,2302,2319,1.0,0.007330746011211729,0.9926692539887882,569,0.12721000431220353,0.6274256144890039,0.24536438119879259
2279,2010274,2586,152,416,967,2434,2586,1.0,0.05877803557617943,0.9412219644238206,1203,0.1608662026295437,0.3739365815931941,0.4651972157772622
2280,2010275,3015,1746,799,164,1269,3015,1.0,0.5791044776119403,0.4208955223880597,2052,0.2650082918739635,0.05439469320066335,0.6805970149253732
2281,2010276,2463,2187,1492,12,276,2463,1.0,0.8879415347137637,0.1120584652862363,959,0.6057653268371904,0.0048721071863581,0.38936256597645147
2282,2010277,2982,178,391,353,2804,2982,1.0,0.059691482226693494,0.9403085177733065,2238,0.1311200536552649,0.11837692823608316,0.7505030181086519
2283,2010278,3541,57,591,726,3484,3541,1.0,0.016097147698390286,0.9839028523016097,2224,0.1669020050833098,0.2050268285794973,0.6280711663371928
2284,2010279,3129,102,318,582,3027,3129,1.0,0.032598274209012464,0.9674017257909875,2229,0.10162991371045062,0.1860019175455417,0.7123681687440077
2285,2010280,2416,308,395,243,2108,2416,1.0,0.12748344370860928,0.8725165562913907,1778,0.1634933774834437,0.1005794701986755,0.7359271523178808
2286,2010281,2114,42,868,1065,2072,2114,1.0,0.019867549668874173,0.9801324503311258,181,0.4105960264900662,0.5037842951750237,0.08561967833491012
2287,2010282,2697,632,481,765,2065,2697,1.0,0.2343344456803856,0.7656655543196144,1451,0.17834631071560994,0.2836484983314794,0.5380051909529107
2288,2010284,5308,1176,1293,766,4132,5308,1.0,0.2215523737754333,0.7784476262245666,3249,0.24359457422758102,0.14431047475508665,0.6120949510173324
2289,2010285,2896,1815,1358,104,1081,2896,1.0,0.6267265193370166,0.37327348066298344,1434,0.46892265193370164,0.03591160220994475,0.4951657458563536
2290,2010286,4334,2281,1834,175,2053,4334,1.0,0.5263036455929857,0.4736963544070143,2325,0.4231656668204892,0.04037840332256576,0.5364559298569451
2291,2010287,1828,175,513,640,1653,1828,1.0,0.09573304157549234,0.9042669584245077,675,0.28063457330415753,0.350109409190372,0.36925601750547044
2292,2010288,1782,1624,1377,17,158,1782,1.0,0.9113355780022446,0.08866442199775533,388,0.7727272727272727,0.009539842873176206,0.21773288439955107
2293,2010289,1520,91,413,333,1429,1520,1.0,0.05986842105263158,0.9401315789473684,774,0.27171052631578946,0.21907894736842104,0.5092105263157894
2294,2010290,2014,84,206,778,1930,2014,1.0,0.041708043694141016,0.958291956305859,1030,0.10228401191658391,0.38629592850049654,0.5114200595829196
2295,2010291,1395,205,405,419,1190,1395,1.0,0.14695340501792115,0.8530465949820788,571,0.2903225806451613,0.3003584229390681,0.40931899641577063
2296,2010292,1754,560,608,93,1194,1754,1.0,0.31927023945267957,0.6807297605473204,1053,0.346636259977195,0.053021664766248575,0.6003420752565565
2297,2010293,1964,329,604,527,1635,1964,1.0,0.1675152749490835,0.8324847250509165,833,0.3075356415478615,0.2683299389002037,0.4241344195519348
2298,2010294,2053,1948,1258,12,105,2053,1.0,0.9488553336580614,0.05114466634193863,783,0.6127618119824647,0.0058451047247929854,0.38139308329274235
2299,2010295,656,609,485,6,47,656,1.0,0.9283536585365854,0.07164634146341463,165,0.739329268292683,0.009146341463414634,0.25152439024390244
2300,2010296,1898,59,398,599,1839,1898,1.0,0.03108535300316122,0.9689146469968388,901,0.20969441517386722,0.315595363540569,0.4747102212855637
2301,2010297,2279,403,611,386,1876,2279,1.0,0.17683194383501535,0.8231680561649847,1282,0.26810004387889425,0.16937253181219833,0.5625274243089075
2302,2010298,2605,507,548,735,2098,2605,1.0,0.19462571976967372,0.8053742802303263,1322,0.21036468330134356,0.2821497120921305,0.5074856046065259
2303,2010299,2203,151,348,171,2052,2203,1.0,0.06854289605083977,0.9314571039491603,1684,0.15796640944167045,0.07762142532909669,0.7644121652292328
2304,2010300,5010,144,722,2752,4866,5010,1.0,0.02874251497005988,0.9712574850299401,1536,0.1441117764471058,0.5493013972055888,0.3065868263473054
2305,2010301,3009,0,639,428,3009,3009,1.0,0.0,1.0,1942,0.2123629112662014,0.1422399468261881,0.6453971419076105
2306,2010302,4009,21,656,875,3988,4009,1.0,0.005238214018458469,0.9947617859815415,2478,0.16363182838613122,0.21825891743576953,0.6181092541780993
2307,2010303,3080,58,434,2052,3022,3080,1.0,0.01883116883116883,0.9811688311688311,594,0.1409090909090909,0.6662337662337663,0.19285714285714287
2308,2010304,2033,82,638,939,1951,2033,1.0,0.04033448106246926,0.9596655189375307,456,0.31382193802262665,0.4618789965568126,0.22429906542056074
2309,2010305,6470,2350,1307,795,4120,6470,1.0,0.36321483771251933,0.6367851622874807,4368,0.20200927357032458,0.12287480680061824,0.6751159196290571
2310,2010306,1771,65,327,988,1706,1771,1.0,0.03670242800677583,0.9632975719932242,456,0.18464144551101072,0.5578769057029926,0.2574816487859966
2311,2010307,3127,104,576,1474,3023,3127,1.0,0.033258714422769425,0.9667412855772306,1077,0.18420211064918451,0.471378317876559,0.3444195714742565
2312,2010308,1845,333,464,197,1512,1845,1.0,0.18048780487804877,0.8195121951219512,1184,0.25149051490514907,0.10677506775067751,0.6417344173441735
2313,2010309,3266,14,454,2129,3252,3266,1.0,0.004286589099816289,0.9957134109001837,683,0.13900796080832822,0.651867728107777,0.20912431108389468
2314,2010310,1681,134,298,643,1547,1681,1.0,0.07971445568114217,0.9202855443188578,740,0.17727543129089826,0.3825104104699584,0.4402141582391434
2315,2010311,3934,576,807,742,3358,3934,1.0,0.14641586171835283,0.8535841382816471,2385,0.20513472292831725,0.18861209964412812,0.6062531774275547
2316,2010312,5109,1066,982,1286,4043,5109,1.0,0.20865139949109415,0.7913486005089059,2841,0.19220982579761206,0.2517126639264044,0.5560775102759835
2317,2010313,70,4,9,14,66,70,1.0,0.05714285714285714,0.9428571428571428,47,0.12857142857142856,0.2,0.6714285714285714
2318,2010314,5892,1215,1257,2058,4677,5892,1.0,0.20621181262729124,0.7937881873727087,2577,0.21334012219959267,0.34928716904276985,0.43737270875763745
2319,2010315,1379,60,445,713,1319,1379,1.0,0.043509789702683106,0.9564902102973168,221,0.32269760696156635,0.5170413343002176,0.1602610587382161
2320,2010316,1720,111,444,617,1609,1720,1.0,0.06453488372093023,0.9354651162790698,659,0.25813953488372093,0.35872093023255813,0.38313953488372093
2321,2010317,2138,1182,605,266,956,2138,1.0,0.5528531337698784,0.4471468662301216,1267,0.2829747427502339,0.1244153414405987,0.5926099158091674
2322,2010318,5394,3619,2174,95,1775,5394,1.0,0.6709306637004079,0.3290693362995921,3125,0.40304041527623286,0.017612161661104932,0.5793474230626622
2323,2010319,2545,1610,1146,87,935,2545,1.0,0.6326129666011788,0.36738703339882123,1312,0.45029469548133594,0.03418467583497053,0.5155206286836935
2324,2010320,1925,144,380,354,1781,1925,1.0,0.0748051948051948,0.9251948051948052,1191,0.1974025974025974,0.1838961038961039,0.6187012987012988
2325,2010321,2546,0,558,315,2546,2546,1.0,0.0,1.0,1673,0.21916732128829536,0.1237234878240377,0.657109190887667
2326,2010322,2005,863,459,162,1142,2005,1.0,0.4304239401496259,0.5695760598503741,1384,0.228927680798005,0.08079800498753117,0.6902743142144638
2327,2010323,2175,520,429,351,1655,2175,1.0,0.23908045977011494,0.7609195402298851,1395,0.19724137931034483,0.16137931034482758,0.6413793103448275
2328,2010324,2507,214,607,1224,2293,2507,1.0,0.08536098923015556,0.9146390107698444,676,0.24212205823693658,0.4882329477463103,0.26964499401675307
2329,2010325,2527,851,737,224,1676,2527,1.0,0.33676296003165807,0.6632370399683419,1566,0.29165017807677085,0.0886426592797784,0.6197071626434507
2330,2010326,707,16,164,152,691,707,1.0,0.02263083451202263,0.9773691654879774,391,0.23196605374823195,0.214992927864215,0.553041018387553
2331,2010327,1762,1614,938,12,148,1762,1.0,0.9160045402951191,0.08399545970488081,812,0.5323496027241771,0.00681044267877412,0.4608399545970488
2332,2010328,3336,435,355,240,2901,3336,1.0,0.1303956834532374,0.8696043165467626,2741,0.10641486810551559,0.07194244604316546,0.8216426858513189
2333,2010329,2589,400,453,230,2189,2589,1.0,0.1544998068752414,0.8455001931247585,1906,0.1749710312862109,0.0888373889532638,0.7361915797605253
2334,2010330,2805,362,483,451,2443,2805,1.0,0.12905525846702318,0.8709447415329769,1871,0.17219251336898395,0.1607843137254902,0.6670231729055258
2335,2010331,2116,377,96,378,1739,2116,1.0,0.1781663516068053,0.8218336483931947,1642,0.045368620037807186,0.1786389413988658,0.775992438563327
2336,2010332,3974,1433,1478,137,2541,3974,1.0,0.3605938600905888,0.6394061399094112,2359,0.3719174635128334,0.03447408152994464,0.5936084549572219
2337,2010333,3932,250,476,1422,3682,3932,1.0,0.06358087487283826,0.9364191251271617,2034,0.12105798575788403,0.36164801627670395,0.517293997965412
2338,2010334,1328,805,285,76,523,1328,1.0,0.6061746987951807,0.3938253012048193,967,0.21460843373493976,0.0572289156626506,0.7281626506024096
2339,2010335,2386,591,444,186,1795,2386,1.0,0.2476948868398994,0.7523051131601006,1756,0.18608549874266556,0.07795473595976529,0.7359597652975691
2340,2010336,6156,3908,2182,201,2248,6156,1.0,0.6348278102664068,0.3651721897335932,3773,0.3544509421702404,0.032651072124756333,0.6128979857050032
2341,2010337,1910,624,417,92,1286,1910,1.0,0.3267015706806283,0.6732984293193718,1401,0.21832460732984293,0.048167539267015703,0.7335078534031414
2342,2010338,6510,1879,1628,670,4631,6510,1.0,0.28863287250384023,0.7113671274961597,4212,0.2500768049155146,0.10291858678955453,0.6470046082949309
2343,2010339,2106,258,543,169,1848,2106,1.0,0.1225071225071225,0.8774928774928775,1394,0.25783475783475784,0.08024691358024691,0.6619183285849952
2344,2010340,4360,179,594,1940,4181,4360,1.0,0.041055045871559635,0.9589449541284404,1826,0.13623853211009174,0.44495412844036697,0.4188073394495413
2345,2010341,1590,280,406,139,1310,1590,1.0,0.1761006289308176,0.8238993710691824,1045,0.25534591194968553,0.08742138364779874,0.6572327044025157
2346,2010342,1421,574,443,68,847,1421,1.0,0.4039408866995074,0.5960591133004927,910,0.31175228712174524,0.04785362420830401,0.6403940886699507
2347,2010343,2868,114,637,251,2754,2868,1.0,0.0397489539748954,0.9602510460251046,1980,0.22210599721059973,0.08751743375174338,0.6903765690376569
2348,2010344,1212,767,605,22,445,1212,1.0,0.6328382838283828,0.36716171617161714,585,0.4991749174917492,0.018151815181518153,0.48267326732673266
2349,2010345,2849,1029,595,167,1820,2849,1.0,0.36117936117936117,0.6388206388206388,2087,0.20884520884520885,0.05861705861705862,0.7325377325377326
2350,2010346,4,0,0,3,4,4,1.0,0.0,1.0,1,0.0,0.75,0.25
2351,2010347,3961,86,659,1156,3875,3961,1.0,0.021711688967432467,0.9782883110325675,2146,0.16637212825044181,0.2918454935622318,0.5417823781873264
2352,2010348,3275,159,264,745,3116,3275,1.0,0.04854961832061069,0.9514503816793893,2266,0.08061068702290076,0.22748091603053436,0.6919083969465649
2353,2010349,1819,208,305,480,1611,1819,1.0,0.11434854315557999,0.88565145684442,1034,0.16767454645409566,0.2638812534359538,0.5684442001099506
2354,2010350,4349,389,1065,782,3960,4349,1.0,0.08944584962060244,0.9105541503793976,2502,0.24488388135203495,0.17981145090825476,0.5753046677397102
2355,2010351,5276,240,609,2632,5036,5276,1.0,0.045489006823351025,0.954510993176649,2035,0.11542835481425322,0.4988627748294162,0.38570887035633056
2356,2010352,6277,221,576,1760,6056,6277,1.0,0.035207901863947746,0.9647920981360523,3941,0.0917635813286602,0.2803887207264617,0.6278476979448782
2357,2010353,5500,2211,1890,421,3289,5500,1.0,0.402,0.598,3189,0.34363636363636363,0.07654545454545454,0.5798181818181818
2358,2010354,4720,2609,1468,484,2111,4720,1.0,0.5527542372881356,0.4472457627118644,2768,0.31101694915254235,0.10254237288135593,0.5864406779661017
2359,2010355,1975,1497,888,85,478,1975,1.0,0.7579746835443038,0.2420253164556962,1002,0.44962025316455695,0.043037974683544304,0.5073417721518987
2360,2010356,3907,699,762,1184,3208,3907,1.0,0.1789096493473253,0.8210903506526747,1961,0.1950345533657538,0.30304581520348095,0.5019196314307653
2361,2010357,3786,100,543,1734,3686,3786,1.0,0.02641310089804543,0.9735868991019546,1509,0.1434231378763867,0.45800316957210774,0.39857369255150554
2362,2010358,4461,2581,1106,80,1880,4461,1.0,0.5785698273929613,0.4214301726070388,3275,0.2479264738847792,0.017933198834342075,0.7341403272808787
2363,2010359,5289,2721,1080,88,2568,5289,1.0,0.5144639818491208,0.48553601815087916,4121,0.2041973908111174,0.0166383059179429,0.7791643032709397
2364,2010360,3565,159,865,1077,3406,3565,1.0,0.044600280504908836,0.9553997194950912,1623,0.2426367461430575,0.30210378681626926,0.4552594670406732
2365,2010361,2273,440,639,137,1833,2273,1.0,0.1935767707875055,0.8064232292124945,1497,0.28112626484821823,0.06027276726792785,0.6586009678838539
2366,2010362,5267,117,835,2437,5150,5267,1.0,0.02221378393772546,0.9777862160622746,1995,0.15853426998291248,0.46269223466869186,0.37877349534839566
2367,2010363,8069,3666,1085,909,4403,8069,1.0,0.45433139174618914,0.5456686082538109,6075,0.1344652373280456,0.11265336472921056,0.7528813979427438
2368,2010364,3803,639,683,790,3164,3803,1.0,0.1680252432290297,0.8319747567709703,2330,0.179595056534315,0.20773073889034974,0.6126742045753353
2369,2010365,1190,948,881,81,242,1190,1.0,0.7966386554621848,0.20336134453781513,228,0.7403361344537815,0.0680672268907563,0.1915966386554622
2370,2010366,4258,1289,835,243,2969,4258,1.0,0.3027242837012682,0.6972757162987318,3180,0.1961014560826679,0.05706904650070456,0.7468294974166275
2371,2010367,1422,417,427,95,1005,1422,1.0,0.29324894514767935,0.7067510548523207,900,0.30028129395218,0.06680731364275667,0.6329113924050633
2372,2010368,1037,432,398,154,605,1037,1.0,0.4165863066538091,0.583413693346191,485,0.3837994214079074,0.1485053037608486,0.46769527483124396
2373,2010369,389,143,96,60,246,389,1.0,0.3676092544987147,0.6323907455012854,233,0.2467866323907455,0.15424164524421594,0.5989717223650386
2374,2010370,5383,542,649,2275,4841,5383,1.0,0.10068734906186141,0.8993126509381386,2459,0.12056474085082668,0.4226267880364109,0.4568084711127624
2375,2010371,666,593,287,5,73,666,1.0,0.8903903903903904,0.10960960960960961,374,0.43093093093093093,0.0075075075075075074,0.5615615615615616
2376,2010372,1418,907,631,88,511,1418,1.0,0.6396332863187588,0.3603667136812412,699,0.44499294781382226,0.06205923836389281,0.4929478138222849
2377,2010373,138,15,74,2,123,138,1.0,0.10869565217391304,0.8913043478260869,62,0.5362318840579711,0.014492753623188406,0.4492753623188406
2378,2010374,1195,397,212,103,798,1195,1.0,0.3322175732217573,0.6677824267782427,880,0.1774058577405858,0.08619246861924686,0.7364016736401674
2379,2010375,4171,133,588,488,4038,4171,1.0,0.03188683768880365,0.9681131623111964,3095,0.1409733876768161,0.1169983217453848,0.7420282905777991
2380,2010376,3126,794,514,426,2332,3126,1.0,0.25399872040946897,0.746001279590531,2186,0.16442738323736406,0.1362763915547025,0.6992962252079334
2381,2010377,3780,150,384,1336,3630,3780,1.0,0.03968253968253968,0.9603174603174603,2060,0.10158730158730159,0.35343915343915344,0.544973544973545
2382,2010378,2520,57,373,674,2463,2520,1.0,0.02261904761904762,0.9773809523809524,1473,0.14801587301587302,0.26746031746031745,0.5845238095238096
2383,2010379,2183,1250,1018,96,933,2183,1.0,0.5726065048098946,0.42739349519010533,1069,0.4663307375171782,0.043976179569399906,0.4896930829134219
2384,2010380,5913,1496,959,1366,4417,5913,1.0,0.25300186030779637,0.7469981396922036,3588,0.1621850160662946,0.23101640453238625,0.6067985794013191
2385,2010381,4554,689,757,585,3865,4554,1.0,0.1512955643390426,0.8487044356609574,3212,0.16622749231444883,0.12845849802371542,0.7053140096618358
2386,2010382,1560,215,127,362,1345,1560,1.0,0.13782051282051283,0.8621794871794872,1071,0.08141025641025641,0.23205128205128206,0.6865384615384615
2387,2010383,2826,890,731,333,1936,2826,1.0,0.31493276716206653,0.6850672328379335,1762,0.2586694975230007,0.1178343949044586,0.6234961075725407
2388,2010384,3084,2027,1297,354,1057,3084,1.0,0.6572632944228275,0.3427367055771725,1433,0.42055771725032426,0.11478599221789883,0.4646562905317769
2389,2010385,2202,0,362,1324,2202,2202,1.0,0.0,1.0,516,0.16439600363306087,0.6012715712988193,0.23433242506811988
2390,2010386,3894,524,481,1406,3370,3894,1.0,0.13456599897277863,0.8654340010272213,2007,0.12352336928608115,0.3610683102208526,0.5154083204930663
2391,2010387,5754,588,556,1558,5166,5754,1.0,0.10218978102189781,0.8978102189781022,3640,0.09662843239485576,0.2707681612791102,0.6326034063260341
2392,2010388,6714,1789,1314,1799,4925,6714,1.0,0.2664581471551981,0.7335418528448019,3601,0.19571045576407506,0.26794757223711646,0.5363419719988085
2393,2010389,3757,1279,437,77,2478,3757,1.0,0.3404311951024754,0.6595688048975247,3243,0.11631620974181528,0.020495075858397657,0.8631887143997871
2394,2010390,4229,1645,883,110,2584,4229,1.0,0.3889808465358241,0.6110191534641759,3236,0.2087964057696855,0.026010877275951763,0.7651927169543628
2395,2010391,2509,120,405,770,2389,2509,1.0,0.047827819848545235,0.9521721801514548,1334,0.16141889198884019,0.30689517736149863,0.5316859306496612
2396,2010392,1463,1320,914,6,143,1463,1.0,0.9022556390977443,0.09774436090225563,543,0.6247436773752563,0.004101161995898838,0.37115516062884485
2397,2010393,2251,355,348,291,1896,2251,1.0,0.15770768547312305,0.8422923145268769,1612,0.15459795646379387,0.12927587738782764,0.7161261661483785
2398,2010394,1525,0,182,144,1525,1525,1.0,0.0,1.0,1199,0.11934426229508197,0.09442622950819672,0.7862295081967213
2399,2010395,1662,85,378,908,1577,1662,1.0,0.05114320096269555,0.9488567990373045,376,0.22743682310469315,0.54632972322503,0.22623345367027678
2400,2010396,1909,1792,1339,16,117,1909,1.0,0.9387113672079623,0.061288632792037716,554,0.7014143530644317,0.008381351492928235,0.29020429544264015
2401,2010397,1095,65,171,125,1030,1095,1.0,0.0593607305936073,0.9406392694063926,799,0.15616438356164383,0.1141552511415525,0.7296803652968037
2402,2010398,5036,756,1117,1110,4280,5036,1.0,0.15011914217633043,0.8498808578236696,2809,0.22180301826846704,0.22041302621127878,0.5577839555202542
2403,2010399,5225,2005,740,726,3220,5225,1.0,0.3837320574162679,0.6162679425837321,3759,0.1416267942583732,0.13894736842105262,0.7194258373205742
2404,2010400,2432,95,420,1116,2337,2432,1.0,0.0390625,0.9609375,896,0.17269736842105263,0.4588815789473684,0.3684210526315789
2405,2010401,2065,1409,948,35,656,2065,1.0,0.6823244552058111,0.31767554479418886,1082,0.45907990314769975,0.01694915254237288,0.5239709443099274
2406,2010402,2665,2061,1061,46,604,2665,1.0,0.7733583489681051,0.22664165103189493,1558,0.3981238273921201,0.01726078799249531,0.5846153846153846
2407,2010403,1357,21,531,754,1336,1357,1.0,0.015475313190862197,0.9845246868091379,72,0.391304347826087,0.5556374355195284,0.05305821665438467
2408,2010404,4065,113,589,693,3952,4065,1.0,0.02779827798277983,0.9722017220172202,2783,0.14489544895448955,0.17047970479704797,0.6846248462484625
2409,2010405,636,30,65,274,606,636,1.0,0.04716981132075472,0.9528301886792453,297,0.10220125786163523,0.4308176100628931,0.4669811320754717
2410,2010406,810,810,343,4,0,810,1.0,1.0,0.0,463,0.42345679012345677,0.0049382716049382715,0.571604938271605
2411,2010407,4984,251,769,1474,4733,4984,1.0,0.05036115569823435,0.9496388443017657,2741,0.15429373996789728,0.29574638844301765,0.5499598715890851
2412,2010408,1915,125,337,264,1790,1915,1.0,0.06527415143603134,0.9347258485639687,1314,0.17597911227154048,0.13785900783289817,0.6861618798955613
2413,2010409,2113,82,357,177,2031,2113,1.0,0.03880738286796025,0.9611926171320397,1579,0.1689540937056318,0.08376715570279224,0.747278750591576
2414,2010410,1100,524,352,84,576,1100,1.0,0.4763636363636364,0.5236363636363637,664,0.32,0.07636363636363637,0.6036363636363636
2415,2010411,2680,125,666,307,2555,2680,1.0,0.04664179104477612,0.9533582089552238,1707,0.24850746268656718,0.11455223880597015,0.6369402985074627
2416,2010412,387,108,248,12,279,387,1.0,0.27906976744186046,0.7209302325581395,127,0.6408268733850129,0.031007751937984496,0.3281653746770026
2417,2010413,3966,1344,1162,815,2622,3966,1.0,0.3388804841149773,0.6611195158850227,1989,0.2929904185577408,0.2054967221381745,0.5015128593040847
2418,2010414,4853,377,488,1508,4476,4853,1.0,0.07768390686173501,0.922316093138265,2857,0.10055635689264372,0.31073562744694005,0.5887080156604162
2419,2010415,2115,45,449,1100,2070,2115,1.0,0.02127659574468085,0.9787234042553191,566,0.21229314420803783,0.5200945626477541,0.26761229314420804
2420,2010416,6968,1259,946,1085,5709,6968,1.0,0.18068312284730195,0.8193168771526981,4937,0.13576349024110218,0.15571182548794488,0.7085246842709529
2421,2010417,2798,520,716,645,2278,2798,1.0,0.18584703359542531,0.8141529664045747,1437,0.2558970693352395,0.2305218012866333,0.5135811293781273
2422,2010418,6126,1956,1082,687,4170,6126,1.0,0.31929480901077373,0.6807051909892262,4357,0.17662422461638916,0.11214495592556317,0.7112308194580477
2423,2010419,3339,105,508,1036,3234,3339,1.0,0.031446540880503145,0.9685534591194969,1795,0.1521413596885295,0.31027253668763105,0.5375861036238395
2424,2010420,5920,21,486,2715,5899,5920,1.0,0.0035472972972972975,0.9964527027027027,2719,0.08209459459459459,0.45861486486486486,0.4592905405405405
2425,2010421,3242,820,535,758,2422,3242,1.0,0.2529302899444787,0.7470697100555213,1949,0.1650215916101172,0.2338062924120913,0.6011721159777915
2426,2010422,3663,3474,1976,34,189,3663,1.0,0.9484029484029484,0.051597051597051594,1653,0.5394485394485394,0.009282009282009281,0.4512694512694513
2427,2010423,2153,149,529,248,2004,2153,1.0,0.06920575940548072,0.9307942405945193,1376,0.24570366929865303,0.11518810961449141,0.6391082210868555
2428,2010424,1330,286,237,338,1044,1330,1.0,0.21503759398496242,0.7849624060150376,755,0.17819548872180452,0.25413533834586466,0.5676691729323309
2429,2010425,919,135,300,141,784,919,1.0,0.14689880304678998,0.85310119695321,478,0.3264417845484222,0.15342763873775844,0.5201305767138193
2430,2010426,1247,145,289,379,1102,1247,1.0,0.11627906976744186,0.8837209302325582,579,0.23175621491579793,0.30392943063352046,0.46431435445068164
2431,2010427,1466,365,348,206,1101,1466,1.0,0.2489768076398363,0.7510231923601637,912,0.2373806275579809,0.14051841746248295,0.6221009549795361
2432,2010428,7032,1361,1570,704,5671,7032,1.0,0.19354379977246872,0.8064562002275313,4758,0.2232650739476678,0.10011376564277588,0.6766211604095563
2433,2010429,4533,1990,1239,308,2543,4533,1.0,0.43900286785793075,0.5609971321420693,2986,0.27332892124420916,0.06794617251268475,0.6587249062431061
2434,2010430,2150,565,566,137,1585,2150,1.0,0.2627906976744186,0.7372093023255814,1447,0.26325581395348835,0.06372093023255813,0.6730232558139535
2435,2010431,5064,1334,1043,355,3730,5064,1.0,0.26342812006319116,0.7365718799368088,3666,0.20596366508688785,0.07010268562401265,0.7239336492890995
2436,2010432,1957,312,407,161,1645,1957,1.0,0.1594276954522228,0.8405723045477772,1389,0.20797138477261115,0.08226877874297393,0.7097598364844149
2437,2010433,562,242,191,42,320,562,1.0,0.4306049822064057,0.5693950177935944,329,0.3398576512455516,0.07473309608540925,0.5854092526690391
2438,2010434,1824,9,319,657,1815,1824,1.0,0.004934210526315789,0.9950657894736842,848,0.17489035087719298,0.36019736842105265,0.4649122807017544
2439,2010435,3799,185,716,1515,3614,3799,1.0,0.04869702553303501,0.951302974466965,1568,0.18847065017109765,0.3987891550408002,0.41274019478810214
2440,2010436,4060,266,950,1581,3794,4060,1.0,0.06551724137931035,0.9344827586206896,1529,0.23399014778325122,0.3894088669950739,0.3766009852216749
2441,2010437,1890,127,409,1055,1763,1890,1.0,0.0671957671957672,0.9328042328042329,426,0.2164021164021164,0.5582010582010583,0.2253968253968254
2442,2010438,3647,31,705,2065,3616,3647,1.0,0.008500137098985467,0.9914998629010146,877,0.19330956950918562,0.5662188099808061,0.24047162051000823
2443,2010439,3522,55,625,1749,3467,3522,1.0,0.015616127200454287,0.9843838727995458,1148,0.17745599091425326,0.49659284497444633,0.3259511641113004
2444,2010440,2562,3,378,1795,2559,2562,1.0,0.00117096018735363,0.9988290398126464,389,0.14754098360655737,0.7006245120999219,0.1518345042935207
2445,2010441,1520,35,282,905,1485,1520,1.0,0.023026315789473683,0.9769736842105263,333,0.18552631578947368,0.5953947368421053,0.21907894736842104
2446,2010442,4146,156,444,2577,3990,4146,1.0,0.03762662807525326,0.9623733719247467,1125,0.10709117221418235,0.6215629522431259,0.27134587554269174
2447,2010443,663,0,113,353,663,663,1.0,0.0,1.0,197,0.17043740573152338,0.5324283559577677,0.2971342383107089
2448,2010444,4063,266,729,1221,3797,4063,1.0,0.06546886537041595,0.934531134629584,2113,0.17942407088358356,0.30051685946345064,0.5200590696529658
2449,2010445,2339,224,462,813,2115,2339,1.0,0.09576742197520308,0.904232578024797,1064,0.19752030782385635,0.347584437793929,0.4548952543822146
2450,2010446,681,80,69,46,601,681,1.0,0.11747430249632893,0.882525697503671,566,0.1013215859030837,0.06754772393538913,0.8311306901615272
2451,2010447,3094,572,516,792,2522,3094,1.0,0.18487394957983194,0.8151260504201681,1786,0.1667744020685197,0.2559793148028442,0.577246283128636
2452,2010448,3396,58,813,1260,3338,3396,1.0,0.01707891637220259,0.9829210836277974,1323,0.2393992932862191,0.3710247349823322,0.38957597173144876
2453,2010449,317,149,85,11,168,317,1.0,0.47003154574132494,0.5299684542586751,221,0.26813880126182965,0.03470031545741325,0.6971608832807571
2454,2010450,3719,1573,1009,347,2146,3719,1.0,0.42296316214036034,0.5770368378596397,2363,0.27130949179887065,0.09330465178811509,0.6353858564130143
2455,2010451,2907,171,333,1713,2736,2907,1.0,0.058823529411764705,0.9411764705882353,861,0.11455108359133127,0.5892672858617131,0.2961816305469556
2456,2010452,5904,662,403,1310,5242,5904,1.0,0.11212737127371274,0.8878726287262872,4191,0.06825880758807588,0.22188346883468835,0.7098577235772358
2457,2010453,2448,658,652,346,1790,2448,1.0,0.2687908496732026,0.7312091503267973,1450,0.26633986928104575,0.14133986928104575,0.5923202614379085
2458,2010454,2288,2207,1505,8,81,2288,1.0,0.9645979020979021,0.035402097902097904,775,0.6577797202797203,0.0034965034965034965,0.3387237762237762
2459,2010455,1806,1197,920,27,609,1806,1.0,0.6627906976744186,0.3372093023255814,859,0.5094130675526024,0.014950166112956811,0.47563676633444074
2460,2010456,5628,1098,801,1020,4530,5628,1.0,0.19509594882729211,0.8049040511727079,3807,0.14232409381663114,0.1812366737739872,0.6764392324093816
2462,2010458,2390,1460,1113,51,930,2390,1.0,0.6108786610878661,0.3891213389121339,1226,0.46569037656903767,0.021338912133891212,0.5129707112970712
2463,2010459,3351,53,533,2236,3298,3351,1.0,0.015816174276335422,0.9841838257236646,582,0.15905699791107134,0.6672635034318114,0.17367949865711726
2464,2010460,4400,1467,1108,414,2933,4400,1.0,0.33340909090909093,0.6665909090909091,2878,0.25181818181818183,0.09409090909090909,0.6540909090909091
2465,2010461,3885,200,865,1866,3685,3885,1.0,0.05148005148005148,0.9485199485199485,1154,0.22265122265122264,0.4803088803088803,0.297039897039897
2466,2010462,4174,1552,1354,789,2622,4174,1.0,0.3718255869669382,0.6281744130330618,2031,0.3243890752275994,0.18902731193100145,0.4865836128413991
2467,2010463,5794,2145,1021,710,3649,5794,1.0,0.3702105626510183,0.6297894373489817,4063,0.1762167759751467,0.12254055919917156,0.7012426648256818
2468,2010464,2698,40,393,967,2658,2698,1.0,0.014825796886582653,0.9851742031134173,1338,0.14566345441067458,0.35841363973313567,0.49592290585618976
2469,2010465,4039,1020,1008,1114,3019,4039,1.0,0.2525377568705125,0.7474622431294875,1917,0.24956672443674177,0.27581084426838326,0.47462243129487497
2470,2010466,4834,1119,1172,1559,3715,4834,1.0,0.2314853123707075,0.7685146876292925,2103,0.24244931733553993,0.32250724038063716,0.4350434422838229
2471,2010467,1376,554,518,180,822,1376,1.0,0.40261627906976744,0.5973837209302325,678,0.376453488372093,0.1308139534883721,0.49273255813953487
2472,2010468,5747,1295,1261,499,4452,5747,1.0,0.22533495736906212,0.7746650426309378,3987,0.21941882721419873,0.08682791021402471,0.6937532625717766
2473,2010469,3079,100,330,1348,2979,3079,1.0,0.03247807729782397,0.9675219227021761,1401,0.1071776550828191,0.4378044819746671,0.4550178629425138
2474,2010470,2278,3,198,545,2275,2278,1.0,0.0013169446883230904,0.9986830553116769,1535,0.08691834942932397,0.2392449517120281,0.6738366988586479
2475,2010471,3200,0,255,1095,3200,3200,1.0,0.0,1.0,1850,0.0796875,0.3421875,0.578125
2476,2010472,1253,53,368,326,1200,1253,1.0,0.04229848363926576,0.9577015163607342,559,0.2936951316839585,0.2601755786113328,0.4461292897047087
2477,2010473,1812,25,369,953,1787,1812,1.0,0.01379690949227373,0.9862030905077263,490,0.20364238410596028,0.5259381898454746,0.2704194260485651
2478,2010474,4101,142,517,1334,3959,4101,1.0,0.03462570104852475,0.9653742989514752,2250,0.12606681297244574,0.32528651548402826,0.548646671543526
2479,2010475,2292,451,504,431,1841,2292,1.0,0.1967713787085515,0.8032286212914486,1357,0.2198952879581152,0.1880453752181501,0.5920593368237347
2480,2010476,3403,597,584,844,2806,3403,1.0,0.17543344108139877,0.8245665589186012,1975,0.17161328239788423,0.24801645606817513,0.5803702615339407
2481,2010477,3918,462,510,1644,3456,3918,1.0,0.11791730474732007,0.8820826952526799,1764,0.13016845329249618,0.41960183767228176,0.450229709035222
2482,2010478,5923,1363,920,1863,4560,5923,1.0,0.23011987168664527,0.7698801283133547,3140,0.15532669255444875,0.31453655242275874,0.5301367550227924
2483,2010479,4327,473,637,1834,3854,4327,1.0,0.10931361220244973,0.8906863877975503,1856,0.14721516061936676,0.42385024266235266,0.42893459671828055
2484,2010480,3640,207,441,1229,3433,3640,1.0,0.05686813186813187,0.9431318681318681,1970,0.12115384615384615,0.33763736263736266,0.5412087912087912
2485,2010481,4289,293,518,1740,3996,4289,1.0,0.06831429237584519,0.9316857076241548,2031,0.12077407321053858,0.40568897178829566,0.47353695500116577
2486,2010482,5146,456,776,1845,4690,5146,1.0,0.08861251457442675,0.9113874854255732,2525,0.15079673532841043,0.3585308977846871,0.49067236688690247
2487,2010483,5145,947,1167,1381,4198,5145,1.0,0.18406219630709428,0.8159378036929057,2597,0.22682215743440234,0.2684159378036929,0.5047619047619047
2488,2010484,4931,816,708,1843,4115,4931,1.0,0.16548367471101197,0.834516325288988,2380,0.1435814236463192,0.37375785844656256,0.48266071790711823
2489,2010485,4493,368,408,1263,4125,4493,1.0,0.08190518584464723,0.9180948141553528,2822,0.09080792343645672,0.2811039394613844,0.6280881371021589
2490,2010486,4781,208,531,2047,4573,4781,1.0,0.04350554277347835,0.9564944572265216,2203,0.11106463083037021,0.42815310604476053,0.46078226312486925
2491,2010487,4996,1040,1217,551,3956,4996,1.0,0.20816653322658127,0.7918334667734187,3228,0.24359487590072057,0.11028823058446757,0.6461168935148118
2492,2010488,2551,835,808,439,1716,2551,1.0,0.32732261858094863,0.6726773814190513,1304,0.3167385339082713,0.17208937671501373,0.511172089376715
2493,2010489,2571,913,812,323,1658,2571,1.0,0.35511474134577986,0.6448852586542202,1436,0.3158304161804745,0.12563204978607545,0.55853753403345
2494,2010490,2421,1061,807,475,1360,2421,1.0,0.4382486575795126,0.5617513424204874,1139,0.3333333333333333,0.19619991738950845,0.4704667492771582
2495,2010491,3389,300,438,680,3089,3389,1.0,0.08852168781351431,0.9114783121864857,2271,0.1292416642077309,0.20064915904396577,0.6701091767483033
2496,2010492,2891,560,707,827,2331,2891,1.0,0.1937046004842615,0.8062953995157385,1357,0.24455205811138014,0.286060186786579,0.46938775510204084
2497,2010494,3261,1498,1009,155,1763,3261,1.0,0.4593682919349893,0.5406317080650107,2097,0.3094142900950629,0.04753143207605029,0.6430542778288868
2498,2010495,2514,220,417,1163,2294,2514,1.0,0.08750994431185362,0.9124900556881463,934,0.1658711217183771,0.4626093874303898,0.3715194908512331
2499,2010496,3019,500,628,409,2519,3019,1.0,0.16561775422325273,0.8343822457767472,1982,0.20801589930440542,0.13547532295462072,0.6565087777409738
2500,2010497,2394,1846,1345,55,548,2394,1.0,0.77109440267335,0.22890559732664995,994,0.5618212197159566,0.02297410192147034,0.4152046783625731
2501,2010498,4055,1375,705,521,2680,4055,1.0,0.33908754623921084,0.6609124537607891,2829,0.17385943279901356,0.1284833538840937,0.6976572133168927
2502,2010499,2348,96,450,1334,2252,2348,1.0,0.04088586030664395,0.959114139693356,564,0.19165247018739354,0.5681431005110733,0.2402044293015332
2503,2010500,4132,491,638,1517,3641,4132,1.0,0.11882865440464666,0.8811713455953534,1977,0.15440464666021297,0.36713455953533397,0.47846079380445306
2504,2010501,2127,64,666,425,2063,2127,1.0,0.03008932769158439,0.9699106723084157,1036,0.3131170662905501,0.1998119417019276,0.48707099200752235
2505,2010502,3634,159,279,1173,3475,3634,1.0,0.043753439735828285,0.9562465602641718,2182,0.07677490368739681,0.3227848101265823,0.600440286186021
2506,2010503,2560,95,209,845,2465,2560,1.0,0.037109375,0.962890625,1506,0.081640625,0.330078125,0.58828125
2507,2010504,2243,18,535,1099,2225,2243,1.0,0.008024966562639322,0.9919750334373607,609,0.23851983950066874,0.48996879179670083,0.27151136870263043
2508,2010505,6104,1037,1109,1042,5067,6104,1.0,0.16988859764089123,0.8301114023591087,3953,0.18168414154652687,0.17070773263433814,0.647608125819135
2509,2010506,3659,2098,1841,375,1561,3659,1.0,0.573380705110686,0.426619294889314,1443,0.5031429352282044,0.10248701831101394,0.3943700464607816
2510,2010507,3528,642,777,149,2886,3528,1.0,0.18197278911564627,0.8180272108843537,2602,0.22023809523809523,0.04223356009070295,0.7375283446712018
2511,2010508,5769,817,1476,793,4952,5769,1.0,0.14161899809325706,0.8583810019067429,3500,0.25585023400936036,0.1374588316866008,0.6066909343040389
2512,2010509,6746,345,900,2040,6401,6746,1.0,0.05114141713608064,0.9488585828639193,3806,0.13341239252890602,0.3024014230655203,0.5641861844055737
2513,2010510,5015,1222,1145,975,3793,5015,1.0,0.2436689930209372,0.7563310069790629,2895,0.22831505483549352,0.19441674975074777,0.5772681954137587
2514,2010511,6641,1023,719,1841,5618,6641,1.0,0.15404306580334287,0.8459569341966572,4081,0.10826682728504743,0.2772172865532299,0.6145158861617226
2515,2010512,5344,884,1164,987,4460,5344,1.0,0.16541916167664672,0.8345808383233533,3193,0.21781437125748504,0.1846931137724551,0.5974925149700598
2516,2010513,3237,529,471,1614,2708,3237,1.0,0.16342292245906703,0.8365770775409329,1152,0.14550509731232622,0.4986098239110287,0.35588507877664505
2517,2010514,6027,930,676,2037,5097,6027,1.0,0.15430562468889994,0.8456943753111,3314,0.11216193794591008,0.33797909407665505,0.5498589679774348
2518,2010515,2839,22,366,1719,2817,2839,1.0,0.007749207467418105,0.9922507925325819,754,0.12891863332159212,0.6054948925678055,0.2655864741106023
2519,2010516,3488,630,732,761,2858,3488,1.0,0.18061926605504589,0.8193807339449541,1995,0.2098623853211009,0.21817660550458715,0.5719610091743119
2520,2010517,5105,795,903,941,4310,5105,1.0,0.15572967678746327,0.8442703232125367,3261,0.17688540646425074,0.1843290891283056,0.6387855044074436
2521,2010518,4817,790,847,1502,4027,4817,1.0,0.16400249117708118,0.8359975088229188,2468,0.17583558231264274,0.3118123313265518,0.5123520863608054
2522,2010519,3108,292,478,1353,2816,3108,1.0,0.09395109395109395,0.9060489060489061,1277,0.1537966537966538,0.43532818532818535,0.41087516087516085
2523,2010520,8058,4956,1987,372,3102,8058,1.0,0.6150409530900968,0.3849590469099032,5699,0.24658724249193348,0.04616530156366344,0.7072474559444031
2524,2010521,4015,624,821,846,3391,4015,1.0,0.15541718555417186,0.8445828144458282,2348,0.20448318804483187,0.21070983810709837,0.5848069738480698
2525,2010522,2676,104,428,1422,2572,2676,1.0,0.03886397608370702,0.9611360239162929,826,0.15994020926756353,0.531390134529148,0.3086696562032885
2526,2010523,4940,374,856,1623,4566,4940,1.0,0.0757085020242915,0.9242914979757085,2461,0.17327935222672064,0.32854251012145747,0.49817813765182184
2527,2010524,4991,1985,1316,561,3006,4991,1.0,0.39771588859947904,0.602284111400521,3114,0.26367461430575034,0.11240232418353036,0.6239230615107193
2528,2010525,3404,1760,1543,401,1644,3404,1.0,0.5170387779083431,0.48296122209165687,1460,0.45329024676850765,0.11780258519388954,0.4289071680376028
2529,2010526,1139,110,221,97,1029,1139,1.0,0.09657594381035997,0.9034240561896401,821,0.19402985074626866,0.08516242317822652,0.7208077260755048
2530,2010528,72,57,44,4,15,72,1.0,0.7916666666666666,0.20833333333333334,24,0.6111111111111112,0.05555555555555555,0.3333333333333333
2531,2010529,4556,271,337,2034,4285,4556,1.0,0.05948200175592625,0.9405179982440738,2185,0.07396839332748024,0.44644424934152765,0.4795873573309921
2532,2010530,1384,20,357,119,1364,1384,1.0,0.014450867052023121,0.9855491329479769,908,0.2579479768786127,0.08598265895953758,0.6560693641618497
2533,2010531,2700,140,418,978,2560,2700,1.0,0.05185185185185185,0.9481481481481482,1304,0.15481481481481482,0.3622222222222222,0.482962962962963
2534,2010532,1601,167,178,442,1434,1601,1.0,0.10430980637101811,0.8956901936289818,981,0.11118051217988757,0.27607745159275454,0.6127420362273579
2535,2010533,1557,334,232,276,1223,1557,1.0,0.2145150931278099,0.7854849068721901,1049,0.14900449582530506,0.17726396917148363,0.6737315350032113
2536,2010534,4783,98,546,1733,4685,4783,1.0,0.0204892326991428,0.9795107673008572,2504,0.11415429646665273,0.36232490068994355,0.5235208028434037
2537,2010535,514,0,101,63,514,514,1.0,0.0,1.0,350,0.19649805447470817,0.122568093385214,0.6809338521400778
2538,2010536,7049,1038,1440,920,6011,7049,1.0,0.14725492977727336,0.8527450702227266,4689,0.2042842956447723,0.13051496666193788,0.6652007376932898
2539,2010537,3567,372,553,1684,3195,3567,1.0,0.10428931875525652,0.8957106812447435,1330,0.15503223997757218,0.4721054107092795,0.3728623493131483
2540,2010538,1398,1189,636,10,209,1398,1.0,0.8505007153075823,0.14949928469241774,752,0.45493562231759654,0.00715307582260372,0.5379113018597997
2541,2010539,2048,528,272,565,1520,2048,1.0,0.2578125,0.7421875,1211,0.1328125,0.27587890625,0.59130859375
2542,2010540,2543,547,562,453,1996,2543,1.0,0.21510027526543452,0.7848997247345655,1528,0.22099882029099488,0.17813605977192293,0.6008651199370821
2543,2010541,8028,4877,2230,326,3151,8028,1.0,0.6074987543597409,0.39250124564025907,5472,0.2777777777777778,0.04060787244643747,0.6816143497757847
2544,2010542,3919,2059,1391,80,1860,3919,1.0,0.5253891298800715,0.47461087011992853,2448,0.3549374840520541,0.02041337075784639,0.6246491451900995
2545,2010543,2360,100,424,220,2260,2360,1.0,0.0423728813559322,0.9576271186440678,1716,0.17966101694915254,0.09322033898305085,0.7271186440677966
2546,2010544,328,196,130,15,132,328,1.0,0.5975609756097561,0.4024390243902439,183,0.39634146341463417,0.04573170731707317,0.5579268292682927
2547,2010545,4214,372,1082,1035,3842,4214,1.0,0.08827717133364973,0.9117228286663502,2097,0.25676317038443286,0.24560987185571903,0.4976269577598481
2548,2010546,2515,22,256,1420,2493,2515,1.0,0.00874751491053678,0.9912524850894632,839,0.10178926441351889,0.5646123260437376,0.33359840954274356
2549,2010547,2892,113,435,1041,2779,2892,1.0,0.039073305670816044,0.960926694329184,1416,0.1504149377593361,0.3599585062240664,0.4896265560165975
2550,2010548,3580,370,631,533,3210,3580,1.0,0.10335195530726257,0.8966480446927374,2416,0.17625698324022346,0.1488826815642458,0.6748603351955307
2551,2010549,3124,1486,1280,206,1638,3124,1.0,0.47567221510883484,0.5243277848911652,1638,0.40973111395646605,0.06594110115236876,0.5243277848911652
2552,2010550,4683,1585,844,861,3098,4683,1.0,0.3384582532564595,0.6615417467435405,2978,0.18022635062993808,0.18385650224215247,0.6359171471279095
2553,2010551,4810,528,629,1817,4282,4810,1.0,0.10977130977130978,0.8902286902286902,2364,0.13076923076923078,0.37775467775467775,0.4914760914760915
2554,2010552,3918,230,389,2024,3688,3918,1.0,0.058703420112302195,0.9412965798876978,1505,0.09928534966819806,0.5165900969882593,0.3841245533435426
2555,2010553,2771,517,664,515,2254,2771,1.0,0.18657524359437028,0.8134247564056297,1592,0.23962468422952002,0.1858534824972934,0.5745218332731866
2556,2010554,2717,1353,730,147,1364,2717,1.0,0.4979757085020243,0.5020242914979757,1840,0.2686786897313213,0.05410379094589621,0.6772175193227825
2557,2010555,3619,2163,853,169,1456,3619,1.0,0.597678916827853,0.402321083172147,2597,0.23570046974302294,0.04669798286819563,0.7176015473887815
2558,2010556,2867,916,765,210,1951,2867,1.0,0.3194977328217649,0.6805022671782351,1892,0.266829438437391,0.07324729682595046,0.6599232647366585
2559,2010557,3369,891,874,457,2478,3369,1.0,0.26447016918967053,0.7355298308103295,2038,0.25942416147224695,0.13564856040368062,0.6049272781240724
2560,2010558,5844,2329,1606,750,3515,5844,1.0,0.3985284052019165,0.6014715947980835,3488,0.27481177275838464,0.12833675564681724,0.5968514715947981
2561,2010559,7935,4085,1852,577,3850,7935,1.0,0.5148078134845621,0.48519218651543794,5506,0.23339634530560807,0.07271581600504096,0.693887838689351
2562,2010560,1253,42,338,95,1211,1253,1.0,0.0335195530726257,0.9664804469273743,820,0.26975259377494015,0.07581803671189145,0.6544293695131684
2563,2010561,4028,539,659,896,3489,4028,1.0,0.13381330685203574,0.8661866931479643,2473,0.16360476663356505,0.2224428997020854,0.6139523336643495
2564,2010562,792,334,309,33,458,792,1.0,0.4217171717171717,0.5782828282828283,450,0.39015151515151514,0.041666666666666664,0.5681818181818182
2565,2010563,3975,285,484,1855,3690,3975,1.0,0.07169811320754717,0.9283018867924528,1636,0.12176100628930818,0.4666666666666667,0.41157232704402513
2566,2010564,4657,1360,1325,490,3297,4657,1.0,0.2920334979600601,0.7079665020399398,2842,0.2845179299978527,0.10521795147090401,0.6102641185312433
2567,2010565,1954,665,409,89,1289,1954,1.0,0.34032753326509724,0.6596724667349028,1456,0.20931422722620266,0.045547594677584444,0.7451381780962129
2568,2010566,4540,1853,1161,416,2687,4540,1.0,0.40814977973568284,0.5918502202643172,2963,0.25572687224669605,0.09162995594713656,0.6526431718061674
2569,2010567,3888,1238,917,325,2650,3888,1.0,0.3184156378600823,0.6815843621399177,2646,0.23585390946502058,0.08359053497942387,0.6805555555555556
2570,2010568,3567,130,790,1612,3437,3567,1.0,0.03644519203812728,0.9635548079618728,1165,0.22147462853938885,0.4519203812727782,0.3266049901878329
2571,2010569,5211,465,948,1248,4746,5211,1.0,0.0892343120322395,0.9107656879677605,3015,0.18192285549798504,0.23949337938975246,0.5785837651122625
2572,2010570,2460,365,484,414,2095,2460,1.0,0.1483739837398374,0.8516260162601627,1562,0.1967479674796748,0.16829268292682928,0.634959349593496
2573,2010571,2835,86,419,215,2749,2835,1.0,0.030335097001763667,0.9696649029982364,2201,0.14779541446208114,0.07583774250440917,0.7763668430335097
2574,2010572,4360,1040,966,854,3320,4360,1.0,0.23853211009174313,0.7614678899082569,2540,0.22155963302752293,0.19587155963302752,0.5825688073394495
2575,2010573,1450,1184,920,13,266,1450,1.0,0.8165517241379311,0.18344827586206897,517,0.6344827586206897,0.00896551724137931,0.356551724137931
2576,2010574,370,133,156,22,237,370,1.0,0.35945945945945945,0.6405405405405405,192,0.42162162162162165,0.05945945945945946,0.518918918918919
2577,2010575,4062,677,501,1081,3385,4062,1.0,0.16666666666666666,0.8333333333333334,2480,0.12333825701624815,0.26612506154603643,0.6105366814377154
2578,2010576,3057,2236,1534,46,821,3057,1.0,0.7314360484134773,0.26856395158652274,1477,0.501799149492967,0.015047432122996402,0.48315341838403664
2579,2010577,1777,132,313,568,1645,1777,1.0,0.0742824985931345,0.9257175014068655,896,0.17613956105796286,0.3196398424310636,0.5042205965109735
2580,2010578,2090,52,426,838,2038,2090,1.0,0.024880382775119617,0.9751196172248804,826,0.20382775119617225,0.40095693779904307,0.3952153110047847
2581,2010579,1928,784,372,124,1144,1928,1.0,0.4066390041493776,0.5933609958506224,1432,0.19294605809128632,0.06431535269709543,0.7427385892116183
2582,2010580,940,813,553,11,127,940,1.0,0.8648936170212767,0.1351063829787234,376,0.5882978723404255,0.011702127659574468,0.4
2583,2010581,965,900,637,18,65,965,1.0,0.9326424870466321,0.06735751295336788,310,0.6601036269430052,0.01865284974093264,0.32124352331606215
2584,2010582,1464,1192,812,41,272,1464,1.0,0.8142076502732241,0.18579234972677597,611,0.5546448087431693,0.028005464480874317,0.4173497267759563
2585,2010583,1449,1244,645,11,205,1449,1.0,0.8585231193926847,0.1414768806073154,793,0.4451345755693582,0.00759144237405107,0.5472739820565907
2586,2010584,1513,958,486,31,555,1513,1.0,0.6331791143423662,0.3668208856576338,996,0.3212161269001983,0.020489094514210177,0.6582947785855915
2587,2010585,2635,2123,1190,27,512,2635,1.0,0.8056925996204933,0.19430740037950664,1418,0.45161290322580644,0.010246679316888045,0.5381404174573055
2588,2010586,6374,1609,934,1496,4765,6374,1.0,0.25243175400062756,0.7475682459993724,3944,0.14653278945716974,0.2347034828992783,0.6187637276435519
2589,2010587,4286,2142,871,501,2144,4286,1.0,0.49976668222118525,0.5002333177788147,2914,0.20321978534764348,0.11689220718618759,0.679888007466169
2590,2010588,3768,497,545,1475,3271,3768,1.0,0.13190021231422505,0.8680997876857749,1748,0.14463906581740976,0.3914543524416136,0.46390658174097665
2591,2010589,4939,670,808,916,4269,4939,1.0,0.1356549908888439,0.8643450091111561,3215,0.16359586960923264,0.18546264425997167,0.6509414861307957
2592,2010590,1855,30,332,1264,1825,1855,1.0,0.016172506738544475,0.9838274932614556,259,0.17897574123989218,0.6814016172506738,0.13962264150943396
2593,2010591,2486,41,581,256,2445,2486,1.0,0.016492357200321803,0.9835076427996782,1649,0.2337087691069992,0.10297666934835076,0.6633145615446501
2594,2010592,2451,718,491,154,1733,2451,1.0,0.29294165646674825,0.7070583435332517,1806,0.20032639738882088,0.06283149734802121,0.7368421052631579
2595,2010593,4125,410,902,796,3715,4125,1.0,0.0993939393939394,0.9006060606060606,2427,0.21866666666666668,0.19296969696969696,0.5883636363636363
2596,2010594,3031,1249,1095,444,1782,3031,1.0,0.4120752226987793,0.5879247773012207,1492,0.36126690861101945,0.1464863081491257,0.4922467832398548
2597,2010595,2541,921,716,137,1620,2541,1.0,0.3624557260920897,0.6375442739079102,1688,0.28177882723337266,0.05391578118850846,0.6643053915781189
2598,2010596,5023,1183,874,1023,3840,5023,1.0,0.23551662353175393,0.764483376468246,3126,0.17399960183157476,0.20366314951224368,0.6223372486561816
2599,2010597,5523,2230,1083,695,3293,5523,1.0,0.4037660691653087,0.5962339308346913,3745,0.19608908202064096,0.1258374072062285,0.6780735107731305
2600,2010598,7136,1737,1379,1140,5399,7136,1.0,0.24341367713004483,0.7565863228699552,4617,0.19324551569506726,0.15975336322869954,0.6470011210762332
2601,2010599,2707,883,822,428,1824,2707,1.0,0.3261913557443665,0.6738086442556336,1457,0.3036571850757296,0.15810860731437015,0.5382342076099003
2602,2010600,5798,2084,1405,793,3714,5798,1.0,0.35943428768540875,0.6405657123145913,3600,0.24232493963435667,0.1367713004484305,0.6209037599172128
2603,2010601,4276,272,661,2171,4004,4276,1.0,0.06361085126286249,0.9363891487371375,1444,0.15458372310570626,0.5077174929840973,0.3376987839101964
2604,2010602,1536,120,240,593,1416,1536,1.0,0.078125,0.921875,703,0.15625,0.3860677083333333,0.4576822916666667
2605,2010603,7841,1278,937,1484,6563,7841,1.0,0.16298941461548272,0.8370105853845173,5420,0.11950006376737661,0.18926157377885475,0.6912383624537687
2606,2010604,4004,115,270,1664,3889,4004,1.0,0.02872127872127872,0.9712787212787213,2070,0.06743256743256744,0.4155844155844156,0.516983016983017
2607,2010605,6616,2835,1680,573,3781,6616,1.0,0.42850665054413545,0.5714933494558646,4363,0.2539298669891173,0.08660822249093107,0.6594619105199516
2608,2010606,899,815,528,8,84,899,1.0,0.9065628476084538,0.09343715239154617,363,0.5873192436040044,0.008898776418242492,0.40378197997775306
2609,2010607,1119,762,284,20,357,1119,1.0,0.6809651474530831,0.3190348525469169,815,0.2537980339588919,0.017873100983020553,0.7283288650580876
2610,2010608,654,0,132,108,654,654,1.0,0.0,1.0,414,0.2018348623853211,0.1651376146788991,0.6330275229357798
2611,2010609,4838,471,930,1589,4367,4838,1.0,0.09735427862753204,0.902645721372468,2319,0.19222819346837536,0.3284415047540306,0.47933030177759406
2612,2010610,2798,34,424,343,2764,2798,1.0,0.012151536812008578,0.9878484631879915,2031,0.15153681200857755,0.12258756254467476,0.7258756254467477
2613,2010611,2082,1757,1360,32,325,2082,1.0,0.8439000960614793,0.15609990393852066,690,0.6532180595581172,0.01536983669548511,0.3314121037463977
2614,2010612,3450,110,500,1733,3340,3450,1.0,0.03188405797101449,0.9681159420289855,1217,0.14492753623188406,0.5023188405797101,0.3527536231884058
2615,2010613,3064,1031,900,188,2033,3064,1.0,0.3364882506527415,0.6635117493472585,1976,0.293733681462141,0.06135770234986945,0.6449086161879896
2616,2010614,5213,1972,1584,802,3241,5213,1.0,0.378285056589296,0.621714943410704,2827,0.303855745252254,0.15384615384615385,0.5422981009015921
2617,2010615,2070,445,511,787,1625,2070,1.0,0.21497584541062803,0.785024154589372,772,0.24685990338164251,0.38019323671497585,0.37294685990338167
2618,2010616,3591,455,654,1607,3136,3591,1.0,0.1267056530214425,0.8732943469785575,1330,0.1821219715956558,0.4475076580339738,0.37037037037037035
2619,2010617,6809,2470,1342,756,4339,6809,1.0,0.36275517697165516,0.6372448230283448,4711,0.19709208400646203,0.11102951975326773,0.6918783962402703
2620,2010618,5695,930,844,650,4765,5695,1.0,0.16330114135206322,0.8366988586479368,4201,0.1482001755926251,0.1141352063213345,0.7376646180860403
2621,2010619,4552,77,788,2492,4475,4552,1.0,0.016915641476274165,0.9830843585237259,1272,0.17311072056239016,0.5474516695957821,0.27943760984182775
2622,2010620,4515,1150,905,802,3365,4515,1.0,0.2547065337763012,0.7452934662236987,2808,0.20044296788482835,0.17763012181616833,0.6219269102990034
2623,2010621,1515,198,285,299,1317,1515,1.0,0.1306930693069307,0.8693069306930693,931,0.18811881188118812,0.19735973597359735,0.6145214521452145
2624,2010622,5087,393,1010,1474,4694,5087,1.0,0.07725574995085512,0.9227442500491448,2603,0.19854531157853353,0.2897582071948103,0.5116964812266562
2625,2010623,4692,833,780,1503,3859,4692,1.0,0.17753623188405798,0.822463768115942,2409,0.16624040920716113,0.3203324808184143,0.5134271099744245
2626,2010624,543,63,61,55,480,543,1.0,0.11602209944751381,0.8839779005524862,427,0.11233885819521179,0.10128913443830571,0.7863720073664825
2627,2010625,2025,508,525,755,1517,2025,1.0,0.2508641975308642,0.7491358024691358,745,0.25925925925925924,0.3728395061728395,0.36790123456790125
2628,2010626,5795,1450,1306,1702,4345,5795,1.0,0.25021570319240727,0.7497842968075927,2787,0.2253666954270923,0.2937014667817084,0.4809318377911993
2629,2010627,4234,1278,960,426,2956,4234,1.0,0.30184222957014645,0.6981577704298536,2848,0.22673594709494568,0.10061407652338214,0.6726499763816722
2630,2010628,3441,484,615,497,2957,3441,1.0,0.14065678581807614,0.8593432141819238,2329,0.17872711421098517,0.14443475733798314,0.6768381284510316
2631,2010629,1252,1008,277,22,244,1252,1.0,0.805111821086262,0.19488817891373802,953,0.22124600638977635,0.01757188498402556,0.7611821086261981
2632,2010630,5816,4024,2320,208,1792,5816,1.0,0.6918844566712518,0.3081155433287483,3288,0.3988995873452545,0.03576341127922971,0.5653370013755158
2633,2010631,3108,566,556,1440,2542,3108,1.0,0.1821106821106821,0.8178893178893178,1112,0.1788931788931789,0.46332046332046334,0.3577863577863578
2634,2010632,355,59,14,5,296,355,1.0,0.16619718309859155,0.8338028169014085,336,0.03943661971830986,0.014084507042253521,0.9464788732394366
2635,2010633,4277,516,627,1810,3761,4277,1.0,0.12064531213467383,0.8793546878653261,1840,0.14659808276829553,0.4231938274491466,0.43020808978255787
2636,2010634,4033,673,623,1092,3360,4033,1.0,0.1668732953136623,0.8331267046863378,2318,0.15447557649392513,0.27076617902305977,0.5747582444830152
2637,2010635,3948,0,420,1562,3948,3948,1.0,0.0,1.0,1966,0.10638297872340426,0.3956433637284701,0.4979736575481256
2638,2010636,4765,71,320,2393,4694,4765,1.0,0.014900314795383,0.985099685204617,2052,0.06715634837355719,0.5022035676810074,0.43064008394543546
2639,2010637,3090,329,874,328,2761,3090,1.0,0.10647249190938511,0.8935275080906149,1888,0.2828478964401295,0.10614886731391586,0.6110032362459547
2640,2010638,2428,1551,1300,99,877,2428,1.0,0.6387973640856672,0.36120263591433277,1029,0.5354200988467874,0.04077429983525535,0.4238056013179572
2641,2010639,3214,145,300,1206,3069,3214,1.0,0.04511512134411948,0.9548848786558806,1708,0.09334163036714374,0.37523335407591785,0.5314250155569384
2642,2010640,4920,838,813,1234,4082,4920,1.0,0.17032520325203251,0.8296747967479675,2873,0.1652439024390244,0.2508130081300813,0.5839430894308943
2643,2010641,4574,844,752,1326,3730,4574,1.0,0.1845212068211631,0.8154787931788369,2496,0.1644075207695671,0.289899431569742,0.5456930476606908
2644,2010642,1765,140,211,1093,1625,1765,1.0,0.07932011331444759,0.9206798866855525,461,0.11954674220963173,0.6192634560906516,0.26118980169971673
2645,2010643,4738,765,887,863,3973,4738,1.0,0.16146053186998732,0.8385394681300127,2988,0.18720979316167158,0.18214436471084847,0.63064584212748
2646,2010644,5157,301,850,1525,4856,5157,1.0,0.05836726779135156,0.9416327322086484,2782,0.16482451037424858,0.2957145627302695,0.5394609268954819
2647,2010645,5979,1762,1319,1151,4217,5979,1.0,0.29469811005184815,0.7053018899481519,3509,0.2206054524167921,0.1925071082120756,0.5868874393711323
2648,2010646,2768,556,861,366,2212,2768,1.0,0.20086705202312138,0.7991329479768786,1541,0.3110549132947977,0.13222543352601157,0.5567196531791907
2649,2010647,5519,1580,1343,501,3939,5519,1.0,0.28628374705562604,0.713716252944374,3675,0.2433411849972821,0.09077731473092952,0.6658815002717884
2650,2010648,3138,216,620,1602,2922,3138,1.0,0.06883365200764818,0.9311663479923518,916,0.1975780752071383,0.5105162523900574,0.29190567240280435
2651,2010649,5533,1631,1570,621,3902,5533,1.0,0.294776793782758,0.705223206217242,3342,0.28375203325501536,0.1122356768480029,0.6040122898969817
2652,2010650,4833,858,723,1831,3975,4833,1.0,0.17752948479205463,0.8224705152079453,2279,0.14959652389819988,0.3788537140492448,0.47154976205255533
2653,2010651,4788,493,886,1570,4295,4788,1.0,0.1029657477025898,0.8970342522974102,2332,0.18504594820384293,0.3279030910609858,0.48705096073517123
2654,2010652,3254,2007,1394,280,1247,3254,1.0,0.616779348494161,0.38322065150583895,1580,0.4283958205285802,0.0860479409956976,0.4855562384757222
2655,2010653,1744,324,223,72,1420,1744,1.0,0.18577981651376146,0.8142201834862385,1449,0.12786697247706422,0.04128440366972477,0.830848623853211
2656,2010654,6263,1004,1302,1521,5259,6263,1.0,0.16030656235031135,0.8396934376496886,3440,0.20788759380488583,0.24285486188727448,0.5492575443078397
2657,2010655,5811,778,900,1622,5033,5811,1.0,0.13388401307864395,0.866115986921356,3289,0.15487867836861124,0.2791257959043194,0.5659955257270693
2658,2010656,2607,1624,1540,55,983,2607,1.0,0.6229382431914078,0.3770617568085923,1012,0.5907172995780591,0.02109704641350211,0.3881856540084388
2659,2010657,1848,425,437,293,1423,1848,1.0,0.22997835497835498,0.770021645021645,1118,0.23647186147186147,0.15854978354978355,0.604978354978355
2660,2010658,3861,539,606,1042,3322,3861,1.0,0.1396011396011396,0.8603988603988604,2213,0.15695415695415696,0.2698782698782699,0.5731675731675732
2661,2010659,6852,1092,869,2305,5760,6852,1.0,0.159369527145359,0.840630472854641,3678,0.1268242848803269,0.3363981319322825,0.5367775831873906
2662,2010660,4421,3270,1518,160,1151,4421,1.0,0.7396516625197919,0.2603483374802081,2743,0.34336123049083916,0.036190907034607554,0.6204478624745533
2663,2010661,6632,1057,1060,1278,5575,6632,1.0,0.15937876960193004,0.84062123039807,4294,0.15983112183353437,0.19270205066344995,0.6474668275030157
2664,2010662,4042,38,489,2278,4004,4042,1.0,0.009401286491835725,0.9905987135081643,1275,0.12097971301335972,0.5635823849579417,0.31543790202869865
2665,2010663,2734,70,638,859,2664,2734,1.0,0.025603511338697878,0.9743964886613021,1237,0.2333577176298464,0.31419166057059256,0.4524506217995611
2666,2010664,3413,756,929,304,2657,3413,1.0,0.22150600644594198,0.778493993554058,2180,0.27219455024904776,0.08907119835921477,0.6387342513917375
2667,2010665,2557,7,193,1131,2550,2557,1.0,0.002737583105201408,0.9972624168947986,1233,0.07547907704341025,0.4423152131403989,0.4822057098161909
2669,2010667,2329,27,321,1189,2302,2329,1.0,0.011592958351223702,0.9884070416487764,819,0.1378273937312151,0.5105195362816659,0.3516530699871189
2670,2010668,5003,881,606,1161,4122,5003,1.0,0.17609434339396363,0.8239056566060364,3236,0.1211273236058365,0.23206076354187488,0.6468119128522887
2671,2010669,4312,957,680,1716,3355,4312,1.0,0.22193877551020408,0.7780612244897959,1916,0.15769944341372913,0.3979591836734694,0.44434137291280146
2672,2010670,3438,31,438,1895,3407,3438,1.0,0.009016870273414777,0.9909831297265852,1105,0.1273996509598604,0.5511925538103548,0.32140779522978474
2673,2010671,3760,460,744,1087,3300,3760,1.0,0.12234042553191489,0.8776595744680851,1929,0.19787234042553192,0.2890957446808511,0.513031914893617
2674,2010672,3768,489,590,1212,3279,3768,1.0,0.12977707006369427,0.8702229299363057,1966,0.15658174097664543,0.321656050955414,0.5217622080679406
2675,2010673,3126,16,364,1615,3110,3126,1.0,0.005118362124120281,0.9948816378758797,1147,0.1164427383237364,0.5166346769033909,0.3669225847728727
2676,2010674,4265,590,676,2169,3675,4265,1.0,0.13833528722157093,0.861664712778429,1420,0.15849941383352872,0.5085580304806565,0.33294255568581477
2678,2010676,3777,857,646,499,2920,3777,1.0,0.2268996558114906,0.7731003441885094,2632,0.17103521313211545,0.1321154355308446,0.69684935133704
2679,2010677,1434,141,367,156,1293,1434,1.0,0.09832635983263599,0.9016736401673641,911,0.25592747559274753,0.1087866108786611,0.6352859135285913
2680,2010678,3539,2692,1513,162,847,3539,1.0,0.7606668550437977,0.2393331449562023,1864,0.4275218988414806,0.04577564283695959,0.5267024583215597
2681,2010679,4259,19,482,1613,4240,4259,1.0,0.004461141112937309,0.9955388588870627,2164,0.11317210612819911,0.37872740079830947,0.5081004930734915
2682,2010680,200,32,40,34,168,200,1.0,0.16,0.84,126,0.2,0.17,0.63
2683,2010681,6,1,1,0,5,6,1.0,0.16666666666666666,0.8333333333333334,5,0.16666666666666666,0.0,0.8333333333333334
2684,2010682,5712,386,631,1907,5326,5712,1.0,0.06757703081232493,0.9324229691876751,3174,0.11046918767507002,0.3338585434173669,0.555672268907563
2685,2010683,418,43,65,30,375,418,1.0,0.10287081339712918,0.8971291866028708,323,0.15550239234449761,0.07177033492822966,0.7727272727272727
2686,2010684,4394,680,533,1548,3714,4394,1.0,0.15475648611743287,0.8452435138825671,2313,0.12130177514792899,0.3522985889849795,0.5263996358670915
2687,2010685,495,99,102,92,396,495,1.0,0.2,0.8,301,0.20606060606060606,0.18585858585858586,0.6080808080808081
2688,2010686,309,86,60,20,223,309,1.0,0.2783171521035599,0.7216828478964401,229,0.1941747572815534,0.06472491909385113,0.7411003236245954
2689,2010687,2795,75,487,1195,2720,2795,1.0,0.026833631484794274,0.9731663685152058,1113,0.1742397137745975,0.4275491949910555,0.39821109123434706
2690,2010688,4255,82,462,2088,4173,4255,1.0,0.01927144535840188,0.9807285546415981,1705,0.10857814336075206,0.49071680376028204,0.4007050528789659
2691,2010689,3174,395,571,531,2779,3174,1.0,0.12444864524259609,0.8755513547574039,2072,0.17989918084436043,0.16729678638941398,0.6528040327662256
2692,2010690,4158,136,404,1585,4022,4158,1.0,0.03270803270803271,0.9672919672919673,2169,0.09716209716209716,0.3811928811928812,0.5216450216450217
2693,2010691,3795,240,435,1799,3555,3795,1.0,0.06324110671936758,0.9367588932806324,1561,0.11462450592885376,0.4740447957839262,0.41133069828722
2694,2010692,4321,263,409,1278,4058,4321,1.0,0.06086554038417033,0.9391344596158296,2634,0.09465401527424207,0.29576486924323075,0.6095811154825272
2695,2010693,611,346,305,109,265,611,1.0,0.5662847790507365,0.4337152209492635,197,0.49918166939443537,0.1783960720130933,0.32242225859247137
2696,2010694,3275,1170,642,728,2105,3275,1.0,0.35725190839694654,0.6427480916030535,1905,0.19603053435114504,0.22229007633587786,0.5816793893129771
2697,2010695,2709,140,269,488,2569,2709,1.0,0.05167958656330749,0.9483204134366925,1952,0.09929863418235511,0.18014027316352899,0.7205610926541159
2698,2010696,3206,103,330,615,3103,3206,1.0,0.03212726138490331,0.9678727386150967,2261,0.10293200249532128,0.19182782283218963,0.7052401746724891
2699,2010697,3763,1242,1235,368,2521,3763,1.0,0.33005580653733724,0.6699441934626628,2160,0.3281955886260962,0.09779431304809992,0.5740100983258039
2700,2010698,3892,2019,1558,175,1873,3892,1.0,0.5187564234326825,0.4812435765673176,2159,0.40030832476875644,0.044964028776978415,0.5547276464542652
2701,2010699,2547,120,499,1045,2427,2547,1.0,0.04711425206124853,0.9528857479387515,1003,0.19591676482135847,0.41028661170003927,0.3937966234786023
2702,2010700,2090,28,139,674,2062,2090,1.0,0.013397129186602871,0.9866028708133971,1277,0.06650717703349282,0.32248803827751193,0.6110047846889952
2703,2010701,555,0,115,131,555,555,1.0,0.0,1.0,309,0.2072072072072072,0.23603603603603604,0.5567567567567567
2704,2010702,590,145,231,35,445,590,1.0,0.2457627118644068,0.7542372881355932,324,0.39152542372881355,0.059322033898305086,0.5491525423728814
2705,2010703,1687,104,321,1005,1583,1687,1.0,0.06164789567279194,0.9383521043272081,361,0.1902786010669828,0.5957320687611144,0.21398933017190278
2706,2010704,3329,18,320,1686,3311,3329,1.0,0.0054070291378792434,0.9945929708621207,1323,0.09612496245118654,0.5064583959146891,0.3974166416341244
2707,2010705,2094,1466,516,68,628,2094,1.0,0.7000955109837631,0.29990448901623684,1510,0.24641833810888253,0.03247373447946514,0.7211079274116523
2708,2010706,3156,798,798,797,2358,3156,1.0,0.25285171102661597,0.747148288973384,1561,0.25285171102661597,0.25253485424588085,0.4946134347275032
2709,2010707,740,107,155,253,633,740,1.0,0.1445945945945946,0.8554054054054054,332,0.20945945945945946,0.3418918918918919,0.4486486486486487
2710,2010708,795,0,98,95,795,795,1.0,0.0,1.0,602,0.12327044025157233,0.11949685534591195,0.7572327044025158
2711,2010709,5632,561,1033,1558,5071,5632,1.0,0.099609375,0.900390625,3041,0.18341619318181818,0.2766335227272727,0.5399502840909091
2712,2010710,2971,84,515,800,2887,2971,1.0,0.0282733086502861,0.9717266913497139,1656,0.1733423089868731,0.26926960619320095,0.557388084819926
2713,2010711,4704,518,824,1324,4186,4704,1.0,0.11011904761904762,0.8898809523809523,2556,0.17517006802721088,0.2814625850340136,0.5433673469387755
2714,2010712,5135,1640,1177,838,3495,5135,1.0,0.3193768257059396,0.6806231742940604,3120,0.22921129503407983,0.1631937682570594,0.6075949367088608
2715,2010713,2765,734,492,583,2031,2765,1.0,0.2654611211573237,0.7345388788426763,1690,0.1779385171790235,0.2108499095840868,0.6112115732368897
2716,2010714,421,23,22,56,398,421,1.0,0.05463182897862233,0.9453681710213777,343,0.052256532066508314,0.1330166270783848,0.8147268408551069
2717,2010715,2933,804,341,373,2129,2933,1.0,0.2741220593249233,0.7258779406750767,2219,0.11626321172860553,0.12717354244800547,0.7565632458233891
2718,2010716,3599,80,415,1142,3519,3599,1.0,0.02222839677688247,0.9777716032231175,2042,0.1153098082800778,0.31731036398999724,0.567379827729925
2719,2010717,2435,997,1000,161,1438,2435,1.0,0.40944558521560576,0.5905544147843943,1274,0.4106776180698152,0.06611909650924025,0.5232032854209445
2720,2010718,4096,68,835,1964,4028,4096,1.0,0.0166015625,0.9833984375,1297,0.203857421875,0.4794921875,0.316650390625
2721,2010719,1752,112,303,447,1640,1752,1.0,0.0639269406392694,0.9360730593607306,1002,0.17294520547945205,0.2551369863013699,0.571917808219178
2722,2010720,6017,415,674,1890,5602,6017,1.0,0.0689712481302975,0.9310287518697025,3453,0.11201595479474821,0.3141100216054512,0.5738740235998006
2723,2010721,2919,95,573,1336,2824,2919,1.0,0.03254539225762247,0.9674546077423776,1010,0.1963001027749229,0.4576909900650908,0.3460089071599863
2724,2010722,5793,3869,2333,155,1924,5793,1.0,0.6678750215777662,0.3321249784222337,3305,0.40272742965648195,0.026756430174348353,0.5705161401691697
2725,2010723,2063,1068,823,234,995,2063,1.0,0.5176926805622879,0.48230731943771205,1006,0.3989335918565196,0.11342704798836646,0.4876393601551139
2726,2010724,981,45,149,343,936,981,1.0,0.045871559633027525,0.9541284403669725,489,0.15188583078491336,0.34964322120285424,0.4984709480122324
2727,2010725,3253,1225,695,568,2028,3253,1.0,0.3765754687980326,0.6234245312019674,1990,0.21364893944051644,0.1746080541039041,0.6117430064555794
2728,2010726,2226,63,142,1258,2163,2226,1.0,0.02830188679245283,0.9716981132075472,826,0.0637915543575921,0.5651392632524708,0.3710691823899371
2729,2010727,3677,1662,1030,334,2015,3677,1.0,0.45199891215664945,0.5480010878433506,2313,0.2801196627685613,0.09083491977155289,0.6290454174598857
2730,2010728,1253,303,232,304,950,1253,1.0,0.2418196328810854,0.7581803671189146,717,0.18515562649640863,0.24261771747805266,0.5722266560255387
2731,2010729,540,124,116,179,416,540,1.0,0.22962962962962963,0.7703703703703704,245,0.21481481481481482,0.3314814814814815,0.4537037037037037
2732,2010730,3120,166,447,1142,2954,3120,1.0,0.0532051282051282,0.9467948717948718,1531,0.14326923076923076,0.366025641025641,0.4907051282051282
2733,2010732,2516,228,460,741,2288,2516,1.0,0.09062003179650238,0.9093799682034976,1315,0.18282988871224165,0.29451510333863273,0.5226550079491256
2734,2010733,403,194,53,33,209,403,1.0,0.4813895781637717,0.5186104218362283,317,0.1315136476426799,0.08188585607940446,0.7866004962779156
2735,2010734,6073,697,768,1687,5376,6073,1.0,0.11477029474724189,0.8852297052527581,3618,0.12646138646467972,0.2777869257368681,0.5957516877984521
2736,2010735,49,0,0,9,49,49,1.0,0.0,1.0,40,0.0,0.1836734693877551,0.8163265306122449
2737,2010736,51,31,7,0,20,51,1.0,0.6078431372549019,0.39215686274509803,44,0.13725490196078433,0.0,0.8627450980392157
2738,2010737,78,56,5,22,22,78,1.0,0.717948717948718,0.28205128205128205,51,0.0641025641025641,0.28205128205128205,0.6538461538461539
2739,2010738,2027,1101,598,85,926,2027,1.0,0.5431672422298964,0.4568327577701036,1344,0.29501726689689195,0.04193389245189936,0.6630488406512087
2740,2010739,3931,1405,785,669,2526,3931,1.0,0.3574154159247011,0.642584584075299,2477,0.19969473416433478,0.170185703383363,0.6301195624523022
2741,2010740,1461,215,192,237,1246,1461,1.0,0.14715947980835045,0.8528405201916496,1032,0.13141683778234087,0.162217659137577,0.7063655030800822
2742,2010741,2358,810,602,203,1548,2358,1.0,0.3435114503816794,0.6564885496183206,1553,0.2553011026293469,0.08608990670059373,0.6586089906700594
2743,2010742,3025,471,518,932,2554,3025,1.0,0.155702479338843,0.844297520661157,1575,0.1712396694214876,0.308099173553719,0.5206611570247934
2744,2010743,282,7,16,14,275,282,1.0,0.024822695035460994,0.975177304964539,252,0.05673758865248227,0.04964539007092199,0.8936170212765957
2745,2010744,2254,103,440,874,2151,2254,1.0,0.04569653948535936,0.9543034605146407,940,0.19520851818988466,0.3877551020408163,0.417036379769299
2746,2010745,2775,64,541,1032,2711,2775,1.0,0.023063063063063063,0.976936936936937,1202,0.19495495495495496,0.37189189189189187,0.43315315315315317
2747,2010746,1265,190,171,189,1075,1265,1.0,0.15019762845849802,0.849802371541502,905,0.13517786561264822,0.14940711462450593,0.7154150197628458
2748,2010747,5195,1295,1042,974,3900,5195,1.0,0.2492781520692974,0.7507218479307026,3179,0.20057747834456208,0.18748796920115496,0.611934552454283
2749,2010748,2791,383,371,335,2408,2791,1.0,0.13722680042995342,0.8627731995700466,2085,0.13292726621282694,0.12002866356144751,0.7470440702257255
2750,2010749,825,237,123,27,588,825,1.0,0.2872727272727273,0.7127272727272728,675,0.14909090909090908,0.03272727272727273,0.8181818181818182
2751,2010750,1667,390,164,240,1277,1667,1.0,0.23395320935812838,0.7660467906418716,1263,0.09838032393521295,0.14397120575884823,0.7576484703059388
2752,2010751,9008,953,915,1919,8055,9008,1.0,0.10579484902309058,0.8942051509769094,6174,0.10157637655417406,0.21303285968028418,0.6853907637655418
2753,2010752,1878,3,203,617,1875,1878,1.0,0.001597444089456869,0.9984025559105432,1058,0.1080937167199148,0.3285410010649627,0.5633652822151225
2754,2010753,680,166,152,143,514,680,1.0,0.24411764705882352,0.7558823529411764,385,0.2235294117647059,0.21029411764705883,0.5661764705882353
2755,2010754,3082,2364,406,14,718,3082,1.0,0.7670343932511356,0.23296560674886438,2662,0.1317326411421155,0.004542504866969501,0.863724853990915
2756,2010755,7434,1103,1136,747,6331,7434,1.0,0.14837234328759752,0.8516276567124025,5551,0.1528114070486952,0.10048426150121065,0.7467043314500942
2757,2010756,3099,1595,546,306,1504,3099,1.0,0.5146821555340433,0.48531784446595677,2247,0.17618586640851888,0.09874152952565343,0.7250726040658277
2758,2010757,7801,4232,1742,330,3569,7801,1.0,0.5424945519805153,0.4575054480194847,5729,0.22330470452506088,0.042302268939879505,0.7343930265350596
2759,2010758,3453,44,409,1889,3409,3453,1.0,0.012742542716478424,0.9872574572835215,1155,0.11844772661453808,0.5470605270779033,0.3344917463075586
2760,2010759,3693,181,641,1012,3512,3693,1.0,0.04901164365014893,0.950988356349851,2040,0.173571621987544,0.2740319523422692,0.5523964256701869
2761,2010761,1183,64,280,839,1119,1183,1.0,0.05409974640743871,0.9459002535925612,64,0.23668639053254437,0.7092138630600169,0.05409974640743871
2762,2010762,1305,275,262,303,1030,1305,1.0,0.210727969348659,0.789272030651341,740,0.20076628352490422,0.23218390804597702,0.5670498084291188
2763,2010763,1598,26,350,194,1572,1598,1.0,0.016270337922403004,0.983729662077597,1054,0.2190237797246558,0.1214017521902378,0.6595744680851063
2764,2010765,8147,3176,1920,834,4971,8147,1.0,0.3898367497238247,0.6101632502761752,5393,0.23566957162145574,0.10236897017306984,0.6619614582054744
2765,2010766,418,18,114,44,400,418,1.0,0.0430622009569378,0.9569377990430622,260,0.2727272727272727,0.10526315789473684,0.6220095693779905
2766,2010767,147,71,10,24,76,147,1.0,0.48299319727891155,0.5170068027210885,113,0.06802721088435375,0.16326530612244897,0.7687074829931972
2767,2010768,2790,77,334,1384,2713,2790,1.0,0.027598566308243727,0.9724014336917562,1072,0.11971326164874552,0.4960573476702509,0.3842293906810036
2768,2010769,214,40,116,6,174,214,1.0,0.18691588785046728,0.8130841121495327,92,0.5420560747663551,0.028037383177570093,0.42990654205607476
2769,2010770,1338,194,58,46,1144,1338,1.0,0.14499252615844543,0.8550074738415545,1234,0.043348281016442454,0.0343796711509716,0.922272047832586
2770,2010771,2330,470,329,352,1860,2330,1.0,0.2017167381974249,0.7982832618025751,1649,0.14120171673819742,0.15107296137339055,0.707725321888412
2771,2010772,4667,70,669,2278,4597,4667,1.0,0.014998928647953718,0.9850010713520463,1720,0.14334690379258624,0.4881079922862653,0.3685451039211485
2772,2010773,5580,1448,1364,478,4132,5580,1.0,0.25949820788530464,0.7405017921146954,3738,0.24444444444444444,0.08566308243727598,0.6698924731182796
2773,2010774,447,94,145,43,353,447,1.0,0.21029082774049218,0.7897091722595079,259,0.3243847874720358,0.09619686800894854,0.5794183445190156
2774,2010775,79,22,32,1,57,79,1.0,0.27848101265822783,0.7215189873417721,46,0.4050632911392405,0.012658227848101266,0.5822784810126582
2775,2010776,4105,869,708,1099,3236,4105,1.0,0.21169305724725945,0.7883069427527406,2298,0.17247259439707674,0.2677222898903776,0.5598051157125457
2776,2010777,1831,112,143,59,1719,1831,1.0,0.06116876024030585,0.9388312397596942,1629,0.0780993992353905,0.03222282905516111,0.8896777717094484
2778,2010779,960,0,224,130,960,960,1.0,0.0,1.0,606,0.23333333333333334,0.13541666666666666,0.63125
2779,2010780,796,51,132,112,745,796,1.0,0.06407035175879397,0.9359296482412061,552,0.1658291457286432,0.1407035175879397,0.6934673366834171
2780,2010781,4238,227,956,641,4011,4238,1.0,0.05356300141576215,0.9464369985842378,2641,0.22557810287871638,0.15125058990089665,0.6231713072203869
2781,2010782,2547,227,492,849,2320,2547,1.0,0.08912446014919513,0.9108755398508048,1206,0.19316843345111898,0.3333333333333333,0.4734982332155477
2782,2010783,598,242,210,45,356,598,1.0,0.40468227424749165,0.5953177257525084,343,0.3511705685618729,0.07525083612040134,0.5735785953177257
2783,2010784,810,629,565,8,181,810,1.0,0.7765432098765432,0.2234567901234568,237,0.6975308641975309,0.009876543209876543,0.29259259259259257
2784,2010785,503,64,47,77,439,503,1.0,0.1272365805168986,0.8727634194831014,379,0.09343936381709742,0.15308151093439365,0.7534791252485089
2785,2010786,1641,2,303,153,1639,1641,1.0,0.001218769043266301,0.9987812309567337,1185,0.1846435100548446,0.09323583180987204,0.7221206581352834
2786,2010787,729,71,148,75,658,729,1.0,0.09739368998628258,0.9026063100137174,506,0.2030178326474623,0.102880658436214,0.6941015089163237
2787,2010788,23,4,3,1,19,23,1.0,0.17391304347826086,0.8260869565217391,19,0.13043478260869565,0.043478260869565216,0.8260869565217391
2788,2010789,3489,654,662,1067,2835,3489,1.0,0.1874462596732588,0.8125537403267412,1760,0.18973918028088277,0.3058182860418458,0.5044425336772714
2789,2010790,3284,845,623,588,2439,3284,1.0,0.25730816077953717,0.7426918392204629,2073,0.1897076735688185,0.17904993909866018,0.6312423873325214
2790,2010791,37,11,7,1,26,37,1.0,0.2972972972972973,0.7027027027027027,29,0.1891891891891892,0.02702702702702703,0.7837837837837838
2791,2010792,1987,453,696,232,1534,1987,1.0,0.2279818822345244,0.7720181177654756,1059,0.35027679919476595,0.116758933064922,0.532964267740312
2792,2010793,4066,481,489,710,3585,4066,1.0,0.11829808165272995,0.8817019183472701,2867,0.12026561731431382,0.17461878996556812,0.705115592720118
2793,2010795,2093,11,324,177,2082,2093,1.0,0.005255613951266125,0.9947443860487338,1592,0.15480172001911133,0.08456760630673674,0.7606306736741519
2794,2010796,4556,688,738,684,3868,4556,1.0,0.15100965759438104,0.848990342405619,3134,0.16198419666374012,0.15013169446883232,0.6878841088674276
2796,2010798,576,32,292,142,544,576,1.0,0.05555555555555555,0.9444444444444444,142,0.5069444444444444,0.2465277777777778,0.2465277777777778
2797,2010799,228,115,58,16,113,228,1.0,0.5043859649122807,0.4956140350877193,154,0.2543859649122807,0.07017543859649122,0.6754385964912281
2798,2010800,4902,533,944,1697,4369,4902,1.0,0.1087311301509588,0.8912688698490412,2261,0.19257445940432477,0.34618523051815586,0.46124031007751937
2799,2010801,357,22,81,40,335,357,1.0,0.06162464985994398,0.938375350140056,236,0.226890756302521,0.11204481792717087,0.6610644257703081
2800,2010802,327,47,106,39,280,327,1.0,0.1437308868501529,0.8562691131498471,182,0.3241590214067278,0.11926605504587157,0.5565749235474006
2801,2010803,4163,322,698,1830,3841,4163,1.0,0.07734806629834254,0.9226519337016574,1635,0.16766754744174875,0.4395868364160461,0.39274561614220516
2802,2010804,6527,913,1037,1664,5614,6527,1.0,0.139880496399571,0.860119503600429,3826,0.1588785046728972,0.2549410142485062,0.5861804810785965
2803,2010805,2593,194,340,1653,2399,2593,1.0,0.07481681450057848,0.9251831854994215,600,0.13112225221750867,0.6374855379868878,0.23139220979560354
2804,2010806,1721,197,215,470,1524,1721,1.0,0.11446833236490413,0.8855316676350958,1036,0.12492736780941313,0.27309703660662404,0.6019755955839629
2805,2010807,3142,1268,875,160,1874,3142,1.0,0.40356460852959897,0.596435391470401,2107,0.2784850413749204,0.050922978994271166,0.6705919796308084
2806,2010808,182,29,32,31,153,182,1.0,0.15934065934065933,0.8406593406593407,119,0.17582417582417584,0.17032967032967034,0.6538461538461539
2807,2010809,151,17,17,10,134,151,1.0,0.11258278145695365,0.8874172185430463,124,0.11258278145695365,0.06622516556291391,0.8211920529801324
2808,2010810,214,139,57,20,75,214,1.0,0.6495327102803738,0.35046728971962615,137,0.26635514018691586,0.09345794392523364,0.6401869158878505
2809,2010811,304,34,111,30,270,304,1.0,0.1118421052631579,0.8881578947368421,163,0.3651315789473684,0.09868421052631579,0.5361842105263158
2811,2010813,4278,787,898,836,3491,4278,1.0,0.18396446937821412,0.8160355306217859,2544,0.2099111734455353,0.1954184198223469,0.5946704067321178
2812,2010814,6594,2993,1974,583,3601,6594,1.0,0.4538974825599029,0.5461025174400971,4037,0.29936305732484075,0.08841370943281772,0.6122232332423415
2814,2010816,124,41,26,6,83,124,1.0,0.33064516129032256,0.6693548387096774,92,0.20967741935483872,0.04838709677419355,0.7419354838709677
2815,2010817,5756,580,709,2030,5176,5756,1.0,0.10076441973592773,0.8992355802640722,3017,0.12317581653926338,0.35267546907574704,0.5241487143849896
2816,2010818,1480,491,181,49,989,1480,1.0,0.33175675675675675,0.6682432432432432,1250,0.1222972972972973,0.03310810810810811,0.8445945945945946
2817,2010819,170,24,42,107,146,170,1.0,0.1411764705882353,0.8588235294117647,21,0.24705882352941178,0.6294117647058823,0.12352941176470589
2819,2010821,2169,957,491,50,1212,2169,1.0,0.4412171507607192,0.5587828492392808,1628,0.22637159981558322,0.023052097740894423,0.7505763024435224
2820,2010822,1606,1455,829,25,151,1606,1.0,0.9059775840597758,0.09402241594022416,752,0.5161892901618929,0.015566625155666251,0.46824408468244083
2821,2010823,3469,318,662,755,3151,3469,1.0,0.09166906889593543,0.9083309311040646,2052,0.19083309311040647,0.2176419717497838,0.5915249351398097
2822,2010824,3471,1346,1096,326,2125,3471,1.0,0.3877845001440507,0.6122154998559493,2049,0.3157591472198214,0.09392106021319505,0.5903197925669835
2823,2010825,38,34,13,5,4,38,1.0,0.8947368421052632,0.10526315789473684,20,0.34210526315789475,0.13157894736842105,0.5263157894736842
2824,2010826,237,15,90,146,222,237,1.4047619047619047,0.06329113924050633,0.9367088607594937,1,0.379746835443038,0.6160337552742616,0.004219409282700422
2825,2010827,1421,52,205,139,1369,1421,1.0,0.036593947923997186,0.9634060520760028,1077,0.1442646023926812,0.09781843771991555,0.7579169598874033
2826,2010828,1704,12,222,1168,1692,1704,1.0,0.007042253521126761,0.9929577464788732,314,0.13028169014084506,0.6854460093896714,0.18427230046948356
2827,2010829,162,61,128,33,101,162,1.0,0.3765432098765432,0.6234567901234568,1,0.7901234567901234,0.2037037037037037,0.006172839506172839
2829,2010831,42,0,8,9,42,42,1.0,0.0,1.0,25,0.19047619047619047,0.21428571428571427,0.5952380952380952
2830,2010832,574,232,106,44,342,574,1.0,0.40418118466898956,0.5958188153310104,424,0.18466898954703834,0.07665505226480836,0.7386759581881533
2831,2010833,16,4,9,0,12,16,1.0,0.25,0.75,7,0.5625,0.0,0.4375
2832,2010834,305,220,158,11,85,305,1.0,0.7213114754098361,0.2786885245901639,136,0.5180327868852459,0.036065573770491806,0.4459016393442623
2833,2010835,285,6,86,39,279,285,1.0,0.021052631578947368,0.9789473684210527,160,0.3017543859649123,0.1368421052631579,0.5614035087719298
2834,2010836,326,133,151,5,193,326,1.0,0.40797546012269936,0.5920245398773006,170,0.46319018404907975,0.015337423312883436,0.5214723926380368
2837,2010839,1471,455,464,113,1016,1471,1.0,0.30931339225016996,0.69068660774983,894,0.31543167912984366,0.07681849082256968,0.6077498300475866
2838,2010840,2657,1163,617,324,1494,2657,1.0,0.4377117049303726,0.5622882950696274,1716,0.23221678584870153,0.12194203989461799,0.6458411742566804
2839,2010841,4748,1944,1174,606,2804,4748,1.0,0.409435551811289,0.590564448188711,2968,0.2472620050547599,0.12763268744734624,0.6251053074978938
2840,2010842,5386,1741,878,772,3645,5386,1.0,0.3232454511696992,0.6767545488303007,3736,0.16301522465651688,0.1433345711102859,0.6936502042331972
2841,2010843,1686,577,643,129,1109,1686,1.0,0.34223013048635825,0.6577698695136418,914,0.38137603795966785,0.07651245551601424,0.5421115065243179
2842,2010844,17,4,5,1,13,17,1.0,0.23529411764705882,0.7647058823529411,11,0.29411764705882354,0.058823529411764705,0.6470588235294118
2843,2010845,623,80,32,61,543,623,1.0,0.12841091492776885,0.8715890850722311,530,0.051364365971107544,0.09791332263242375,0.8507223113964687
2844,2010846,212,55,93,4,157,212,1.0,0.25943396226415094,0.7405660377358491,115,0.4386792452830189,0.018867924528301886,0.5424528301886793
2845,2010847,3561,1791,801,296,1770,3561,1.0,0.5029486099410277,0.4970513900589722,2464,0.22493681550126368,0.08312271833754563,0.6919404661611906
2846,2010848,2203,1045,813,383,1158,2203,1.0,0.4743531547889242,0.5256468452110759,1007,0.3690422151611439,0.17385383567862006,0.45710394916023606
2847,2010849,3181,485,666,368,2696,3181,1.0,0.1524677774284816,0.8475322225715184,2147,0.20936812323168816,0.11568689091480666,0.6749449858535052
2848,2010850,145,15,75,48,130,145,1.0,0.10344827586206896,0.896551724137931,22,0.5172413793103449,0.3310344827586207,0.15172413793103448
2849,2010851,5181,491,677,1417,4690,5181,1.0,0.0947693495464196,0.9052306504535804,3087,0.13066975487357652,0.27349932445473846,0.595830920671685
2851,2010853,2963,318,441,1594,2645,2963,1.0,0.10732365845426932,0.8926763415457307,928,0.14883563955450557,0.5379682753965576,0.31319608504893687
2852,2010854,153,85,64,6,68,153,1.0,0.5555555555555556,0.4444444444444444,83,0.41830065359477125,0.0392156862745098,0.5424836601307189
2853,2010855,204,144,7,9,60,204,1.0,0.7058823529411765,0.29411764705882354,188,0.03431372549019608,0.04411764705882353,0.9215686274509803
2856,2010858,380,242,143,3,138,380,1.0,0.6368421052631579,0.3631578947368421,234,0.3763157894736842,0.007894736842105263,0.6157894736842106
2857,2010859,1189,353,400,104,836,1189,1.0,0.2968881412952061,0.703111858704794,685,0.33641715727502103,0.08746846089150546,0.5761143818334735
2859,2010861,3350,1572,816,181,1778,3350,1.0,0.4692537313432836,0.5307462686567164,2353,0.2435820895522388,0.054029850746268655,0.7023880597014925
2860,2010863,661,481,266,10,180,661,1.0,0.7276853252647504,0.2723146747352496,385,0.40242057488653554,0.015128593040847202,0.5824508320726173
2861,2010864,3215,594,794,275,2621,3215,1.0,0.18475894245723173,0.8152410575427683,2146,0.24696734059097977,0.08553654743390357,0.6674961119751166
2862,2010865,9,7,8,0,2,9,1.6,0.7777777777777778,0.2222222222222222,1,0.8888888888888888,0.0,0.1111111111111111
2865,2010868,3316,514,770,353,2802,3316,1.0,0.15500603136308805,0.8449939686369119,2193,0.2322074788902292,0.10645355850422196,0.6613389626055488
2866,2010869,695,180,191,33,515,695,1.0,0.2589928057553957,0.7410071942446043,471,0.27482014388489207,0.04748201438848921,0.6776978417266187
2868,2010871,3,0,3,0,3,3,3.0,0.0,1.0,0,1.0,0.0,0.0
2869,2010872,68,0,7,10,68,68,1.0,0.0,1.0,51,0.10294117647058823,0.14705882352941177,0.75
2870,2010873,1285,569,286,90,716,1285,1.0,0.44280155642023344,0.5571984435797666,909,0.222568093385214,0.07003891050583658,0.7073929961089495
2871,2010874,3462,198,489,1740,3264,3462,1.0,0.05719237435008666,0.9428076256499134,1233,0.1412478336221837,0.5025996533795494,0.3561525129982669
2872,2010875,4356,940,702,658,3416,4356,1.0,0.2157943067033976,0.7842056932966024,2996,0.16115702479338842,0.15105601469237834,0.6877869605142333
2873,2010876,4260,303,600,1635,3957,4260,1.0,0.07112676056338028,0.9288732394366197,2025,0.14084507042253522,0.38380281690140844,0.4753521126760563
2874,2010877,4215,1213,950,691,3002,4215,1.0,0.2877817319098458,0.7122182680901542,2574,0.22538552787663108,0.16393831553973903,0.61067615658363
2875,2010878,1144,13,54,439,1131,1144,1.0,0.011363636363636364,0.9886363636363636,651,0.0472027972027972,0.38374125874125875,0.5690559440559441
2876,2010879,3560,485,722,657,3075,3560,1.0,0.13623595505617977,0.8637640449438202,2181,0.20280898876404493,0.1845505617977528,0.6126404494382023
2877,2010880,2965,325,329,1176,2640,2965,1.0,0.10961214165261383,0.8903878583473862,1460,0.11096121416526138,0.39662731871838114,0.4924114671163575
2878,2010881,8432,2115,1584,758,6317,8432,1.0,0.25083017077798864,0.7491698292220114,6090,0.18785578747628084,0.08989563567362428,0.7222485768500949
2879,2010882,6881,934,1353,957,5947,6881,1.0,0.13573608487138497,0.864263915128615,4571,0.19662839703531462,0.13907862229327134,0.6642929806714141
2880,2010883,7356,3127,2187,471,4229,7356,1.0,0.42509516041326806,0.5749048395867319,4698,0.2973083197389886,0.06402936378466557,0.6386623164763459
2881,2010884,507,263,133,24,244,507,1.0,0.5187376725838264,0.4812623274161736,350,0.26232741617357,0.047337278106508875,0.6903353057199211
2882,2010885,3700,685,674,1053,3015,3700,1.0,0.18513513513513513,0.8148648648648649,1973,0.18216216216216216,0.2845945945945946,0.5332432432432432
2883,2010886,1274,40,197,237,1234,1274,1.0,0.03139717425431711,0.9686028257456829,840,0.1546310832025118,0.18602825745682888,0.6593406593406593
2884,2010887,304,6,86,131,298,304,1.0,0.019736842105263157,0.9802631578947368,87,0.28289473684210525,0.4309210526315789,0.28618421052631576
2885,2010888,2001,419,570,264,1582,2001,1.0,0.20939530234882558,0.7906046976511744,1167,0.2848575712143928,0.13193403298350825,0.5832083958020989
2886,2010889,583,275,9,12,308,583,1.0,0.4716981132075472,0.5283018867924528,562,0.015437392795883362,0.02058319039451115,0.9639794168096055
2887,2010890,1816,438,258,172,1378,1816,1.0,0.24118942731277532,0.7588105726872246,1386,0.1420704845814978,0.0947136563876652,0.763215859030837
2888,2010891,1653,195,526,384,1458,1653,1.0,0.11796733212341198,0.8820326678765881,743,0.31820931639443434,0.2323049001814882,0.4494857834240774
2889,2010892,1029,217,221,94,812,1029,1.0,0.2108843537414966,0.7891156462585034,714,0.21477162293488825,0.0913508260447036,0.6938775510204082
2890,2010893,6,5,1,0,1,6,1.0,0.8333333333333334,0.16666666666666666,5,0.16666666666666666,0.0,0.8333333333333334
2891,2010894,3675,2400,799,117,1275,3675,1.0,0.6530612244897959,0.3469387755102041,2759,0.21741496598639456,0.03183673469387755,0.7507482993197279
2892,2010895,674,0,373,301,674,674,1.1013071895424837,0.0,1.0,0,0.5534124629080118,0.4465875370919881,0.0
2893,2010896,1360,32,561,387,1328,1360,1.0,0.023529411764705882,0.9764705882352941,412,0.4125,0.28455882352941175,0.3029411764705882
2894,2010897,2720,363,478,609,2357,2720,1.0,0.13345588235294117,0.8665441176470589,1633,0.17573529411764705,0.22389705882352942,0.6003676470588235
2895,2010898,1237,294,494,423,943,1237,1.0,0.23767178658043653,0.7623282134195635,320,0.3993532740501213,0.3419563459983832,0.2586903799514956
2896,2010899,1237,103,205,695,1134,1237,1.0,0.08326596604688763,0.9167340339531124,337,0.16572352465642684,0.5618431689571544,0.27243330638641877
2897,2010900,18,4,4,1,14,18,1.0,0.2222222222222222,0.7777777777777778,13,0.2222222222222222,0.05555555555555555,0.7222222222222222
2899,2010902,2956,121,576,869,2835,2956,1.0,0.040933694181326113,0.9590663058186739,1511,0.19485791610284167,0.293978349120433,0.5111637347767253
2900,2010903,5211,442,439,1400,4769,5211,1.0,0.08482057186720399,0.915179428132796,3372,0.08424486662828631,0.2686624448282479,0.6470926885434658
2901,2010904,1,0,1,0,1,1,1.0,0.0,1.0,0,1.0,0.0,0.0
2902,2010905,1161,89,260,186,1072,1161,1.0,0.07665805340223945,0.9233419465977606,715,0.2239448751076658,0.16020671834625322,0.615848406546081
2903,2010906,25,0,9,9,25,25,1.0,0.0,1.0,7,0.36,0.36,0.28
2904,2010907,226,113,81,21,113,226,1.0,0.5,0.5,124,0.3584070796460177,0.09292035398230089,0.5486725663716814
2906,2010909,33,3,5,6,30,33,1.0,0.09090909090909091,0.9090909090909091,22,0.15151515151515152,0.18181818181818182,0.6666666666666666
2907,2010910,311,30,48,37,281,311,1.0,0.09646302250803858,0.9035369774919614,226,0.15434083601286175,0.1189710610932476,0.7266881028938906
2908,2010911,989,271,90,208,718,989,1.0,0.27401415571284127,0.7259858442871587,691,0.0910010111223458,0.2103134479271992,0.698685540950455
2909,2010912,1694,225,309,572,1469,1694,1.0,0.13282172373081463,0.8671782762691853,813,0.18240850059031877,0.33766233766233766,0.47992916174734357
2910,2010913,367,45,60,20,322,367,1.0,0.1226158038147139,0.8773841961852861,287,0.16348773841961853,0.05449591280653951,0.782016348773842
2911,2010914,248,101,51,15,147,248,1.0,0.40725806451612906,0.592741935483871,182,0.2056451612903226,0.06048387096774194,0.7338709677419355
2913,2010916,2097,126,124,650,1971,2097,1.0,0.060085836909871244,0.9399141630901288,1323,0.05913209346685742,0.3099666189794945,0.630901287553648
2914,2010917,95,21,39,2,74,95,1.0,0.22105263157894736,0.7789473684210526,54,0.4105263157894737,0.021052631578947368,0.5684210526315789
2915,2010918,220,37,0,1,183,220,1.0,0.16818181818181818,0.8318181818181818,219,0.0,0.004545454545454545,0.9954545454545455
2916,2010919,4,1,1,2,3,4,1.0,0.25,0.75,1,0.25,0.5,0.25
2917,2010920,85,5,15,27,80,85,1.0,0.058823529411764705,0.9411764705882353,43,0.17647058823529413,0.3176470588235294,0.5058823529411764
2918,2010921,53,24,31,5,29,53,1.0,0.4528301886792453,0.5471698113207547,17,0.5849056603773585,0.09433962264150944,0.32075471698113206
2919,2010923,4742,721,483,1381,4021,4742,1.0,0.15204555040067483,0.8479544495993252,2878,0.10185575706452973,0.29122733024040487,0.6069169126950654
2922,2010926,985,27,107,364,958,985,1.0,0.027411167512690356,0.9725888324873097,514,0.10862944162436548,0.3695431472081218,0.5218274111675127
2923,2010927,1690,32,405,571,1658,1690,1.0,0.01893491124260355,0.9810650887573964,714,0.23964497041420119,0.3378698224852071,0.42248520710059173
2924,2010928,7,2,6,0,5,7,1.2,0.2857142857142857,0.7142857142857143,1,0.8571428571428571,0.0,0.14285714285714285
2926,2010930,952,284,268,4,668,952,1.0,0.29831932773109243,0.7016806722689075,680,0.2815126050420168,0.004201680672268907,0.7142857142857143
2927,2010931,111,3,42,58,108,111,1.0,0.02702702702702703,0.972972972972973,11,0.3783783783783784,0.5225225225225225,0.0990990990990991
2929,2010933,1124,409,257,91,715,1124,1.0,0.3638790035587189,0.6361209964412812,776,0.22864768683274023,0.0809608540925267,0.6903914590747331
2931,2010935,66,0,14,11,66,66,1.0,0.0,1.0,41,0.21212121212121213,0.16666666666666666,0.6212121212121212
2932,2010936,159,115,14,7,44,159,1.0,0.7232704402515723,0.27672955974842767,138,0.0880503144654088,0.0440251572327044,0.8679245283018868
2934,2010938,303,95,56,27,208,303,1.0,0.31353135313531355,0.6864686468646864,220,0.1848184818481848,0.0891089108910891,0.7260726072607261
2936,2010940,38,9,9,1,29,38,1.0,0.23684210526315788,0.7631578947368421,28,0.23684210526315788,0.02631578947368421,0.7368421052631579
2937,2010941,1146,290,148,182,856,1146,1.0,0.2530541012216405,0.7469458987783595,816,0.12914485165794065,0.15881326352530542,0.7120418848167539
2938,2010942,162,10,14,76,152,162,1.0,0.06172839506172839,0.9382716049382716,72,0.08641975308641975,0.4691358024691358,0.4444444444444444
2939,2010943,1015,250,212,54,765,1015,1.0,0.24630541871921183,0.7536945812807881,749,0.20886699507389161,0.053201970443349754,0.7379310344827587
2941,2010945,11,0,11,0,11,11,1.1,0.0,1.0,0,1.0,0.0,0.0
2942,2010946,16,0,6,0,16,16,1.0,0.0,1.0,10,0.375,0.0,0.625
2943,2010947,875,20,266,327,855,875,1.0,0.022857142857142857,0.9771428571428571,282,0.304,0.3737142857142857,0.3222857142857143
2944,2010948,5,2,0,0,3,5,1.0,0.4,0.6,5,0.0,0.0,1.0
2945,2010949,180,3,48,45,177,180,1.0,0.016666666666666666,0.9833333333333333,87,0.26666666666666666,0.25,0.48333333333333334
2946,2010951,476,180,94,27,296,476,1.0,0.37815126050420167,0.6218487394957983,355,0.19747899159663865,0.05672268907563025,0.7457983193277311
2947,2010952,78,33,16,23,45,78,1.0,0.4230769230769231,0.5769230769230769,39,0.20512820512820512,0.2948717948717949,0.5
2948,2010953,5,1,4,0,4,5,1.0,0.2,0.8,1,0.8,0.0,0.2
2949,2010954,2,0,0,0,2,2,1.0,0.0,1.0,2,0.0,0.0,1.0
2950,2010955,3199,127,366,1508,3072,3199,1.0,0.03969990622069397,0.960300093779306,1325,0.11441075336042514,0.47139731165989374,0.41419193497968115
2951,2010956,10,0,3,4,10,10,1.0,0.0,1.0,3,0.3,0.4,0.3
2952,2010957,745,333,312,60,412,745,1.0,0.4469798657718121,0.553020134228188,373,0.41879194630872485,0.08053691275167785,0.5006711409395973
2953,2010958,1417,628,445,128,789,1417,1.0,0.44318983768525055,0.5568101623147494,844,0.3140437544107269,0.0903316866619619,0.5956245589273113
2954,2010959,4,2,4,0,2,4,2.0,0.5,0.5,0,1.0,0.0,0.0
2955,2010960,939,436,368,130,503,939,1.0,0.4643237486687966,0.5356762513312034,441,0.3919062832800852,0.13844515441959532,0.4696485623003195
2956,2010961,2921,1333,884,215,1588,2921,1.0,0.4563505648750428,0.5436494351249572,1822,0.3026360835330366,0.07360492981855529,0.6237589866484081
2957,2010962,6132,3536,28,7,2596,6132,1.0,0.5766470971950424,0.4233529028049576,6097,0.0045662100456621,0.001141552511415525,0.9942922374429224
2958,2010963,598,152,75,114,446,598,1.0,0.25418060200668896,0.745819397993311,409,0.1254180602006689,0.19063545150501673,0.6839464882943144
2959,2010964,2566,649,517,858,1917,2566,1.0,0.2529228371005456,0.7470771628994544,1191,0.2014809041309431,0.3343725643024162,0.4641465315666407
2960,2010965,1077,272,38,79,805,1077,1.0,0.2525533890436397,0.7474466109563602,960,0.035283194057567316,0.0733519034354689,0.8913649025069638
2961,2010966,2750,765,323,134,1985,2750,1.0,0.2781818181818182,0.7218181818181818,2293,0.11745454545454545,0.04872727272727273,0.8338181818181818
2962,2010967,390,132,37,26,258,390,1.0,0.3384615384615385,0.6615384615384615,327,0.09487179487179487,0.06666666666666667,0.8384615384615385
2963,2010968,1346,340,262,59,1006,1346,1.0,0.2526002971768202,0.7473997028231798,1025,0.19465081723625557,0.043833580980683504,0.7615156017830609
2964,2010969,611,565,411,1,46,611,1.0,0.9247135842880524,0.07528641571194762,199,0.6726677577741408,0.0016366612111292963,0.32569558101472995
2965,2010970,1404,674,255,29,730,1404,1.0,0.48005698005698005,0.51994301994302,1120,0.18162393162393162,0.020655270655270654,0.7977207977207977
2968,2010973,1679,128,178,373,1551,1679,1.0,0.07623585467540203,0.9237641453245979,1128,0.10601548540798095,0.2221560452650387,0.6718284693269804
2970,2010975,189,36,59,52,153,189,1.0,0.19047619047619047,0.8095238095238095,78,0.31216931216931215,0.2751322751322751,0.4126984126984127
2971,2010976,1198,74,99,183,1124,1198,1.0,0.06176961602671119,0.9382303839732888,916,0.08263772954924875,0.15275459098497496,0.7646076794657763
2972,2010977,915,120,112,72,795,915,1.0,0.13114754098360656,0.8688524590163934,731,0.12240437158469945,0.07868852459016394,0.7989071038251366
2973,2010978,2,0,0,0,2,2,1.0,0.0,1.0,2,0.0,0.0,1.0
2975,2010980,1168,72,222,709,1096,1168,1.0,0.06164383561643835,0.9383561643835616,237,0.19006849315068494,0.6070205479452054,0.2029109589041096
2976,2010981,51,46,12,3,5,51,1.0,0.9019607843137255,0.09803921568627451,36,0.23529411764705882,0.058823529411764705,0.7058823529411765
2977,2010982,1955,91,147,641,1864,1955,1.0,0.046547314578005115,0.9534526854219949,1167,0.07519181585677749,0.3278772378516624,0.5969309462915601
2978,2010983,454,31,29,39,423,454,1.0,0.06828193832599119,0.9317180616740088,386,0.06387665198237885,0.08590308370044053,0.8502202643171806
2979,2010984,610,297,132,7,313,610,1.0,0.48688524590163934,0.5131147540983606,471,0.21639344262295082,0.011475409836065573,0.7721311475409836
2980,2010985,612,183,110,122,429,612,1.0,0.29901960784313725,0.7009803921568627,380,0.17973856209150327,0.19934640522875818,0.6209150326797386
2981,2010986,866,371,191,21,495,866,1.0,0.4284064665127021,0.5715935334872979,654,0.22055427251732102,0.02424942263279446,0.7551963048498845
2982,2010987,734,225,586,56,509,734,1.0,0.3065395095367847,0.6934604904632152,92,0.7983651226158038,0.07629427792915532,0.12534059945504086
2983,2010988,197,43,9,54,154,197,1.0,0.2182741116751269,0.7817258883248731,134,0.04568527918781726,0.27411167512690354,0.6802030456852792
2985,2010990,120,23,7,15,97,120,1.0,0.19166666666666668,0.8083333333333333,98,0.058333333333333334,0.125,0.8166666666666667
2986,2010991,4,0,0,0,4,4,1.0,0.0,1.0,4,0.0,0.0,1.0
2987,2010992,1310,145,208,282,1165,1310,1.0,0.11068702290076336,0.8893129770992366,820,0.15877862595419848,0.2152671755725191,0.6259541984732825
2989,2010994,20,9,15,4,11,20,1.4615384615384615,0.45,0.55,1,0.75,0.2,0.05
2990,2010995,1565,877,735,38,688,1565,1.0,0.5603833865814697,0.43961661341853037,792,0.4696485623003195,0.02428115015974441,0.5060702875399361
2991,2010996,802,94,163,250,708,802,1.0,0.1172069825436409,0.8827930174563591,389,0.20324189526184538,0.3117206982543641,0.4850374064837905
2992,2010997,3286,1909,622,119,1377,3286,1.0,0.5809494826536823,0.4190505173463177,2545,0.18928788800973828,0.03621424223980523,0.7744978697504565
2993,2010998,42,6,7,17,36,42,1.0,0.14285714285714285,0.8571428571428571,18,0.16666666666666666,0.40476190476190477,0.42857142857142855
2995,2011000,707,218,88,16,489,707,1.0,0.30834512022630833,0.6916548797736917,603,0.12446958981612447,0.02263083451202263,0.8528995756718529
2996,2011001,2351,1323,606,164,1028,2351,1.0,0.5627392598894088,0.43726074011059124,1581,0.2577626541897065,0.06975754997873246,0.672479795831561
2997,2011002,2704,923,668,90,1781,2704,1.0,0.34134615384615385,0.6586538461538461,1946,0.2470414201183432,0.03328402366863906,0.7196745562130178
2999,2011004,713,96,156,200,617,713,1.0,0.13464235624123422,0.8653576437587658,357,0.2187938288920056,0.2805049088359046,0.5007012622720898
3002,2011007,2810,1259,627,212,1551,2810,1.0,0.4480427046263345,0.5519572953736654,1971,0.22313167259786476,0.07544483985765124,0.701423487544484
3003,2011008,1413,125,140,479,1288,1413,1.0,0.08846426043878274,0.9115357395612173,794,0.09907997169143666,0.33899504600141545,0.5619249823071479
3005,2011010,942,404,158,33,538,942,1.0,0.4288747346072187,0.5711252653927813,751,0.16772823779193205,0.03503184713375796,0.79723991507431
3006,2011011,20,0,9,5,20,20,1.0,0.0,1.0,6,0.45,0.25,0.3
3007,2011012,1625,380,510,188,1245,1625,1.0,0.23384615384615384,0.7661538461538462,927,0.31384615384615383,0.11569230769230769,0.5704615384615385
3008,2030001,2110,314,445,1028,1796,2110,1.0,0.14881516587677726,0.8511848341232228,637,0.2109004739336493,0.4872037914691943,0.3018957345971564
3009,2030002,2799,1569,805,383,1230,2799,1.0,0.5605573419078242,0.43944265809217575,1611,0.2876027152554484,0.1368345837799214,0.5755627009646302
3010,2030003,2836,1955,1572,106,881,2836,1.0,0.6893511988716502,0.3106488011283498,1158,0.5543018335684062,0.03737658674188998,0.4083215796897038
3011,2030004,2111,684,518,633,1427,2111,1.0,0.3240170535291331,0.6759829464708669,960,0.24538133585978208,0.29985788725722407,0.4547607768829938
3012,2030005,1063,83,173,453,980,1063,1.0,0.07808090310442145,0.9219190968955786,437,0.1627469426152399,0.4261523988711195,0.41110065851364064
3013,2030006,1473,319,217,611,1154,1473,1.0,0.21656483367277665,0.7834351663272233,645,0.14731839782756279,0.4147997284453496,0.4378818737270876
3014,2030007,984,215,180,406,769,984,1.0,0.2184959349593496,0.7815040650406504,398,0.18292682926829268,0.41260162601626016,0.40447154471544716
3015,2030008,2921,498,397,1359,2423,2921,1.0,0.1704895583704211,0.8295104416295789,1165,0.1359123587812393,0.4652516261554262,0.3988360150633345
3016,2030009,1312,306,294,629,1006,1312,1.0,0.23323170731707318,0.7667682926829268,389,0.22408536585365854,0.4794207317073171,0.2964939024390244
3017,2030010,881,82,147,591,799,881,1.0,0.09307604994324631,0.9069239500567536,143,0.16685584562996594,0.6708286038592508,0.1623155505107832
3018,2030011,615,154,140,151,461,615,1.0,0.25040650406504067,0.7495934959349594,324,0.22764227642276422,0.24552845528455283,0.526829268292683
3019,2030012,5461,322,348,2191,5139,5461,1.0,0.05896355978758469,0.9410364402124153,2922,0.0637245925654642,0.40120856985900016,0.5350668375755356
3020,2030013,1031,131,80,689,900,1031,1.0,0.1270611057225994,0.8729388942774006,262,0.07759456838021339,0.6682832201745877,0.2541222114451988
3021,2030014,1673,258,245,628,1415,1673,1.0,0.15421398684997012,0.8457860131500299,800,0.14644351464435146,0.3753735803945009,0.4781829049611476
3022,2030015,1033,59,63,564,974,1033,1.0,0.057115198451113264,0.9428848015488868,406,0.06098741529525654,0.5459825750242013,0.39303000968054214
3023,2030016,636,78,73,281,558,636,1.0,0.12264150943396226,0.8773584905660378,282,0.11477987421383648,0.4418238993710692,0.44339622641509435
3024,2030017,1677,409,543,437,1268,1677,1.0,0.24388789505068575,0.7561121049493142,697,0.32379248658318427,0.26058437686344665,0.41562313655336913
3025,2030018,792,126,92,419,666,792,1.0,0.1590909090909091,0.8409090909090909,281,0.11616161616161616,0.5290404040404041,0.3547979797979798
3026,2030019,3711,304,342,1441,3407,3711,1.0,0.08191862031797359,0.9180813796820264,1928,0.09215844785772029,0.38830503907302616,0.5195365130692535
3027,2030020,2931,896,414,1125,2035,2931,1.0,0.305697714090754,0.694302285909246,1392,0.14124872057318322,0.38382804503582396,0.4749232343909928
3028,2030021,672,149,192,297,523,672,1.0,0.22172619047619047,0.7782738095238095,183,0.2857142857142857,0.4419642857142857,0.27232142857142855
3029,2030022,2346,1091,696,424,1255,2346,1.0,0.46504688832054564,0.5349531116794544,1226,0.2966751918158568,0.18073316283034954,0.5225916453537937
3030,2030023,454,5,34,247,449,454,1.0,0.011013215859030838,0.9889867841409692,173,0.07488986784140969,0.5440528634361234,0.381057268722467
3031,2030024,418,31,94,245,387,418,1.0,0.07416267942583732,0.9258373205741627,79,0.22488038277511962,0.5861244019138756,0.18899521531100477
3032,2030025,4614,514,287,1848,4100,4614,1.0,0.11140008669267447,0.8885999133073256,2479,0.06220199393151279,0.40052015604681407,0.5372778500216732
3033,2030026,543,107,65,326,436,543,1.0,0.19705340699815838,0.8029465930018416,152,0.11970534069981584,0.6003683241252302,0.27992633517495397
3034,2050101,404,18,19,197,386,404,1.0,0.04455445544554455,0.9554455445544554,188,0.04702970297029703,0.4876237623762376,0.46534653465346537
3035,2050102,158,30,11,146,128,158,1.0129032258064516,0.189873417721519,0.810126582278481,1,0.06962025316455696,0.9240506329113924,0.006329113924050633
3036,2050201,229,8,19,167,221,229,1.0,0.034934497816593885,0.9650655021834061,43,0.08296943231441048,0.7292576419213974,0.18777292576419213
3037,2050202,445,28,28,300,417,445,1.0,0.06292134831460675,0.9370786516853933,117,0.06292134831460675,0.6741573033707865,0.26292134831460673
3038,2050301,809,12,48,504,797,809,1.0,0.014833127317676144,0.9851668726823238,257,0.059332509270704575,0.622991347342398,0.3176761433868974
3039,2050401,2103,396,59,394,1707,2103,1.0,0.18830242510699002,0.81169757489301,1650,0.028055159296243463,0.1873514027579648,0.7845934379457917
3040,2070001,343,4,50,206,339,343,1.0,0.011661807580174927,0.9883381924198251,87,0.1457725947521866,0.6005830903790087,0.2536443148688047
3041,2070002,923,83,124,284,840,923,1.0,0.08992416034669556,0.9100758396533044,515,0.13434452871072589,0.3076923076923077,0.5579631635969664
3042,2070003,718,28,99,217,690,718,1.0,0.03899721448467967,0.9610027855153204,402,0.13788300835654596,0.3022284122562674,0.5598885793871866
3043,2070004,302,3,40,123,299,302,1.0,0.009933774834437087,0.9900662251655629,139,0.13245033112582782,0.40728476821192056,0.4602649006622517
3044,2070005,521,2,75,154,519,521,1.0,0.003838771593090211,0.9961612284069098,292,0.14395393474088292,0.29558541266794625,0.5604606525911708
3045,2070006,493,22,76,159,471,493,1.0,0.04462474645030426,0.9553752535496958,258,0.15415821501014199,0.3225152129817444,0.5233265720081136
3046,2070007,166,8,8,45,158,166,1.0,0.04819277108433735,0.9518072289156626,113,0.04819277108433735,0.2710843373493976,0.6807228915662651
3047,2070008,170,9,31,57,161,170,1.0,0.052941176470588235,0.9470588235294117,82,0.18235294117647058,0.3352941176470588,0.4823529411764706
3048,2070009,264,0,27,105,264,264,1.0,0.0,1.0,132,0.10227272727272728,0.3977272727272727,0.5
3049,2070010,170,0,25,74,170,170,1.0,0.0,1.0,71,0.14705882352941177,0.43529411764705883,0.4176470588235294
3050,2090110,2137,80,338,400,2057,2137,1.0,0.03743565746373421,0.9625643425362658,1399,0.15816565278427702,0.18717828731867103,0.6546560598970519
3051,2090111,362,28,98,57,334,362,1.0,0.07734806629834254,0.9226519337016574,207,0.27071823204419887,0.1574585635359116,0.5718232044198895
3052,2090112,3038,98,730,231,2940,3038,1.0,0.03225806451612903,0.967741935483871,2077,0.24028966425279788,0.07603686635944701,0.6836734693877551
3053,2090113,6866,272,1152,606,6594,6866,1.0,0.03961549665016021,0.9603845033498398,5108,0.1677832799300903,0.08826099621322459,0.7439557238566851
3054,2090120,9105,1001,1239,701,8104,9105,1.0,0.1099395936298737,0.8900604063701263,7165,0.1360790774299835,0.07699066447007138,0.7869302580999451
3055,2090127,6794,576,913,959,6218,6794,1.0,0.08478068884309685,0.9152193111569031,4922,0.13438327936414485,0.14115395937591993,0.7244627612599353
3056,2090129,6259,335,1062,961,5924,6259,1.0,0.0535229269851414,0.9464770730148586,4236,0.16967566703946318,0.1535389039782713,0.6767854289822656
3057,2090221,5339,70,789,1037,5269,5339,1.0,0.01311106948866829,0.9868889305113318,3513,0.14778048323656115,0.19423112942498597,0.6579883873384529
3058,2090223,3722,166,636,552,3556,3722,1.0,0.0445996775926921,0.9554003224073079,2534,0.1708758731864589,0.14830736163353037,0.6808167651800108
3059,2090224,7529,63,1038,1519,7466,7529,1.0,0.008367645105591712,0.9916323548944083,4972,0.13786691459689202,0.20175322087926684,0.6603798645238411
3060,2090225,1359,46,330,667,1313,1359,1.0,0.03384841795437822,0.9661515820456218,362,0.24282560706401765,0.49080206033848417,0.26637233259749815
3061,2090226,2313,44,750,1071,2269,2313,1.0,0.019022913964548204,0.9809770860354518,492,0.324254215304799,0.46303501945525294,0.2127107652399481
3062,2090229,3881,36,393,278,3845,3881,1.0,0.009275959804174182,0.9907240401958258,3210,0.10126256119556815,0.07163102293223396,0.8271064158721979
3063,2090234,1831,80,243,194,1751,1831,1.0,0.04369197160021846,0.9563080283997816,1394,0.13271436373566356,0.10595303113052977,0.7613326051338066
3064,2090236,528,0,50,167,528,528,1.0,0.0,1.0,311,0.0946969696969697,0.3162878787878788,0.5890151515151515
3067,2090315,3173,13,752,1378,3160,3173,1.0,0.0040970690198550265,0.9959029309801449,1043,0.23699968484084463,0.43428931610463284,0.32871099905452256
3068,2090316,1650,53,246,320,1597,1650,1.0,0.03212121212121212,0.9678787878787879,1084,0.14909090909090908,0.19393939393939394,0.656969696969697
3069,2090317,1485,0,135,69,1485,1485,1.0,0.0,1.0,1281,0.09090909090909091,0.046464646464646465,0.8626262626262626
3070,2090318,130,13,33,23,117,130,1.0,0.1,0.9,74,0.25384615384615383,0.17692307692307693,0.5692307692307692
3071,2090330,2861,166,509,349,2695,2861,1.0,0.05802167074449493,0.9419783292555051,2003,0.17790982174065012,0.12198531981824537,0.7001048584411045
3072,2090332,4402,78,977,756,4324,4402,1.0,0.017719218537028625,0.9822807814629714,2669,0.2219445706497047,0.1717401181281236,0.6063153112221717
3073,2090334,4177,420,704,428,3757,4177,1.0,0.10055063442662197,0.8994493655733781,3045,0.168542015800814,0.10246588460617669,0.7289920995930094
3074,2090336,5577,36,903,1033,5541,5577,1.0,0.006455083378160301,0.9935449166218397,3641,0.16191500806885423,0.18522503137887752,0.6528599605522682
3075,2090337,4874,12,1015,1970,4862,4874,1.0,0.0024620434961017644,0.9975379565038982,1889,0.2082478457119409,0.404185473943373,0.3875666803446861
3076,2090414,2497,232,452,183,2265,2497,1.0,0.09291149379255106,0.907088506207449,1862,0.18101722066479775,0.07328794553464157,0.7456948338005607
3077,2090416,510,32,36,28,478,510,1.0,0.06274509803921569,0.9372549019607843,446,0.07058823529411765,0.054901960784313725,0.8745098039215686
3078,2090417,634,15,111,125,619,634,1.0,0.02365930599369085,0.9763406940063092,398,0.1750788643533123,0.1971608832807571,0.6277602523659306
3079,2090418,62,1,0,2,61,62,1.0,0.016129032258064516,0.9838709677419355,60,0.0,0.03225806451612903,0.967741935483871
3080,2090419,1862,56,280,444,1806,1862,1.0,0.03007518796992481,0.9699248120300752,1138,0.15037593984962405,0.23845327604726102,0.611170784103115
3081,2090440,1714,0,387,771,1714,1714,1.0,0.0,1.0,556,0.22578763127187865,0.4498249708284714,0.32438739789964993
3082,2090442,2265,0,596,829,2265,2265,1.0,0.0,1.0,840,0.2631346578366446,0.36600441501103753,0.3708609271523179
3083,2090443,4249,144,780,1613,4105,4249,1.0,0.033890327135796657,0.9661096728642034,1856,0.18357260531889857,0.3796187338197223,0.43680866086137915
3084,2090444,5305,18,1143,2291,5287,5305,1.0,0.0033930254476908575,0.9966069745523092,1871,0.21545711592836947,0.43185673892554194,0.3526861451460886
3085,2090447,2470,95,475,642,2375,2470,1.0,0.038461538461538464,0.9615384615384616,1353,0.19230769230769232,0.25991902834008096,0.5477732793522267
3086,2110101,492,4,43,287,488,492,1.0,0.008130081300813009,0.991869918699187,162,0.08739837398373984,0.5833333333333334,0.32926829268292684
3087,2110201,642,3,42,270,639,642,1.0,0.004672897196261682,0.9953271028037384,330,0.06542056074766354,0.4205607476635514,0.514018691588785
3088,2110202,22,0,0,22,22,22,1.1578947368421053,0.0,1.0,0,0.0,1.0,0.0
3089,2110301,503,8,43,327,495,503,1.0,0.015904572564612324,0.9840954274353877,133,0.08548707753479125,0.6500994035785288,0.2644135188866799
3090,2110302,35,0,0,32,35,35,1.0,0.0,1.0,3,0.0,0.9142857142857143,0.08571428571428572
3091,2110303,80,0,10,70,80,80,1.0666666666666667,0.0,1.0,0,0.125,0.875,0.0
3092,2110401,444,5,48,220,439,444,1.0,0.01126126126126126,0.9887387387387387,176,0.10810810810810811,0.4954954954954955,0.3963963963963964
3093,2110402,83,0,6,70,83,83,1.0,0.0,1.0,7,0.07228915662650602,0.8433734939759037,0.08433734939759036
3094,2130002,636,84,46,127,552,636,1.0,0.1320754716981132,0.8679245283018868,463,0.07232704402515723,0.19968553459119498,0.7279874213836478
3095,2130003,2168,829,541,172,1339,2168,1.0,0.382380073800738,0.617619926199262,1455,0.24953874538745388,0.07933579335793357,0.6711254612546126
3096,2130004,3617,318,432,1589,3299,3617,1.0,0.08791816422449544,0.9120818357755046,1596,0.11943599668233343,0.43931434890793475,0.4412496544097318
3097,213001A,2251,0,205,694,2251,2251,1.0,0.0,1.0,1352,0.09107063527321191,0.30830741892492225,0.6006219458018658
3098,213001M,2624,558,363,879,2066,2624,1.0,0.21265243902439024,0.7873475609756098,1382,0.13833841463414634,0.33498475609756095,0.5266768292682927
3099,213001T,2374,69,236,721,2305,2374,1.0,0.02906486941870261,0.9709351305812974,1417,0.09941027801179445,0.3037068239258635,0.5968828980623421
3100,213002E,2297,44,191,950,2253,2297,1.0,0.01915542011319112,0.9808445798868088,1156,0.08315193730953417,0.413582934262081,0.5032651284283849
3101,213003B,2787,29,183,1298,2758,2787,1.0,0.010405453893074991,0.989594546106925,1306,0.06566200215285253,0.46573376390383925,0.4686042339433082
3102,213003C,3590,356,405,1983,3234,3590,1.0,0.09916434540389972,0.9008356545961003,1202,0.11281337047353761,0.5523676880222841,0.3348189415041783
3103,213003M,1747,4,123,667,1743,1747,1.0,0.0022896393817973667,0.9977103606182026,957,0.07040641099026904,0.38179736691471095,0.54779622209502
3104,213003N,1633,75,202,782,1558,1633,1.0,0.04592774035517452,0.9540722596448254,649,0.12369871402327005,0.4788732394366197,0.3974280465401102
3105,213004A,1296,288,151,272,1008,1296,1.0,0.2222222222222222,0.7777777777777778,873,0.11651234567901235,0.20987654320987653,0.6736111111111112
3106,213004W,1198,17,94,504,1181,1198,1.0,0.014190317195325543,0.9858096828046744,600,0.07846410684474124,0.42070116861435725,0.5008347245409015
3107,21301CR,2946,89,169,1126,2857,2946,1.0,0.030210454854039375,0.9697895451459606,1651,0.05736591989137814,0.3822131704005431,0.5604209097080788
3108,21301MN,1383,36,167,445,1347,1383,1.0,0.026030368763557483,0.9739696312364425,771,0.12075198843094721,0.32176428054953,0.5574837310195228
3109,21301TC,3604,65,316,1101,3539,3604,1.0,0.018035516093229745,0.9819644839067703,2187,0.0876803551609323,0.3054938956714761,0.6068257491675916
3110,21303WS,2134,6,143,669,2128,2134,1.0,0.0028116213683223993,0.9971883786316776,1322,0.06701030927835051,0.3134957825679475,0.619493908153702
3111,21304BV,1308,98,101,365,1210,1308,1.0,0.07492354740061162,0.9250764525993884,842,0.077217125382263,0.2790519877675841,0.6437308868501529
3112,21304CC,1708,24,238,669,1684,1708,1.0,0.01405152224824356,0.9859484777517564,801,0.13934426229508196,0.3916861826697892,0.4689695550351288
3113,21304MS,580,383,199,109,197,580,1.0,0.6603448275862069,0.3396551724137931,272,0.3431034482758621,0.1879310344827586,0.4689655172413793
3114,21304PF,616,52,50,228,564,616,1.0,0.08441558441558442,0.9155844155844156,338,0.08116883116883117,0.37012987012987014,0.5487012987012987
3115,21304SE,3215,110,344,1476,3105,3215,1.0,0.03421461897356143,0.9657853810264385,1395,0.10699844479004665,0.45909797822706067,0.43390357698289267
3116,2132GBN,3754,40,348,1203,3714,3754,1.0,0.010655301012253596,0.9893446989877464,2203,0.09270111880660628,0.3204581779435269,0.5868407032498668
3117,2132GBS,3210,180,274,791,3030,3210,1.0,0.056074766355140186,0.9439252336448598,2145,0.0853582554517134,0.24641744548286604,0.6682242990654206
3118,2132PSN,4275,77,377,1299,4198,4275,1.0,0.01801169590643275,0.9819883040935673,2599,0.08818713450292398,0.303859649122807,0.607953216374269
3119,2132PSS,1511,9,135,600,1502,1511,1.0,0.005956320317670417,0.9940436796823295,776,0.08934480476505625,0.3970880211780278,0.513567174056916
3120,2134NYL,1372,58,73,512,1314,1372,1.0,0.04227405247813411,0.9577259475218659,787,0.053206997084548104,0.37317784256559766,0.5736151603498543
3121,2150001,1058,0,162,41,1058,1058,1.0,0.0,1.0,855,0.15311909262759923,0.038752362948960305,0.8081285444234405
3122,2150002,2215,0,493,317,2215,2215,1.0,0.0,1.0,1405,0.22257336343115125,0.14311512415349886,0.6343115124153499
3123,2150003,1009,0,620,95,1009,1009,1.0,0.0,1.0,294,0.6144697720515362,0.09415262636273539,0.29137760158572845
3124,2150004,4617,0,1249,370,4617,4617,1.0,0.0,1.0,2998,0.2705219839722764,0.08013861815031406,0.6493393978774096
3125,2150005,1593,0,646,57,1593,1593,1.0,0.0,1.0,890,0.40552416823603266,0.035781544256120526,0.5586942875078468
3126,2150006,1955,0,337,354,1955,1955,1.0,0.0,1.0,1264,0.1723785166240409,0.18107416879795396,0.6465473145780051
3127,2150007,4093,10,802,582,4083,4093,1.0,0.002443195699975568,0.9975568043000245,2709,0.19594429513804057,0.14219398973857805,0.6618617151233814
3128,2150008,1322,25,283,406,1297,1322,1.0,0.018910741301059002,0.981089258698941,633,0.2140695915279879,0.3071104387291982,0.47881996974281393
3129,2150009,3120,0,711,451,3120,3120,1.0,0.0,1.0,1958,0.22788461538461538,0.14455128205128207,0.6275641025641026
3130,2150010,2430,0,766,208,2430,2430,1.0,0.0,1.0,1456,0.31522633744855966,0.08559670781893004,0.5991769547325103
3131,2150011,2053,0,1040,117,2053,2053,1.0,0.0,1.0,896,0.5065757428153921,0.056989771066731615,0.4364344861178763
3132,2150012,164,0,140,24,164,164,1.1549295774647887,0.0,1.0,0,0.8536585365853658,0.14634146341463414,0.0
3133,2150013,4529,9,897,507,4520,4529,1.0,0.001987193640980349,0.9980128063590197,3125,0.1980569662177081,0.11194524177522631,0.6899977920070656
3134,2150014,999,0,497,167,999,999,1.0,0.0,1.0,335,0.4974974974974975,0.16716716716716717,0.3353353353353353
3135,2150015,919,0,101,38,919,919,1.0,0.0,1.0,780,0.10990206746463548,0.041349292709466814,0.8487486398258978
3136,2150016,2168,0,1355,126,2168,2168,1.0,0.0,1.0,687,0.625,0.058118081180811805,0.3168819188191882
3137,2150017,784,0,684,77,784,784,1.0,0.0,1.0,23,0.8724489795918368,0.09821428571428571,0.029336734693877552
3138,2150018,319,0,85,13,319,319,1.0,0.0,1.0,221,0.2664576802507837,0.04075235109717868,0.6927899686520376
3139,2150019,168,0,69,44,168,168,1.0,0.0,1.0,55,0.4107142857142857,0.2619047619047619,0.3273809523809524
3140,2150020,690,0,181,22,690,690,1.0,0.0,1.0,487,0.26231884057971017,0.03188405797101449,0.7057971014492753
3141,2150021,538,0,99,26,538,538,1.0,0.0,1.0,413,0.18401486988847585,0.048327137546468404,0.7676579925650557
3142,2150022,688,0,296,62,688,688,1.0,0.0,1.0,330,0.43023255813953487,0.09011627906976744,0.4796511627906977
3143,2150023,2084,0,759,210,2084,2084,1.0,0.0,1.0,1115,0.3642034548944338,0.10076775431861804,0.5350287907869482
3144,2150024,113,0,24,43,113,113,1.0,0.0,1.0,46,0.21238938053097345,0.3805309734513274,0.40707964601769914
3145,2150025,3027,0,591,472,3027,3027,1.0,0.0,1.0,1964,0.1952428146679881,0.15592996366038983,0.6488272216716221
3146,2150026,998,1,306,74,997,998,1.0,0.001002004008016032,0.998997995991984,618,0.3066132264529058,0.07414829659318638,0.6192384769539078
3147,2150027,1157,0,324,59,1157,1157,1.0,0.0,1.0,774,0.28003457216940364,0.05099394987035436,0.668971477960242
3148,2150028,2800,0,527,218,2800,2800,1.0,0.0,1.0,2055,0.18821428571428572,0.07785714285714286,0.7339285714285714
3149,2150029,708,0,114,62,708,708,1.0,0.0,1.0,532,0.16101694915254236,0.08757062146892655,0.751412429378531
3150,2150030,5055,0,843,247,5055,5055,1.0,0.0,1.0,3965,0.16676557863501484,0.048862512363996045,0.7843719090009891
3151,2150031,1627,0,414,174,1627,1627,1.0,0.0,1.0,1039,0.2544560540872772,0.10694529809465274,0.6385986478180701
3152,2150032,2063,13,714,249,2050,2063,1.0,0.006301502666020358,0.9936984973339796,1100,0.3460979156568105,0.12069801260300533,0.5332040717401842
3153,2150033,1252,0,493,135,1252,1252,1.0,0.0,1.0,624,0.3937699680511182,0.10782747603833866,0.4984025559105431
3154,2150034,1004,21,276,125,983,1004,1.0,0.02091633466135458,0.9790836653386454,603,0.2749003984063745,0.12450199203187251,0.600597609561753
3155,2150035,2937,1,1029,294,2936,2937,1.0,0.00034048348655090226,0.9996595165134491,1614,0.3503575076608784,0.10010214504596528,0.5495403472931563
3156,2150036,3929,2,1211,334,3927,3929,1.0,0.0005090353779587681,0.9994909646220412,2384,0.3082209213540341,0.08500890811911428,0.6067701705268517
3157,2150037,1404,0,254,123,1404,1404,1.0,0.0,1.0,1027,0.18091168091168092,0.0876068376068376,0.7314814814814815
3158,2150038,2682,0,700,605,2682,2682,1.0,0.0,1.0,1377,0.2609992542878449,0.2255779269202088,0.5134228187919463
3159,2150039,2024,0,566,107,2024,2024,1.0,0.0,1.0,1351,0.27964426877470355,0.052865612648221344,0.6674901185770751
3160,2150040,3200,1,607,114,3199,3200,1.0,0.0003125,0.9996875,2479,0.1896875,0.035625,0.7746875
3161,2150041,4576,10,693,133,4566,4576,1.0,0.0021853146853146855,0.9978146853146853,3750,0.15144230769230768,0.029064685314685316,0.819493006993007
3162,2150042,3232,2,966,311,3230,3232,1.0,0.0006188118811881188,0.9993811881188119,1955,0.2988861386138614,0.09622524752475248,0.6048886138613861
3163,2150043,5471,0,957,280,5471,5471,1.0,0.0,1.0,4234,0.1749223176750137,0.05117894352038019,0.7738987388046061
3164,2150044,1107,0,201,55,1107,1107,1.0,0.0,1.0,851,0.18157181571815717,0.04968383017163505,0.7687443541102078
3165,2150045,1510,0,542,242,1510,1510,1.0,0.0,1.0,726,0.35894039735099337,0.16026490066225166,0.48079470198675495
3166,2150046,322,0,54,26,322,322,1.0,0.0,1.0,242,0.16770186335403728,0.08074534161490683,0.7515527950310559
3167,2150047,1943,0,500,147,1943,1943,1.0,0.0,1.0,1296,0.2573340195573855,0.07565620174987134,0.6670097786927431
3168,2150048,3112,51,973,180,3061,3112,1.0,0.016388174807197942,0.9836118251928021,1959,0.31266066838046275,0.05784061696658098,0.6294987146529563
3169,2150049,3214,0,749,277,3214,3214,1.0,0.0,1.0,2188,0.23304293714996888,0.08618543870566273,0.6807716241443684
3170,2150050,2462,1,867,170,2461,2462,1.0,0.00040617384240454913,0.9995938261575954,1425,0.3521527213647441,0.06904955320877336,0.5787977254264826
3171,2150051,1937,0,984,80,1937,1937,1.0,0.0,1.0,873,0.5080020650490449,0.041300980898296334,0.45069695405265875
3172,2150052,3058,49,843,546,3009,3058,1.0,0.016023544800523218,0.9839764551994767,1669,0.275670372792675,0.17854807063440156,0.5457815565729235
3173,2150053,5461,42,1477,424,5419,5461,1.0,0.007690899102728438,0.9923091008972715,3560,0.27046328511261675,0.07764145760849661,0.6518952572788866
3174,2150054,1367,22,171,184,1345,1367,1.0,0.016093635698610095,0.9839063643013899,1012,0.1250914411119239,0.1346013167520117,0.7403072421360644
3175,2150055,2469,3,1164,195,2466,2469,1.0,0.001215066828675577,0.9987849331713244,1110,0.47144592952612396,0.07897934386391252,0.44957472660996356
3176,2150056,2752,11,1037,237,2741,2752,1.0,0.003997093023255814,0.9960029069767442,1478,0.37681686046511625,0.08611918604651163,0.5370639534883721
3177,2150057,1202,2,283,108,1200,1202,1.0,0.0016638935108153079,0.9983361064891847,811,0.23544093178036607,0.08985024958402663,0.6747088186356073
3178,2150058,3195,16,685,232,3179,3195,1.0,0.005007824726134585,0.9949921752738654,2278,0.21439749608763695,0.07261345852895149,0.7129890453834116
3179,2150059,2745,0,621,139,2745,2745,1.0,0.0,1.0,1985,0.2262295081967213,0.05063752276867031,0.7231329690346083
3180,2150060,3750,0,563,248,3750,3750,1.0,0.0,1.0,2939,0.15013333333333334,0.06613333333333334,0.7837333333333333
3181,2150061,2405,0,666,155,2405,2405,1.0,0.0,1.0,1584,0.27692307692307694,0.06444906444906445,0.6586278586278587
3182,2150062,3496,121,660,989,3375,3496,1.0,0.03461098398169336,0.9653890160183066,1847,0.18878718535469108,0.28289473684210525,0.5283180778032036
3183,2150063,857,0,166,75,857,857,1.0,0.0,1.0,616,0.19369894982497082,0.08751458576429405,0.7187864644107351
3184,2150064,2847,0,491,73,2847,2847,1.0,0.0,1.0,2283,0.17246224095539164,0.02564102564102564,0.8018967334035827
3185,2150065,1567,32,278,120,1535,1567,1.0,0.0204211869814933,0.9795788130185067,1169,0.17740906190172304,0.07657945118059988,0.746011486917677
3186,2150066,1091,0,401,169,1091,1091,1.0,0.0,1.0,521,0.3675527039413382,0.15490375802016498,0.4775435380384968
3187,2150067,2426,0,509,427,2426,2426,1.0,0.0,1.0,1490,0.20981038746908492,0.1760098928276999,0.6141797197032152
3188,2150068,7427,633,748,246,6794,7427,1.0,0.08522956779318702,0.914770432206813,6433,0.10071361249495085,0.03312239127507742,0.8661639962299718
3189,2150069,4256,66,605,209,4190,4256,1.0,0.01550751879699248,0.9844924812030075,3442,0.14215225563909775,0.049107142857142856,0.8087406015037594
3190,2150070,2380,0,360,88,2380,2380,1.0,0.0,1.0,1932,0.15126050420168066,0.03697478991596639,0.8117647058823529
3191,2150072,1345,9,365,211,1336,1345,1.0,0.006691449814126394,0.9933085501858736,769,0.27137546468401486,0.15687732342007435,0.5717472118959108
3192,2150073,2198,0,492,778,2198,2198,1.0,0.0,1.0,928,0.22383985441310283,0.353958143767061,0.4222020018198362
3193,2150074,785,24,87,105,761,785,1.0,0.030573248407643312,0.9694267515923567,593,0.11082802547770701,0.1337579617834395,0.7554140127388536
3194,2150075,77,0,16,18,77,77,1.0,0.0,1.0,43,0.2077922077922078,0.23376623376623376,0.5584415584415584
3195,2150076,28,0,0,10,28,28,1.0,0.0,1.0,18,0.0,0.35714285714285715,0.6428571428571429
3196,2150077,1790,0,526,186,1790,1790,1.0,0.0,1.0,1078,0.293854748603352,0.10391061452513967,0.6022346368715084
3197,2150078,2163,33,558,98,2130,2163,1.0,0.015256588072122053,0.984743411927878,1507,0.2579750346740638,0.045307443365695796,0.6967175219602404
3198,2150079,1874,0,454,64,1874,1874,1.0,0.0,1.0,1356,0.24226254002134473,0.03415154749199573,0.7235859124866596
3199,2150080,881,0,291,31,881,881,1.0,0.0,1.0,559,0.33030646992054485,0.03518728717366629,0.6345062429057888
3200,2150081,6003,0,1063,804,6003,6003,1.0,0.0,1.0,4136,0.17707812760286523,0.13393303348325838,0.6889888389138764
3201,2150082,22,0,2,0,22,22,1.0,0.0,1.0,20,0.09090909090909091,0.0,0.9090909090909091
3202,2150083,3087,0,628,832,3087,3087,1.0,0.0,1.0,1627,0.20343375445416262,0.26951733074182055,0.5270489148040168
3203,2150084,863,8,175,180,855,863,1.0,0.009269988412514484,0.9907300115874855,508,0.20278099652375434,0.2085747392815759,0.5886442641946698
3204,2150085,4293,0,1057,277,4293,4293,1.0,0.0,1.0,2959,0.24621476822734684,0.06452364313999534,0.6892615886326579
3205,2150086,671,0,209,107,671,671,1.0,0.0,1.0,355,0.3114754098360656,0.15946348733233978,0.5290611028315947
3206,2150087,4232,0,653,172,4232,4232,1.0,0.0,1.0,3407,0.15430056710775047,0.04064272211720227,0.8050567107750473
3207,2150088,5582,0,1066,234,5582,5582,1.0,0.0,1.0,4282,0.1909709781440344,0.04192045861698316,0.7671085632389825
3208,2150089,36,0,10,6,36,36,1.0,0.0,1.0,20,0.2777777777777778,0.16666666666666666,0.5555555555555556
3209,2150090,3984,0,2572,277,3984,3984,1.0,0.0,1.0,1135,0.6455823293172691,0.0695281124497992,0.2848895582329317
3210,2150091,1221,0,281,82,1221,1221,1.0,0.0,1.0,858,0.23013923013923013,0.06715806715806716,0.7027027027027027
3211,2150092,304,0,60,7,304,304,1.0,0.0,1.0,237,0.19736842105263158,0.023026315789473683,0.7796052631578947
3212,2150093,334,0,33,52,334,334,1.0,0.0,1.0,249,0.09880239520958084,0.15568862275449102,0.7455089820359282
3213,2150094,2767,0,681,144,2767,2767,1.0,0.0,1.0,1942,0.24611492591254067,0.05204192265992049,0.7018431514275388
3214,2150095,3408,93,1050,172,3315,3408,1.0,0.027288732394366196,0.9727112676056338,2186,0.30809859154929575,0.05046948356807512,0.6414319248826291
3215,2150096,3220,15,600,690,3205,3220,1.0,0.004658385093167702,0.9953416149068323,1930,0.18633540372670807,0.21428571428571427,0.5993788819875776
3216,2150098,4752,0,1084,305,4752,4752,1.0,0.0,1.0,3363,0.2281144781144781,0.06418350168350169,0.7077020202020202
3217,2150099,7180,45,1222,290,7135,7180,1.0,0.006267409470752089,0.9937325905292479,5668,0.1701949860724234,0.0403899721448468,0.7894150417827298
3218,2150100,2472,6,1042,268,2466,2472,1.0,0.0024271844660194173,0.9975728155339806,1162,0.4215210355987055,0.10841423948220065,0.47006472491909385
3219,2150101,1132,25,207,287,1107,1132,1.0,0.022084805653710248,0.9779151943462897,638,0.18286219081272084,0.25353356890459366,0.5636042402826855
3220,2150102,1110,0,209,305,1110,1110,1.0,0.0,1.0,596,0.18828828828828828,0.2747747747747748,0.5369369369369369
3221,2150103,3069,0,736,638,3069,3069,1.0,0.0,1.0,1695,0.23981753014011079,0.2078853046594982,0.552297165200391
3222,2150104,2715,9,484,150,2706,2715,1.0,0.0033149171270718232,0.9966850828729282,2081,0.17826887661141805,0.055248618784530384,0.7664825046040515
3223,2150105,3536,0,751,361,3536,3536,1.0,0.0,1.0,2424,0.2123868778280543,0.10209276018099547,0.6855203619909502
3224,2150106,4769,89,1195,745,4680,4769,1.0,0.018662193331935417,0.9813378066680646,2829,0.25057664080520026,0.15621723631788634,0.5932061228769134
3225,2150107,2638,14,816,280,2624,2638,1.0,0.00530705079605762,0.9946929492039424,1542,0.30932524639878695,0.10614101592115238,0.5845337376800607
3226,2150108,2230,1,865,146,2229,2230,1.0,0.0004484304932735426,0.9995515695067264,1219,0.38789237668161436,0.06547085201793722,0.5466367713004484
3227,2150109,4500,165,896,277,4335,4500,1.0,0.03666666666666667,0.9633333333333334,3327,0.1991111111111111,0.06155555555555556,0.7393333333333333
3228,2150110,1361,0,243,64,1361,1361,1.0,0.0,1.0,1054,0.17854518736223365,0.0470242468772961,0.7744305657604702
3229,2150111,3173,0,676,457,3173,3173,1.0,0.0,1.0,2040,0.2130475890324614,0.14402773400567287,0.6429246769618657
3230,2150112,1753,0,580,102,1753,1753,1.0,0.0,1.0,1071,0.33086138049058755,0.05818596691386195,0.6109526525955505
3231,2150113,4042,21,1034,631,4021,4042,1.0,0.005195447798119743,0.9948045522018802,2377,0.2558139534883721,0.1561108362196932,0.5880752102919347
3232,2150114,3475,17,866,630,3458,3475,1.0,0.004892086330935252,0.9951079136690647,1979,0.24920863309352517,0.18129496402877698,0.5694964028776979
3233,2150115,3175,0,1005,262,3175,3175,1.0,0.0,1.0,1908,0.3165354330708661,0.08251968503937007,0.6009448818897638
3234,2150116,2365,12,410,216,2353,2365,1.0,0.00507399577167019,0.9949260042283298,1739,0.1733615221987315,0.09133192389006342,0.735306553911205
3235,2150117,4673,0,1048,170,4673,4673,1.0,0.0,1.0,3455,0.22426706612454525,0.03637919965760753,0.7393537342178472
3236,2150118,2342,0,473,172,2342,2342,1.0,0.0,1.0,1697,0.20196413321947054,0.07344150298889837,0.7245943637916311
3237,2150119,1213,0,391,73,1213,1213,1.0,0.0,1.0,749,0.32234130255564714,0.060181368507831824,0.6174773289365211
3238,2150120,2229,0,778,184,2229,2229,1.0,0.0,1.0,1267,0.3490354419021983,0.08254822790489008,0.5684163301929116
3239,2150121,74,0,37,37,74,74,1.0136986301369864,0.0,1.0,0,0.5,0.5,0.0
3240,2150122,2395,0,633,89,2395,2395,1.0,0.0,1.0,1673,0.26430062630480167,0.037160751565762005,0.6985386221294363
3241,2150123,1109,0,363,145,1109,1109,1.0,0.0,1.0,601,0.327321911632101,0.13074842200180342,0.5419296663660956
3242,2150124,1462,29,335,327,1433,1462,1.0,0.019835841313269494,0.9801641586867305,800,0.22913816689466485,0.22366621067031464,0.5471956224350205
3243,2150125,1018,0,222,57,1018,1018,1.0,0.0,1.0,739,0.2180746561886051,0.055992141453831044,0.7259332023575639
3244,2150126,1609,20,498,181,1589,1609,1.0,0.012430080795525171,0.9875699192044748,930,0.30950901180857676,0.1124922311995028,0.5779987569919205
3245,2150127,1159,0,468,63,1159,1159,1.0,0.0,1.0,628,0.40379637618636754,0.054357204486626405,0.5418464193270061
3246,2150128,2692,0,615,117,2692,2692,1.0,0.0,1.0,1960,0.22845468053491827,0.043462109955423475,0.7280832095096582
3247,2150129,171,2,47,34,169,171,1.0,0.011695906432748537,0.9883040935672515,90,0.27485380116959063,0.19883040935672514,0.5263157894736842
3248,2150130,1616,0,226,119,1616,1616,1.0,0.0,1.0,1271,0.13985148514851486,0.07363861386138613,0.786509900990099
3249,2150131,212,0,192,20,212,212,15.142857142857142,0.0,1.0,0,0.9056603773584906,0.09433962264150944,0.0
3250,2150132,933,0,370,62,933,933,1.0,0.0,1.0,501,0.3965702036441586,0.06645230439442658,0.5369774919614148
3251,2150133,77,0,10,6,77,77,1.0,0.0,1.0,61,0.12987012987012986,0.07792207792207792,0.7922077922077922
3252,2150134,2637,0,442,692,2637,2637,1.0,0.0,1.0,1503,0.16761471368979902,0.26241941600303376,0.5699658703071673
3253,2150135,2379,5,376,315,2374,2379,1.0,0.002101723413198823,0.9978982765868012,1688,0.1580496006725515,0.13240857503152584,0.7095418242959226
3254,2150136,1582,7,434,333,1575,1582,1.0,0.004424778761061947,0.995575221238938,815,0.2743362831858407,0.21049304677623262,0.5151706700379267
3255,2150137,93,0,12,3,93,93,1.0,0.0,1.0,78,0.12903225806451613,0.03225806451612903,0.8387096774193549
3256,2150138,537,0,134,26,537,537,1.0,0.0,1.0,377,0.24953445065176907,0.048417132216014895,0.702048417132216
3257,2150139,515,2,125,48,513,515,1.0,0.003883495145631068,0.996116504854369,342,0.24271844660194175,0.09320388349514563,0.6640776699029126
3258,2150140,29,1,5,0,28,29,1.0,0.034482758620689655,0.9655172413793104,24,0.1724137931034483,0.0,0.8275862068965517
3259,2150141,44,0,4,3,44,44,1.0,0.0,1.0,37,0.09090909090909091,0.06818181818181818,0.8409090909090909
3260,2150142,79,0,3,3,79,79,1.0,0.0,1.0,73,0.0379746835443038,0.0379746835443038,0.9240506329113924
3261,2150143,55,0,1,0,55,55,1.0,0.0,1.0,54,0.01818181818181818,0.0,0.9818181818181818
3262,2150144,77,0,10,8,77,77,1.0,0.0,1.0,59,0.12987012987012986,0.1038961038961039,0.7662337662337663
3263,2150145,935,0,390,132,935,935,1.0,0.0,1.0,413,0.41711229946524064,0.1411764705882353,0.44171122994652406
3264,2150146,1995,0,503,60,1995,1995,1.0,0.0,1.0,1432,0.2521303258145363,0.03007518796992481,0.7177944862155389
3265,2150147,90,0,18,30,90,90,1.0,0.0,1.0,42,0.2,0.3333333333333333,0.4666666666666667
3266,2150148,188,0,28,5,188,188,1.0,0.0,1.0,155,0.14893617021276595,0.026595744680851064,0.824468085106383
3267,2150149,84,0,20,7,84,84,1.0,0.0,1.0,57,0.23809523809523808,0.08333333333333333,0.6785714285714286
3268,2150150,1320,0,222,131,1320,1320,1.0,0.0,1.0,967,0.16818181818181818,0.09924242424242424,0.7325757575757575
3269,2150151,652,3,122,25,649,652,1.0,0.004601226993865031,0.995398773006135,505,0.18711656441717792,0.03834355828220859,0.7745398773006135
3270,2150152,2395,6,444,347,2389,2395,1.0,0.0025052192066805845,0.9974947807933194,1604,0.18538622129436325,0.14488517745302715,0.6697286012526096
3271,2150153,236,0,60,14,236,236,1.0,0.0,1.0,162,0.2542372881355932,0.059322033898305086,0.6864406779661016
3272,2150154,3336,47,499,164,3289,3336,1.0,0.01408872901678657,0.9859112709832134,2673,0.14958033573141488,0.049160671462829736,0.8012589928057554
3273,2150155,679,0,126,28,679,679,1.0,0.0,1.0,525,0.18556701030927836,0.041237113402061855,0.7731958762886598
3274,2150156,2384,0,841,136,2384,2384,1.0,0.0,1.0,1407,0.3527684563758389,0.05704697986577181,0.5901845637583892
3275,2150157,1329,0,243,56,1329,1329,1.0,0.0,1.0,1030,0.18284424379232506,0.042136945071482315,0.7750188111361926
3276,2150158,3298,7,556,222,3291,3298,1.0,0.002122498483929654,0.9978775015160704,2520,0.16858702243784113,0.06731352334748332,0.7640994542146755
3277,2150159,1063,0,139,11,1063,1063,1.0,0.0,1.0,913,0.13076199435559738,0.010348071495766699,0.8588899341486359
3278,2150160,174,7,4,2,167,174,1.0,0.040229885057471264,0.9597701149425287,168,0.022988505747126436,0.011494252873563218,0.9655172413793104
3279,2150161,2643,38,463,246,2605,2643,1.0,0.014377601210745366,0.9856223987892546,1934,0.17517972001513432,0.09307604994324631,0.7317442300416194
3280,2150162,350,0,28,20,350,350,1.0,0.0,1.0,302,0.08,0.05714285714285714,0.8628571428571429
3281,2150163,334,0,37,14,334,334,1.0,0.0,1.0,283,0.11077844311377245,0.041916167664670656,0.8473053892215568
3282,2150164,1962,0,247,204,1962,1962,1.0,0.0,1.0,1511,0.12589194699286443,0.10397553516819572,0.7701325178389399
3283,2150165,855,0,165,140,855,855,1.0,0.0,1.0,550,0.19298245614035087,0.16374269005847952,0.6432748538011696
3284,2150166,724,26,60,49,698,724,1.0,0.03591160220994475,0.9640883977900553,615,0.08287292817679558,0.06767955801104972,0.8494475138121547
3285,2150167,548,0,116,160,548,548,1.0,0.0,1.0,272,0.2116788321167883,0.291970802919708,0.49635036496350365
3286,2150168,227,0,72,94,227,227,1.0,0.0,1.0,61,0.31718061674008813,0.41409691629955947,0.2687224669603524
3287,2150169,1223,0,149,43,1223,1223,1.0,0.0,1.0,1031,0.12183156173344235,0.03515944399018806,0.8430089942763695
3288,2150170,802,0,203,25,802,802,1.0,0.0,1.0,574,0.25311720698254364,0.03117206982543641,0.71571072319202
3289,2150171,26,0,5,2,26,26,1.0,0.0,1.0,19,0.19230769230769232,0.07692307692307693,0.7307692307692307
3290,2150172,89,0,50,8,89,89,1.0,0.0,1.0,31,0.5617977528089888,0.0898876404494382,0.34831460674157305
3291,2150173,1823,11,270,173,1812,1823,1.0,0.006034009873834339,0.9939659901261657,1380,0.14810751508502468,0.09489851892484914,0.7569939659901261
3292,2150174,1173,0,317,60,1173,1173,1.0,0.0,1.0,796,0.27024722932651324,0.05115089514066496,0.6786018755328218
3293,2150175,1039,0,253,83,1039,1039,1.0,0.0,1.0,703,0.2435033686236766,0.07988450433108758,0.6766121270452358
3294,2150176,1419,0,227,91,1419,1419,1.0,0.0,1.0,1101,0.15997181113460182,0.06412966878083157,0.7758985200845666
3295,2150178,35,0,2,11,35,35,1.0,0.0,1.0,22,0.05714285714285714,0.3142857142857143,0.6285714285714286
3296,2150179,424,0,99,27,424,424,1.0,0.0,1.0,298,0.23349056603773585,0.06367924528301887,0.7028301886792453
3297,2150180,116,0,10,1,116,116,1.0,0.0,1.0,105,0.08620689655172414,0.008620689655172414,0.9051724137931034
3298,2150181,798,0,169,373,798,798,1.0,0.0,1.0,256,0.21177944862155387,0.4674185463659148,0.3208020050125313
3299,2150182,941,0,108,19,941,941,1.0,0.0,1.0,814,0.11477151965993623,0.020191285866099893,0.8650371944739639
3300,2150183,1034,0,117,43,1034,1034,1.0,0.0,1.0,874,0.11315280464216634,0.041586073500967116,0.8452611218568665
3301,2150184,32,0,9,18,32,32,1.0,0.0,1.0,5,0.28125,0.5625,0.15625
3303,2150186,181,0,47,30,181,181,1.0,0.0,1.0,104,0.2596685082872928,0.16574585635359115,0.574585635359116
3304,2150187,3602,0,751,237,3602,3602,1.0,0.0,1.0,2614,0.2084952803997779,0.06579677956690727,0.7257079400333148
3305,2150188,2355,0,454,422,2355,2355,1.0,0.0,1.0,1479,0.19278131634819534,0.1791932059447983,0.6280254777070063
3306,2150189,2630,0,195,44,2630,2630,1.0,0.0,1.0,2391,0.0741444866920152,0.016730038022813688,0.9091254752851711
3307,2150190,314,0,122,44,314,314,1.0,0.0,1.0,148,0.3885350318471338,0.14012738853503184,0.4713375796178344
3308,2150191,297,0,132,24,297,297,1.0,0.0,1.0,141,0.4444444444444444,0.08080808080808081,0.47474747474747475
3309,2150192,485,4,89,34,481,485,1.0,0.008247422680412371,0.9917525773195877,362,0.18350515463917524,0.07010309278350516,0.7463917525773196
3310,2150193,283,0,44,31,283,283,1.0,0.0,1.0,208,0.15547703180212014,0.10954063604240283,0.734982332155477
3311,2150195,801,0,179,185,801,801,1.0,0.0,1.0,437,0.22347066167290885,0.23096129837702872,0.5455680399500624
3312,2150196,1319,0,251,154,1319,1319,1.0,0.0,1.0,914,0.19029567854435178,0.11675511751326763,0.6929492039423806
3313,2150197,1085,0,128,15,1085,1085,1.0,0.0,1.0,942,0.11797235023041475,0.013824884792626729,0.8682027649769585
3314,2150199,2654,44,379,376,2610,2654,1.0,0.016578749058025623,0.9834212509419744,1899,0.14280331574981162,0.14167294649585532,0.7155237377543331
3315,2150200,2855,6,643,478,2849,2855,1.0,0.0021015761821366026,0.9978984238178634,1734,0.22521891418563922,0.16742556917688267,0.6073555166374781
3316,2150201,955,5,231,217,950,955,1.0,0.005235602094240838,0.9947643979057592,507,0.2418848167539267,0.22722513089005236,0.5308900523560209
3317,2150202,850,0,135,147,850,850,1.0,0.0,1.0,568,0.1588235294117647,0.17294117647058824,0.668235294117647
3318,2150203,3617,0,578,693,3617,3617,1.0,0.0,1.0,2346,0.15980094000552944,0.19159524467790987,0.6486038153165606
3319,2150204,994,0,125,91,994,994,1.0,0.0,1.0,778,0.12575452716297786,0.09154929577464789,0.7826961770623743
3320,2150205,238,0,62,15,238,238,1.0,0.0,1.0,161,0.2605042016806723,0.06302521008403361,0.6764705882352942
3321,2150206,1688,51,220,117,1637,1688,1.0,0.030213270142180094,0.9697867298578199,1351,0.13033175355450238,0.0693127962085308,0.8003554502369669
3322,2150207,2269,32,555,473,2237,2269,1.0,0.014103129131776113,0.9858968708682239,1241,0.24460114587924195,0.20846187747906567,0.5469369766416924
3323,2150209,908,0,166,51,908,908,1.0,0.0,1.0,691,0.1828193832599119,0.05616740088105727,0.7610132158590308
3324,2150210,257,0,56,11,257,257,1.0,0.0,1.0,190,0.2178988326848249,0.042801556420233464,0.7392996108949417
3325,2150211,1668,15,221,64,1653,1668,1.0,0.008992805755395683,0.9910071942446043,1383,0.13249400479616308,0.03836930455635491,0.829136690647482
3326,2150212,445,12,62,85,433,445,1.0,0.02696629213483146,0.9730337078651685,298,0.1393258426966292,0.19101123595505617,0.6696629213483146
3327,2150213,194,0,42,18,194,194,1.0,0.0,1.0,134,0.21649484536082475,0.09278350515463918,0.6907216494845361
3328,2150215,1076,69,136,65,1007,1076,1.0,0.06412639405204461,0.9358736059479554,875,0.12639405204460966,0.0604089219330855,0.8131970260223048
3329,2150216,2124,0,463,147,2124,2124,1.0,0.0,1.0,1514,0.217984934086629,0.0692090395480226,0.7128060263653484
3330,2150217,257,0,37,7,257,257,1.0,0.0,1.0,213,0.14396887159533073,0.027237354085603113,0.8287937743190662
3331,2150218,764,0,144,36,764,764,1.0,0.0,1.0,584,0.18848167539267016,0.04712041884816754,0.7643979057591623
3332,2150219,1284,0,265,56,1284,1284,1.0,0.0,1.0,963,0.20638629283489096,0.04361370716510903,0.75
3333,2150220,642,0,137,38,642,642,1.0,0.0,1.0,467,0.21339563862928349,0.059190031152647975,0.7274143302180686
3334,2150221,1573,0,275,108,1573,1573,1.0,0.0,1.0,1190,0.17482517482517482,0.06865861411315957,0.7565162110616656
3335,2150222,15,0,0,6,15,15,1.0,0.0,1.0,9,0.0,0.4,0.6
3336,2150223,84,0,35,34,84,84,1.0,0.0,1.0,15,0.4166666666666667,0.40476190476190477,0.17857142857142858
3337,2150224,166,0,40,75,166,166,1.0,0.0,1.0,51,0.24096385542168675,0.45180722891566266,0.3072289156626506
3338,2150225,295,0,90,13,295,295,1.0,0.0,1.0,192,0.3050847457627119,0.04406779661016949,0.6508474576271186
3339,2150226,19,0,11,8,19,19,1.1875,0.0,1.0,0,0.5789473684210527,0.42105263157894735,0.0
3340,2150227,3030,0,743,85,3030,3030,1.0,0.0,1.0,2202,0.2452145214521452,0.028052805280528052,0.7267326732673267
3341,2150228,4370,0,1294,218,4370,4370,1.0,0.0,1.0,2858,0.2961098398169336,0.04988558352402746,0.6540045766590389
3342,2150229,1091,0,230,33,1091,1091,1.0,0.0,1.0,828,0.21081576535288726,0.03024747937671861,0.7589367552703942
3343,2150230,458,0,111,56,458,458,1.0,0.0,1.0,291,0.2423580786026201,0.1222707423580786,0.6353711790393013
3344,2150231,611,0,60,53,611,611,1.0,0.0,1.0,498,0.09819967266775777,0.0867430441898527,0.8150572831423896
3345,2150232,1593,0,274,74,1593,1593,1.0,0.0,1.0,1245,0.17200251098556182,0.04645323289391086,0.7815442561205274
3346,2150233,5,0,5,0,5,5,1.0,0.0,1.0,0,1.0,0.0,0.0
3347,2150234,1357,0,953,166,1357,1357,1.0,0.0,1.0,238,0.7022844509948416,0.12232866617538689,0.17538688282977155
3348,2150235,312,1,63,77,311,312,1.0,0.003205128205128205,0.9967948717948718,172,0.20192307692307693,0.2467948717948718,0.5512820512820513
3349,2150236,525,0,98,173,525,525,1.0,0.0,1.0,254,0.18666666666666668,0.3295238095238095,0.4838095238095238
3350,2150237,1244,0,321,44,1244,1244,1.0,0.0,1.0,879,0.2580385852090032,0.03536977491961415,0.7065916398713826
3351,2150238,55,0,11,0,55,55,1.0,0.0,1.0,44,0.2,0.0,0.8
3352,2150239,2582,0,482,270,2582,2582,1.0,0.0,1.0,1830,0.18667699457784662,0.104570100697134,0.7087529047250194
3353,2150240,945,7,134,68,938,945,1.0,0.007407407407407408,0.9925925925925926,743,0.14179894179894179,0.07195767195767196,0.7862433862433862
3354,2150241,727,0,47,13,727,727,1.0,0.0,1.0,667,0.06464924346629987,0.017881705639614855,0.9174690508940853
3355,2150242,26,0,5,3,26,26,1.0,0.0,1.0,18,0.19230769230769232,0.11538461538461539,0.6923076923076923
3356,2150243,52,0,15,15,52,52,1.0,0.0,1.0,22,0.28846153846153844,0.28846153846153844,0.4230769230769231
3357,2150244,881,0,150,62,881,881,1.0,0.0,1.0,669,0.170261066969353,0.07037457434733257,0.7593643586833144
3358,2150246,9,0,1,0,9,9,1.0,0.0,1.0,8,0.1111111111111111,0.0,0.8888888888888888
3359,2150247,252,0,33,17,252,252,1.0,0.0,1.0,202,0.13095238095238096,0.06746031746031746,0.8015873015873016
3360,2150248,26,0,9,6,26,26,1.0,0.0,1.0,11,0.34615384615384615,0.23076923076923078,0.4230769230769231
3361,2150249,683,0,51,40,683,683,1.0,0.0,1.0,592,0.0746705710102489,0.05856515373352855,0.8667642752562226
3362,2150250,205,2,22,6,203,205,1.0,0.00975609756097561,0.9902439024390244,177,0.1073170731707317,0.02926829268292683,0.8634146341463415
3363,2150251,12,0,7,2,12,12,1.0,0.0,1.0,3,0.5833333333333334,0.16666666666666666,0.25
3364,2150252,10,0,0,0,10,10,1.0,0.0,1.0,10,0.0,0.0,1.0
3365,2150253,353,0,152,45,353,353,1.0,0.0,1.0,156,0.43059490084985835,0.1274787535410765,0.44192634560906513
3366,2150254,376,0,34,15,376,376,1.0,0.0,1.0,327,0.09042553191489362,0.0398936170212766,0.8696808510638298
3367,2150255,231,7,65,29,224,231,1.0,0.030303030303030304,0.9696969696969697,137,0.2813852813852814,0.12554112554112554,0.5930735930735931
3368,2150256,670,0,73,11,670,670,1.0,0.0,1.0,586,0.10895522388059702,0.016417910447761194,0.8746268656716418
3369,2150257,472,0,100,12,472,472,1.0,0.0,1.0,360,0.211864406779661,0.025423728813559324,0.7627118644067796
3370,2170002,1303,242,140,376,1061,1303,1.0,0.18572524942440521,0.8142747505755947,787,0.10744435917114352,0.2885648503453569,0.6039907904834996
3371,2170003,2195,640,345,302,1555,2195,1.0,0.29157175398633256,0.7084282460136674,1548,0.1571753986332574,0.13758542141230068,0.705239179954442
3372,2170004,2700,218,288,1054,2482,2700,1.0,0.08074074074074074,0.9192592592592592,1358,0.10666666666666667,0.39037037037037037,0.502962962962963
3373,2170005,582,2,50,260,580,582,1.0,0.003436426116838488,0.9965635738831615,272,0.0859106529209622,0.44673539518900346,0.46735395189003437
3374,2170006,393,12,42,185,381,393,1.0,0.030534351145038167,0.9694656488549618,166,0.10687022900763359,0.4707379134860051,0.4223918575063613
3375,2170007,483,17,75,255,466,483,1.0,0.035196687370600416,0.9648033126293996,153,0.15527950310559005,0.5279503105590062,0.3167701863354037
3376,2170008,311,5,33,152,306,311,1.0,0.01607717041800643,0.9839228295819936,126,0.10610932475884244,0.4887459807073955,0.40514469453376206
3377,2170009,702,31,88,216,671,702,1.0,0.04415954415954416,0.9558404558404558,398,0.12535612535612536,0.3076923076923077,0.5669515669515669
3378,2170010,2029,155,262,713,1874,2029,1.0,0.0763923114834894,0.9236076885165106,1054,0.1291276490882208,0.35140463282405127,0.519467718087728
3379,2170012,691,2,99,309,689,691,1.0,0.002894356005788712,0.9971056439942113,283,0.14327062228654125,0.447178002894356,0.40955137481910275
3380,2170013,3458,79,268,1204,3379,3458,1.0,0.022845575477154424,0.9771544245228456,1986,0.07750144592249855,0.3481781376518219,0.5743204164256795
3381,2170014,1189,41,65,503,1148,1189,1.0,0.034482758620689655,0.9655172413793104,621,0.054667788057190914,0.42304457527333894,0.5222876366694701
3382,2170015,420,22,38,172,398,420,1.0,0.05238095238095238,0.9476190476190476,210,0.09047619047619047,0.4095238095238095,0.5
3383,2170016,349,19,57,162,330,349,1.0,0.054441260744985676,0.9455587392550143,130,0.16332378223495703,0.46418338108882523,0.37249283667621774
3384,2170018,227,3,26,92,224,227,1.0,0.013215859030837005,0.986784140969163,109,0.1145374449339207,0.4052863436123348,0.4801762114537445
3385,2170019,519,5,56,158,514,519,1.0,0.009633911368015413,0.9903660886319846,305,0.10789980732177264,0.3044315992292871,0.5876685934489403
3386,2170020,1231,0,105,404,1231,1231,1.0,0.0,1.0,722,0.08529650690495533,0.3281884646628757,0.586515028432169
3387,2170021,1975,0,199,888,1975,1975,1.0,0.0,1.0,888,0.10075949367088607,0.44962025316455695,0.44962025316455695
3388,2170022,1753,6,198,733,1747,1753,1.0,0.0034227039361095267,0.9965772960638904,822,0.11294922989161438,0.41814033086138047,0.46891043924700515
3389,2170023,675,22,75,184,653,675,1.0,0.03259259259259259,0.9674074074074074,416,0.1111111111111111,0.2725925925925926,0.6162962962962963
3390,2170024,1699,127,157,497,1572,1699,1.0,0.07474985285462037,0.9252501471453797,1045,0.0924072984108299,0.29252501471453796,0.6150676868746321
3391,2170027,672,0,86,313,672,672,1.0,0.0,1.0,273,0.12797619047619047,0.46577380952380953,0.40625
3392,2190011,705,50,61,397,655,705,1.0,0.07092198581560284,0.9290780141843972,247,0.08652482269503546,0.5631205673758866,0.350354609929078
3393,2190014,720,0,70,378,720,720,1.0,0.0,1.0,272,0.09722222222222222,0.525,0.37777777777777777
3394,2190015,776,6,42,214,770,776,1.0,0.007731958762886598,0.9922680412371134,520,0.05412371134020619,0.2757731958762887,0.6701030927835051
3395,2190016,2480,83,153,1026,2397,2480,1.0,0.03346774193548387,0.9665322580645161,1301,0.06169354838709677,0.4137096774193548,0.5245967741935483
3396,2190021,2887,221,247,849,2666,2887,1.0,0.07655005195704884,0.9234499480429511,1791,0.08555594042258399,0.29407689643228263,0.6203671631451334
3397,2190024,894,13,82,450,881,894,1.0,0.0145413870246085,0.9854586129753915,362,0.09172259507829977,0.5033557046979866,0.40492170022371365
3398,2190032,2484,89,265,578,2395,2484,1.0,0.035829307568438,0.964170692431562,1641,0.10668276972624799,0.23268921095008052,0.6606280193236715
3399,2190033,106,0,5,49,106,106,1.0,0.0,1.0,52,0.04716981132075472,0.46226415094339623,0.49056603773584906
3400,2190035,255,20,32,86,235,255,1.0,0.0784313725490196,0.9215686274509803,137,0.12549019607843137,0.33725490196078434,0.5372549019607843
3401,2190036,686,22,91,100,664,686,1.0,0.03206997084548105,0.967930029154519,495,0.1326530612244898,0.1457725947521866,0.7215743440233237
3402,2190043,327,1,31,157,326,327,1.0,0.0030581039755351682,0.9969418960244648,139,0.09480122324159021,0.4801223241590214,0.42507645259938837
3403,2190044,947,33,149,357,914,947,1.0,0.03484688489968321,0.9651531151003168,441,0.1573389651531151,0.37697993664202745,0.4656810982048574
3404,2190045A,1260,9,126,424,1251,1260,1.0,0.007142857142857143,0.9928571428571429,710,0.1,0.33650793650793653,0.5634920634920635
3405,2190045B,642,14,61,194,628,642,1.0,0.021806853582554516,0.9781931464174455,387,0.09501557632398754,0.30218068535825543,0.602803738317757
3406,2190046,836,12,71,287,824,836,1.0,0.014354066985645933,0.9856459330143541,478,0.08492822966507177,0.34330143540669855,0.5717703349282297
3407,2210001,1308,88,144,555,1220,1308,1.0,0.0672782874617737,0.9327217125382263,609,0.11009174311926606,0.4243119266055046,0.46559633027522934
3408,2210002,4108,4,379,1416,4104,4108,1.0,0.0009737098344693282,0.9990262901655307,2313,0.09225900681596884,0.34469328140214217,0.563047711781889
3409,2210003,2785,8,294,1188,2777,2785,1.0,0.002872531418312388,0.9971274685816877,1303,0.10556552962298026,0.4265709156193896,0.46786355475763014
3410,2210004,3354,71,233,869,3283,3354,1.0,0.021168753726893263,0.9788312462731067,2252,0.06946929039952296,0.25909361955873583,0.6714370900417412
3411,2210005,2288,3,188,995,2285,2288,1.0,0.0013111888111888112,0.9986888111888111,1105,0.08216783216783216,0.4348776223776224,0.48295454545454547
3412,2210007,880,0,84,384,880,880,1.0,0.0,1.0,412,0.09545454545454546,0.43636363636363634,0.4681818181818182
3413,2210008,2941,0,234,1245,2941,2941,1.0,0.0,1.0,1462,0.07956477388643318,0.4233253995239714,0.49710982658959535
3414,2210009,4429,0,338,1903,4429,4429,1.0,0.0,1.0,2188,0.07631519530368029,0.42966809663580946,0.4940167080605103
3415,2210010,4642,59,425,2390,4583,4642,1.0,0.012710038776389487,0.9872899612236106,1827,0.0915553640672124,0.5148642826367945,0.3935803532959931
3416,2210011,2182,21,145,622,2161,2182,1.0,0.009624197983501375,0.9903758020164987,1415,0.06645279560036664,0.2850595783684693,0.648487626031164
3417,2210012,2044,0,179,618,2044,2044,1.0,0.0,1.0,1247,0.087573385518591,0.30234833659491195,0.610078277886497
3418,2210013,3551,45,288,1577,3506,3551,1.0,0.012672486623486343,0.9873275133765137,1686,0.08110391439031259,0.4441002534497325,0.47479583215995497
3419,2210014,4145,0,335,1348,4145,4145,1.0,0.0,1.0,2462,0.08082026537997587,0.32521109770808204,0.5939686369119421
3420,2210015,543,0,29,152,543,543,1.0,0.0,1.0,362,0.053406998158379376,0.27992633517495397,0.6666666666666666
3421,2210016,5032,0,548,3147,5032,5032,1.0,0.0,1.0,1337,0.10890302066772654,0.6253974562798092,0.26569952305246425
3422,2230001,2358,144,254,965,2214,2358,1.0,0.061068702290076333,0.9389312977099237,1139,0.1077184054283291,0.409245122985581,0.4830364715860899
3423,2230002,1673,196,228,616,1477,1673,1.0,0.11715481171548117,0.8828451882845189,829,0.13628212791392708,0.3682008368200837,0.4955170352659892
3424,2230003,2196,432,235,697,1764,2196,1.0,0.19672131147540983,0.8032786885245902,1264,0.10701275045537341,0.3173952641165756,0.575591985428051
3425,2230004,1442,77,122,658,1365,1442,1.0,0.05339805825242718,0.9466019417475728,662,0.08460471567267684,0.4563106796116505,0.4590846047156727
3426,2230005,659,11,47,278,648,659,1.0,0.01669195751138088,0.9833080424886191,334,0.07132018209408195,0.4218512898330804,0.5068285280728376
3427,2230008,231,2,48,125,229,231,1.0,0.008658008658008658,0.9913419913419913,58,0.2077922077922078,0.5411255411255411,0.2510822510822511
3428,2230011,937,0,94,330,937,937,1.0,0.0,1.0,513,0.10032017075773746,0.35218783351120597,0.5474919957310566
3429,2230012,286,2,38,159,284,286,1.0,0.006993006993006993,0.993006993006993,89,0.13286713286713286,0.5559440559440559,0.3111888111888112
3430,2230013,1276,122,106,430,1154,1276,1.0,0.09561128526645768,0.9043887147335423,740,0.08307210031347963,0.33699059561128525,0.5799373040752351
3431,2230014,1120,52,99,451,1068,1120,1.0,0.04642857142857143,0.9535714285714286,570,0.08839285714285715,0.40267857142857144,0.5089285714285714
3432,2230016,1159,3,103,483,1156,1159,1.0,0.0025884383088869713,0.997411561691113,573,0.08886971527178603,0.4167385677308024,0.4943917169974116
3433,2230017,1262,13,132,483,1249,1262,1.0,0.010301109350237718,0.9896988906497622,647,0.1045958795562599,0.3827258320126783,0.5126782884310618
3434,223001A,2035,51,200,887,1984,2035,1.0,0.02506142506142506,0.9749385749385749,948,0.09828009828009827,0.4358722358722359,0.46584766584766585
3435,2230020,638,0,51,270,638,638,1.0,0.0,1.0,317,0.07993730407523511,0.4231974921630094,0.49686520376175547
3436,2230023,218,14,36,151,204,218,1.0,0.06422018348623854,0.9357798165137615,31,0.1651376146788991,0.6926605504587156,0.14220183486238533
3437,2230024,786,6,72,360,780,786,1.0,0.007633587786259542,0.9923664122137404,354,0.0916030534351145,0.4580152671755725,0.45038167938931295
3438,2230025,362,0,24,187,362,362,1.0,0.0,1.0,151,0.06629834254143646,0.5165745856353591,0.4171270718232044
3439,223002A,1455,469,392,302,986,1455,1.0,0.3223367697594502,0.6776632302405499,761,0.26941580756013744,0.20756013745704469,0.5230240549828179
3440,2230036,1042,77,95,438,965,1042,1.0,0.07389635316698656,0.9261036468330134,509,0.09117082533589252,0.42034548944337813,0.4884836852207294
3441,223003A,2155,89,173,744,2066,2155,1.0,0.041299303944315545,0.9587006960556844,1238,0.0802784222737819,0.3452436194895592,0.5744779582366589
3442,223004A,2135,109,228,822,2026,2135,1.0,0.05105386416861827,0.9489461358313818,1085,0.10679156908665105,0.38501170960187353,0.5081967213114754
3443,2250001,1489,459,281,425,1030,1489,1.0,0.3082605775688381,0.6917394224311618,783,0.18871725990597715,0.28542646071188715,0.5258562793821356
3444,2250002,1850,470,253,625,1380,1850,1.0,0.25405405405405407,0.745945945945946,972,0.13675675675675675,0.33783783783783783,0.5254054054054054
3445,2250003,1929,1132,516,255,797,1929,1.0,0.5868325557283567,0.4131674442716433,1158,0.26749611197511663,0.1321928460342146,0.6003110419906688
3446,2250004,1932,344,316,802,1588,1932,1.0,0.17805383022774326,0.8219461697722568,814,0.16356107660455488,0.41511387163561075,0.42132505175983437
3447,2250005,1802,194,102,562,1608,1802,1.0,0.1076581576026637,0.8923418423973363,1138,0.05660377358490566,0.3118756936736959,0.6315205327413984
3448,2250006,1185,236,207,465,949,1185,1.0,0.1991561181434599,0.8008438818565401,513,0.17468354430379746,0.3924050632911392,0.43291139240506327
3449,2250007,1087,175,66,512,912,1087,1.0,0.1609935602575897,0.8390064397424103,509,0.06071757129714812,0.47102115915363385,0.46826126954921804
3450,2250008,486,38,44,228,448,486,1.0,0.07818930041152264,0.9218106995884774,214,0.09053497942386832,0.4691358024691358,0.4403292181069959
3451,2250009,422,1,29,228,421,422,1.0,0.002369668246445498,0.9976303317535545,165,0.06872037914691943,0.5402843601895735,0.3909952606635071
3452,2250010,245,55,30,157,190,245,1.0,0.22448979591836735,0.7755102040816326,58,0.12244897959183673,0.6408163265306123,0.23673469387755103
3453,2250011,139,21,12,53,118,139,1.0,0.1510791366906475,0.8489208633093526,74,0.08633093525179857,0.381294964028777,0.5323741007194245
3454,2250012,121,0,18,57,121,121,1.0,0.0,1.0,46,0.1487603305785124,0.47107438016528924,0.38016528925619836
3455,2250014,350,29,37,312,321,350,1.207612456747405,0.08285714285714285,0.9171428571428571,1,0.10571428571428572,0.8914285714285715,0.002857142857142857
3456,2250015,343,87,45,134,256,343,1.0,0.2536443148688047,0.7463556851311953,164,0.13119533527696792,0.39067055393586003,0.478134110787172
3457,2250016,264,4,19,139,260,264,1.0,0.015151515151515152,0.9848484848484849,106,0.07196969696969698,0.5265151515151515,0.4015151515151515
3458,2250017,2802,1016,18,158,1786,2802,1.0,0.3625981441827266,0.6374018558172734,2626,0.006423982869379015,0.05638829407566024,0.9371877230549608
3459,2250018,121,5,37,38,116,121,1.0,0.04132231404958678,0.9586776859504132,46,0.30578512396694213,0.3140495867768595,0.38016528925619836
3460,2250019,681,75,100,290,606,681,1.0,0.11013215859030837,0.8898678414096917,291,0.14684287812041116,0.42584434654919234,0.42731277533039647
3461,2250020,210,0,14,139,210,210,1.0,0.0,1.0,57,0.06666666666666667,0.6619047619047619,0.2714285714285714
3462,2250021,360,184,65,149,176,360,1.0,0.5111111111111111,0.4888888888888889,146,0.18055555555555555,0.41388888888888886,0.40555555555555556
3463,2250022,265,60,54,144,205,265,1.0,0.22641509433962265,0.7735849056603774,67,0.2037735849056604,0.5433962264150943,0.2528301886792453
3464,2270011,2383,228,294,261,2155,2383,1.0,0.09567771716323961,0.9043222828367604,1828,0.12337389844733529,0.10952580780528745,0.7671002937473772
3465,2270012,1062,27,105,96,1035,1062,1.0,0.025423728813559324,0.9745762711864406,861,0.09887005649717515,0.0903954802259887,0.8107344632768362
3466,2270013,2400,317,93,82,2083,2400,1.0,0.13208333333333333,0.8679166666666667,2225,0.03875,0.034166666666666665,0.9270833333333334
3467,2270014,292,16,42,37,276,292,1.0,0.0547945205479452,0.9452054794520548,213,0.14383561643835616,0.1267123287671233,0.7294520547945206
3468,2270016,281,5,24,20,276,281,1.0,0.017793594306049824,0.9822064056939501,237,0.08540925266903915,0.0711743772241993,0.8434163701067615
3469,2270024,495,40,59,229,455,495,1.0,0.08080808080808081,0.9191919191919192,207,0.1191919191919192,0.4626262626262626,0.41818181818181815
3470,2270025,1444,64,160,611,1380,1444,1.0,0.0443213296398892,0.9556786703601108,673,0.11080332409972299,0.4231301939058172,0.4660664819944598
3471,2270026,957,58,67,262,899,957,1.0,0.06060606060606061,0.9393939393939394,628,0.07001044932079414,0.27377220480668757,0.6562173458725182
3472,2270032,273,19,13,47,254,273,1.0,0.0695970695970696,0.9304029304029304,213,0.047619047619047616,0.17216117216117216,0.7802197802197802
3473,2270033,1971,138,229,651,1833,1971,1.0,0.0700152207001522,0.9299847792998478,1091,0.11618467782851344,0.3302891933028919,0.5535261288685946
3474,2270034,2350,155,192,586,2195,2350,1.0,0.06595744680851064,0.9340425531914893,1572,0.08170212765957446,0.24936170212765957,0.668936170212766
3475,2270035,359,35,42,121,324,359,1.0,0.09749303621169916,0.9025069637883009,196,0.116991643454039,0.3370473537604457,0.5459610027855153
3477,2270042,1118,65,95,234,1053,1118,1.0,0.05813953488372093,0.9418604651162791,789,0.08497316636851521,0.20930232558139536,0.7057245080500895
3478,2270045,1344,27,100,219,1317,1344,1.0,0.020089285714285716,0.9799107142857143,1025,0.0744047619047619,0.16294642857142858,0.7626488095238095
3479,2270046,1567,172,136,314,1395,1567,1.0,0.10976388002552648,0.8902361199744735,1117,0.08679004467134652,0.200382897255903,0.7128270580727505
3480,2270103,175,4,18,95,171,175,1.0,0.022857142857142857,0.9771428571428571,62,0.10285714285714286,0.5428571428571428,0.35428571428571426
3481,2270104,241,0,10,71,241,241,1.0,0.0,1.0,160,0.04149377593360996,0.2946058091286307,0.6639004149377593
3483,227012A,348,24,26,20,324,348,1.0,0.06896551724137931,0.9310344827586207,302,0.07471264367816093,0.05747126436781609,0.867816091954023
3484,2270205,1367,51,91,782,1316,1367,1.0,0.03730797366495977,0.9626920263350403,494,0.06656912948061448,0.5720555961960497,0.36137527432333577
3485,2270207,1275,68,67,363,1207,1275,1.0,0.05333333333333334,0.9466666666666667,845,0.05254901960784314,0.2847058823529412,0.6627450980392157
3486,2270208,168,0,5,84,168,168,1.0,0.0,1.0,79,0.02976190476190476,0.5,0.47023809523809523
3488,2270304,656,12,39,255,644,656,1.0,0.018292682926829267,0.9817073170731707,362,0.05945121951219512,0.38871951219512196,0.551829268292683
3489,2270404,698,10,69,280,688,698,1.0,0.014326647564469915,0.9856733524355301,349,0.0988538681948424,0.40114613180515757,0.5
3490,2270405,550,2,26,133,548,550,1.0,0.0036363636363636364,0.9963636363636363,391,0.04727272727272727,0.24181818181818182,0.7109090909090909
3491,2270408,66,0,5,32,66,66,1.0,0.0,1.0,29,0.07575757575757576,0.48484848484848486,0.4393939393939394
3492,2270409,717,1,47,251,716,717,1.0,0.001394700139470014,0.99860529986053,419,0.06555090655509066,0.3500697350069735,0.5843793584379359
3493,227207C,487,0,56,317,487,487,1.0,0.0,1.0,114,0.11498973305954825,0.6509240246406571,0.23408624229979466
3494,2290001,510,0,83,142,510,510,1.0,0.0,1.0,285,0.1627450980392157,0.2784313725490196,0.5588235294117647
3495,2290002,801,9,147,89,792,801,1.0,0.011235955056179775,0.9887640449438202,565,0.18352059925093633,0.1111111111111111,0.7053682896379525
3496,2290004,207,0,58,134,207,207,1.0,0.0,1.0,15,0.28019323671497587,0.6473429951690821,0.07246376811594203
3497,229003N,180,2,33,56,178,180,1.0,0.011111111111111112,0.9888888888888889,91,0.18333333333333332,0.3111111111111111,0.5055555555555555
3498,229003S,251,2,58,50,249,251,1.0,0.00796812749003984,0.9920318725099602,143,0.23107569721115537,0.199203187250996,0.5697211155378487
3499,2310101,1192,35,98,537,1157,1192,1.0,0.02936241610738255,0.9706375838926175,557,0.08221476510067115,0.45050335570469796,0.4672818791946309
3500,2310102,1667,167,167,544,1500,1667,1.0,0.10017996400719856,0.8998200359928015,956,0.10017996400719856,0.32633473305338934,0.5734853029394121
3501,2310103,683,0,65,352,683,683,1.0,0.0,1.0,266,0.0951683748169839,0.5153733528550513,0.38945827232796487
3502,2310104,1047,27,91,460,1020,1047,1.0,0.025787965616045846,0.9742120343839542,496,0.08691499522445081,0.4393505253104107,0.47373447946513847
3503,2310105,1412,159,132,294,1253,1412,1.0,0.11260623229461757,0.8873937677053825,986,0.09348441926345609,0.20821529745042494,0.6983002832861189
3504,2310106,3000,495,363,678,2505,3000,1.0,0.165,0.835,1959,0.121,0.226,0.653
3505,2310107,3429,432,344,1263,2997,3429,1.0,0.12598425196850394,0.8740157480314961,1822,0.10032079323417906,0.36832895888014,0.531350247885681
3506,2310108,2718,454,284,533,2264,2718,1.0,0.1670345842531273,0.8329654157468727,1901,0.10448859455481972,0.1961000735835173,0.6994113318616629
3507,2310109,1444,9,106,503,1435,1444,1.0,0.006232686980609419,0.9937673130193906,835,0.07340720221606649,0.34833795013850416,0.5782548476454293
3508,2310210,1025,21,97,286,1004,1025,1.0,0.02048780487804878,0.9795121951219512,642,0.09463414634146342,0.27902439024390246,0.6263414634146341
3509,2310211,579,13,84,319,566,579,1.0,0.022452504317789293,0.9775474956822107,176,0.14507772020725387,0.5509499136442142,0.30397236614853196
3510,2310212,1624,112,145,443,1512,1624,1.0,0.06896551724137931,0.9310344827586207,1036,0.08928571428571429,0.2727832512315271,0.6379310344827587
3511,2310213,755,0,53,453,755,755,1.0,0.0,1.0,249,0.07019867549668875,0.6,0.32980132450331123
3512,2310214,4368,40,274,1243,4328,4368,1.0,0.009157509157509158,0.9908424908424909,2851,0.06272893772893773,0.28456959706959706,0.6527014652014652
3513,2310215,5870,101,373,2037,5769,5870,1.0,0.017206132879045998,0.982793867120954,3460,0.0635434412265758,0.34701873935264055,0.5894378194207837
3514,2310216,2048,19,184,783,2029,2048,1.0,0.00927734375,0.99072265625,1081,0.08984375,0.38232421875,0.52783203125
3515,2310217,1755,10,136,724,1745,1755,1.0,0.005698005698005698,0.9943019943019943,895,0.07749287749287749,0.41253561253561255,0.50997150997151
3516,2310318,665,0,58,362,665,665,1.0,0.0,1.0,245,0.08721804511278196,0.544360902255639,0.3684210526315789
3517,2310319,1736,10,161,692,1726,1736,1.0,0.00576036866359447,0.9942396313364056,883,0.09274193548387097,0.3986175115207373,0.5086405529953917
3518,2310320,3124,3,269,803,3121,3124,1.0,0.0009603072983354673,0.9990396927016645,2052,0.08610755441741358,0.25704225352112675,0.6568501920614597
3519,2310321,1907,9,139,489,1898,1907,1.0,0.0047194546407970635,0.995280545359203,1279,0.07288935500786575,0.2564237021499738,0.6706869428421605
3520,2310322,1815,39,136,357,1776,1815,1.0,0.021487603305785124,0.9785123966942149,1322,0.07493112947658402,0.19669421487603306,0.7283746556473829
3521,2310323,2768,2,203,1250,2766,2768,1.0,0.000722543352601156,0.9992774566473989,1315,0.07333815028901734,0.4515895953757225,0.4750722543352601
3522,2310324,1666,94,163,984,1572,1666,1.0,0.056422569027611044,0.943577430972389,519,0.09783913565426171,0.5906362545018007,0.3115246098439376
3523,2310325,2892,225,274,1362,2667,2892,1.0,0.07780082987551867,0.9221991701244814,1256,0.09474412171507607,0.470954356846473,0.4343015214384509
3524,2310426,682,33,68,175,649,682,1.0,0.04838709677419355,0.9516129032258065,439,0.09970674486803519,0.2565982404692082,0.6436950146627566
3525,2310427,4701,1274,605,717,3427,4701,1.0,0.271006168900234,0.728993831099766,3379,0.12869602212295256,0.1525207402680281,0.7187832376090194
3526,2310428,3004,554,381,577,2450,3004,1.0,0.18442077230359522,0.8155792276964048,2046,0.12683089214380824,0.19207723035952065,0.6810918774966711
3527,2310429,381,3,58,179,378,381,1.0,0.007874015748031496,0.9921259842519685,144,0.15223097112860892,0.46981627296587924,0.3779527559055118
3528,2310430,647,72,71,204,575,647,1.0,0.11128284389489954,0.8887171561051005,372,0.10973724884080371,0.31530139103554866,0.5749613601236476
3529,2310431,545,60,106,178,485,545,1.0,0.11009174311926606,0.8899082568807339,261,0.1944954128440367,0.326605504587156,0.47889908256880737
3530,2310432,860,53,72,351,807,860,1.0,0.06162790697674419,0.9383720930232559,437,0.08372093023255814,0.40813953488372096,0.5081395348837209
3531,2310433,2939,953,812,219,1986,2939,1.0,0.3242599523647499,0.6757400476352501,1908,0.2762844504933651,0.07451514120449132,0.6492004083021435
3532,2310434,1425,28,99,660,1397,1425,1.0,0.019649122807017545,0.9803508771929824,666,0.06947368421052631,0.4631578947368421,0.4673684210526316
3533,2330011,2265,53,131,1067,2212,2265,1.0,0.023399558498896248,0.9766004415011037,1067,0.05783664459161148,0.47108167770419423,0.47108167770419423
3534,2330014,2600,39,157,1222,2561,2600,1.0,0.015,0.985,1221,0.060384615384615384,0.47,0.4696153846153846
3535,2330021,3716,15,215,1730,3701,3716,1.0,0.004036598493003229,0.9959634015069968,1771,0.05785791173304629,0.4655543595263724,0.47658772874058125
3536,2330023,349,1,21,199,348,349,1.0,0.0028653295128939827,0.997134670487106,129,0.06017191977077364,0.5702005730659025,0.36962750716332377
3537,2330031,1415,15,125,897,1400,1415,1.0,0.01060070671378092,0.9893992932862191,393,0.08833922261484099,0.6339222614840989,0.2777385159010601
3538,2330033,1881,108,123,841,1773,1881,1.0,0.05741626794258373,0.9425837320574163,917,0.06539074960127592,0.44710260499734183,0.4875066454013822
3539,2330041,49,0,6,43,49,49,1.0425531914893618,0.0,1.0,0,0.12244897959183673,0.8775510204081632,0.0
3540,2330042,3243,88,267,805,3155,3243,1.0,0.027135368485969782,0.9728646315140302,2171,0.08233117483811286,0.24822695035460993,0.6694418748072772
3541,2350100,296,17,25,151,279,296,1.0,0.057432432432432436,0.9425675675675675,120,0.08445945945945946,0.5101351351351351,0.40540540540540543
3542,2350200,283,6,28,166,277,283,1.0,0.02120141342756184,0.9787985865724381,89,0.0989399293286219,0.5865724381625441,0.31448763250883394
3543,2350300,296,10,30,142,286,296,1.0,0.033783783783783786,0.9662162162162162,124,0.10135135135135136,0.4797297297297297,0.4189189189189189
3544,2350400,288,6,29,210,282,288,1.0,0.020833333333333332,0.9791666666666666,49,0.10069444444444445,0.7291666666666666,0.1701388888888889
3545,2370001,2417,236,69,585,2181,2417,1.0,0.09764170459247,0.90235829540753,1763,0.028547786512205214,0.24203558129913116,0.7294166321886636
3546,2370002,1180,5,71,516,1175,1180,1.0,0.00423728813559322,0.9957627118644068,593,0.06016949152542373,0.43728813559322033,0.502542372881356
3547,2370003,231,22,17,109,209,231,1.0,0.09523809523809523,0.9047619047619048,105,0.0735930735930736,0.47186147186147187,0.45454545454545453
3548,2370004,729,50,46,475,679,729,1.0,0.06858710562414266,0.9314128943758574,208,0.06310013717421124,0.6515775034293553,0.28532235939643347
3549,2370005,671,3,26,332,668,671,1.0,0.004470938897168405,0.9955290611028316,313,0.038748137108792845,0.4947839046199702,0.46646795827123694
3550,2370006,1365,86,74,563,1279,1365,1.0,0.063003663003663,0.936996336996337,728,0.054212454212454214,0.41245421245421243,0.5333333333333333
3551,2390001,2462,288,312,748,2174,2462,1.0,0.11697806661251016,0.8830219333874898,1402,0.12672623883021933,0.30381803411860275,0.5694557270511779
3552,2390002,2398,127,243,1031,2271,2398,1.0,0.05296080066722268,0.9470391993327774,1124,0.10133444537114263,0.4299416180150125,0.46872393661384487
3553,2390003,1979,153,194,748,1826,1979,1.0,0.07731177362304194,0.922688226376958,1037,0.09802930773117736,0.3779686710459828,0.5240020212228398
3554,2390004,356,0,29,188,356,356,1.0,0.0,1.0,139,0.08146067415730338,0.5280898876404494,0.3904494382022472
3555,2390005,508,0,65,322,508,508,1.0,0.0,1.0,121,0.1279527559055118,0.6338582677165354,0.23818897637795275
3556,2390006,1044,105,111,245,939,1044,1.0,0.10057471264367816,0.8994252873563219,688,0.10632183908045977,0.23467432950191572,0.6590038314176245
3557,2390007,136,0,9,53,136,136,1.0,0.0,1.0,74,0.0661764705882353,0.3897058823529412,0.5441176470588235
3558,2390008,552,0,67,299,552,552,1.0,0.0,1.0,186,0.1213768115942029,0.5416666666666666,0.33695652173913043
3559,2390009,502,2,44,269,500,502,1.0,0.00398406374501992,0.9960159362549801,189,0.08764940239043825,0.5358565737051793,0.37649402390438247
3560,2410001,42,3,7,14,39,42,1.0,0.07142857142857142,0.9285714285714286,21,0.16666666666666666,0.3333333333333333,0.5
3561,2410002,634,39,51,328,595,634,1.0,0.061514195583596214,0.9384858044164038,255,0.0804416403785489,0.5173501577287066,0.4022082018927445
3562,2410003,948,96,119,478,852,948,1.0,0.10126582278481013,0.8987341772151899,351,0.12552742616033755,0.5042194092827004,0.370253164556962
3563,2410004,355,0,58,297,355,355,1.002824858757062,0.0,1.0,0,0.16338028169014085,0.8366197183098592,0.0
3564,2410005,246,50,33,85,196,246,1.0,0.2032520325203252,0.7967479674796748,128,0.13414634146341464,0.34552845528455284,0.5203252032520326
3565,2410006,1871,539,242,444,1332,1871,1.0,0.28808123997862106,0.711918760021379,1185,0.1293425975414217,0.23730625334045966,0.6333511491181186
3566,2410007,1089,698,227,235,391,1089,1.0,0.6409550045913682,0.3590449954086318,627,0.20844811753902662,0.2157943067033976,0.5757575757575758
3567,2410008,1331,296,262,347,1035,1331,1.0,0.22238918106686703,0.777610818933133,722,0.19684447783621337,0.2607062359128475,0.5424492862509391
3568,2410009,2198,7,177,930,2191,2198,1.0,0.0031847133757961785,0.9968152866242038,1091,0.0805277525022748,0.42311191992720654,0.4963603275705187
3569,2410010,2214,148,166,820,2066,2214,1.0,0.06684733514001806,0.9331526648599819,1228,0.07497741644083107,0.37037037037037035,0.5546522131887985
3570,2410011,611,23,46,237,588,611,1.0,0.03764320785597381,0.9623567921440261,328,0.07528641571194762,0.3878887070376432,0.5368248772504092
3571,2410012,659,106,87,279,553,659,1.0,0.16084977238239756,0.8391502276176024,293,0.13201820940819423,0.4233687405159332,0.44461305007587254
3572,2410013,543,30,99,246,513,543,1.0,0.055248618784530384,0.9447513812154696,198,0.18232044198895028,0.4530386740331492,0.36464088397790057
3573,2410014,3357,344,371,1099,3013,3357,1.0,0.10247244563598451,0.8975275543640155,1887,0.11051534107834377,0.3273756330056598,0.5621090259159964
3574,2410015,2814,67,203,1198,2747,2814,1.0,0.023809523809523808,0.9761904761904762,1413,0.07213930348258707,0.425728500355366,0.502132196162047
3575,2410016,528,0,23,114,528,528,1.0,0.0,1.0,391,0.043560606060606064,0.2159090909090909,0.740530303030303
3576,2410017,1329,0,108,780,1329,1329,1.0,0.0,1.0,441,0.08126410835214447,0.5869074492099323,0.33182844243792325
3577,2410019,2229,298,271,993,1931,2229,1.0,0.13369223867205024,0.8663077613279497,965,0.12157918349035442,0.44549125168236875,0.4329295648272768
3578,2410020,1442,620,475,300,822,1442,1.0,0.42995839112343964,0.5700416088765603,667,0.32940360610263525,0.20804438280166435,0.46255201109570043
3579,2410021,1919,818,378,700,1101,1919,1.0,0.42626367899947887,0.5737363210005211,841,0.1969775924960917,0.36477331943720687,0.43824908806670143
3580,2430001,400,0,142,205,400,400,1.0,0.0,1.0,53,0.355,0.5125,0.1325
3581,2430002,353,0,110,125,353,353,1.0,0.0,1.0,118,0.311614730878187,0.35410764872521244,0.3342776203966006
3582,2430003,345,0,80,197,345,345,1.0,0.0,1.0,68,0.2318840579710145,0.5710144927536231,0.19710144927536233
3583,2430004,267,0,42,79,267,267,1.0,0.0,1.0,146,0.15730337078651685,0.2958801498127341,0.5468164794007491
3584,2430005,274,1,66,111,273,274,1.0,0.0036496350364963502,0.9963503649635036,97,0.24087591240875914,0.4051094890510949,0.354014598540146
3585,2450001,1585,1059,977,66,526,1585,1.0,0.6681388012618297,0.3318611987381703,542,0.616403785488959,0.0416403785488959,0.3419558359621451
3586,2450002,948,453,452,123,495,948,1.0,0.4778481012658228,0.5221518987341772,373,0.4767932489451477,0.12974683544303797,0.39345991561181437
3587,2450003,3080,2293,1249,45,787,3080,1.0,0.7444805194805195,0.25551948051948054,1786,0.4055194805194805,0.01461038961038961,0.5798701298701299
3588,2450004,1406,147,271,772,1259,1406,1.0,0.10455192034139403,0.895448079658606,363,0.19274537695590327,0.5490753911806543,0.2581792318634424
3589,2450005,1848,772,543,496,1076,1848,1.0,0.41774891774891776,0.5822510822510822,809,0.29383116883116883,0.2683982683982684,0.43777056277056275
3590,2450006,1307,602,465,239,705,1307,1.0,0.46059678653404745,0.5394032134659525,603,0.35577658760520275,0.18286151491966335,0.4613618974751339
3591,2450007,1704,764,431,362,940,1704,1.0,0.44835680751173707,0.5516431924882629,911,0.2529342723004695,0.21244131455399062,0.5346244131455399
3592,2450008,1217,1070,439,23,147,1217,1.0,0.8792111750205424,0.12078882497945768,755,0.3607230895645029,0.018898931799506986,0.6203779786359901
3593,2450009,3673,58,400,2182,3615,3673,1.0,0.015790906615845358,0.9842090933841546,1091,0.10890280424720937,0.5940647971685271,0.29703239858426356
3594,2450010,794,340,299,55,454,794,1.0,0.4282115869017632,0.5717884130982368,440,0.3765743073047859,0.06926952141057935,0.5541561712846348
3595,2450011,513,281,180,26,232,513,1.0,0.5477582846003899,0.4522417153996101,307,0.3508771929824561,0.050682261208576995,0.5984405458089669
3596,2450012,721,678,369,8,43,721,1.0,0.9403606102635229,0.059639389736477116,344,0.5117891816920943,0.011095700416088766,0.47711511789181693
3597,2450013,342,283,251,7,59,342,1.0,0.827485380116959,0.17251461988304093,84,0.7339181286549707,0.02046783625730994,0.24561403508771928
3598,2450014,1444,1072,784,29,372,1444,1.0,0.7423822714681441,0.25761772853185594,631,0.5429362880886427,0.02008310249307479,0.43698060941828254
3599,2450015,1445,845,672,47,600,1445,1.0,0.5847750865051903,0.41522491349480967,726,0.46505190311418687,0.032525951557093424,0.5024221453287198
3600,2450016,546,261,195,39,285,546,1.0,0.47802197802197804,0.521978021978022,312,0.35714285714285715,0.07142857142857142,0.5714285714285714
3601,2450017,2682,1070,800,758,1612,2682,1.0,0.3989560029828486,0.6010439970171514,1124,0.29828486204325133,0.2826249067859806,0.4190902311707681
3602,2450018,1577,1291,800,12,286,1577,1.0,0.8186429930247305,0.1813570069752695,765,0.507292327203551,0.007609384908053266,0.4850982878883957
3603,2450019,1678,1411,888,61,267,1678,1.0,0.8408820023837902,0.15911799761620976,729,0.5292014302741359,0.03635280095351609,0.43444576877234803
3604,2450020,1627,1223,664,59,404,1627,1.0,0.7516902274124155,0.24830977258758452,904,0.40811309157959436,0.03626306084818685,0.5556238475722188
3605,2450021,7331,2312,74,86,5019,7331,1.0,0.3153730732505797,0.6846269267494203,7171,0.010094120856636203,0.011731005319874506,0.9781748738234893
3606,2450022,4938,2372,1354,1039,2566,4938,1.0,0.4803564196030782,0.5196435803969218,2545,0.27420008100445525,0.21040907249898744,0.5153908464965573
3607,2450023,2611,1761,987,387,850,2611,1.0,0.6744542320949828,0.3255457679050172,1237,0.3780160857908847,0.14821907315204902,0.47376484105706623
3608,2450024,487,14,80,248,473,487,1.0,0.028747433264887063,0.971252566735113,159,0.16427104722792607,0.5092402464065708,0.3264887063655031
3609,2450025,2399,588,276,978,1811,2399,1.0,0.24510212588578575,0.7548978741142143,1145,0.11504793664026677,0.40766986244268444,0.47728220091704876
3610,2450026,2838,787,440,978,2051,2838,1.0,0.277307963354475,0.7226920366455251,1420,0.15503875968992248,0.34460887949260044,0.5003523608174771
3611,2450027,1490,452,409,420,1038,1490,1.0,0.30335570469798656,0.6966442953020134,661,0.274496644295302,0.28187919463087246,0.4436241610738255
3612,2450028,992,516,372,170,476,992,1.0,0.5201612903225806,0.4798387096774194,450,0.375,0.17137096774193547,0.4536290322580645
3613,2450029,1888,72,146,918,1816,1888,1.0,0.038135593220338986,0.961864406779661,824,0.07733050847457627,0.486228813559322,0.4364406779661017
3614,2450030,1226,14,108,638,1212,1226,1.0,0.011419249592169658,0.9885807504078303,480,0.08809135399673736,0.5203915171288744,0.3915171288743883
3615,2450031,851,29,100,635,822,851,1.0,0.03407755581668625,0.9659224441833137,116,0.11750881316098707,0.7461809635722679,0.136310223266745
3616,2450032,310,20,27,109,290,310,1.0,0.06451612903225806,0.9354838709677419,174,0.08709677419354839,0.35161290322580646,0.5612903225806452
3617,2450033,2676,479,437,863,2197,2676,1.0,0.1789985052316891,0.8210014947683109,1376,0.1633034379671151,0.32249626307922274,0.5142002989536621
3618,2450034,1495,1017,1173,31,478,1495,1.0,0.6802675585284281,0.3197324414715719,291,0.7846153846153846,0.02073578595317726,0.19464882943143813
3619,2450035,1068,0,85,402,1068,1068,1.0,0.0,1.0,581,0.07958801498127341,0.37640449438202245,0.5440074906367042
3620,2450036,1989,14,176,776,1975,1989,1.0,0.007038712921065862,0.9929612870789342,1037,0.08848667672197084,0.3901458019105078,0.5213675213675214
3621,2450037,2695,79,304,1231,2616,2695,1.0,0.029313543599257884,0.9706864564007421,1160,0.11280148423005566,0.4567717996289425,0.43042671614100186
3622,2450038,2158,46,237,1196,2112,2158,1.0,0.021316033364226137,0.9786839666357738,725,0.1098239110287303,0.5542168674698795,0.3359592215013902
3623,2450039,1646,1555,1335,20,91,1646,1.0,0.9447144592952612,0.05528554070473876,291,0.8110571081409478,0.012150668286755772,0.1767922235722965
3624,2450040,3352,149,304,1301,3203,3352,1.0,0.04445107398568019,0.9555489260143198,1747,0.09069212410501193,0.38812649164677804,0.52118138424821
3625,2450041,177,0,24,66,177,177,1.0,0.0,1.0,87,0.13559322033898305,0.3728813559322034,0.4915254237288136
3626,2450042,2537,0,317,1241,2537,2537,1.0,0.0,1.0,979,0.12495072920772567,0.48916042569964524,0.3858888450926291
3627,2450043,2590,133,296,1107,2457,2590,1.0,0.051351351351351354,0.9486486486486486,1187,0.11428571428571428,0.4274131274131274,0.4583011583011583
3628,2450044,943,371,214,202,572,943,1.0,0.3934252386002121,0.6065747613997879,527,0.22693531283138918,0.2142099681866384,0.5588547189819725
3629,2450045,1755,558,436,201,1197,1755,1.0,0.31794871794871793,0.6820512820512821,1118,0.24843304843304842,0.11452991452991453,0.6370370370370371
3630,2450046,1673,703,474,225,970,1673,1.0,0.4202032277346085,0.5797967722653915,974,0.28332337118948,0.13448894202032277,0.5821876867901973
3631,2450047,1461,406,544,230,1055,1461,1.0,0.2778918548939083,0.7221081451060917,687,0.3723477070499658,0.15742642026009582,0.4702258726899384
3632,2450048,1039,281,403,106,758,1039,1.0,0.27045235803657364,0.7295476419634264,530,0.38787295476419636,0.10202117420596728,0.5101058710298364
3633,2450049,547,209,157,42,338,547,1.0,0.3820840950639854,0.6179159049360147,348,0.2870201096892139,0.07678244972577697,0.6361974405850092
3634,2450050,2326,1210,1177,173,1116,2326,1.0,0.5202063628546861,0.47979363714531387,976,0.5060189165950129,0.07437661220980224,0.41960447119518485
3635,2450051,517,383,234,17,134,517,1.0,0.7408123791102514,0.25918762088974856,266,0.4526112185686654,0.03288201160541586,0.5145067698259188
3636,2450052,512,464,309,3,48,512,1.0,0.90625,0.09375,200,0.603515625,0.005859375,0.390625
3637,2450053,1668,1359,820,44,309,1668,1.0,0.814748201438849,0.18525179856115107,804,0.49160671462829736,0.026378896882494004,0.48201438848920863
3638,2450054,553,525,309,8,28,553,1.0,0.9493670886075949,0.05063291139240506,236,0.5587703435804702,0.014466546112115732,0.4267631103074141
3639,2450055,351,338,293,2,13,351,1.0,0.9629629629629629,0.037037037037037035,56,0.8347578347578347,0.005698005698005698,0.15954415954415954
3640,2450056,3093,72,315,1573,3021,3093,1.0,0.023278370514064017,0.976721629485936,1205,0.10184287099903007,0.5085677335919819,0.389589395408988
3641,2450057,946,905,595,10,41,946,1.0,0.9566596194503171,0.04334038054968287,341,0.6289640591966174,0.010570824524312896,0.36046511627906974
3642,2450058,43,2,8,25,41,43,1.0,0.046511627906976744,0.9534883720930233,10,0.18604651162790697,0.5813953488372093,0.23255813953488372
3643,2450059,1424,1386,808,8,38,1424,1.0,0.973314606741573,0.026685393258426966,608,0.5674157303370787,0.0056179775280898875,0.42696629213483145
3644,2450060,3712,102,403,1431,3610,3712,1.0,0.02747844827586207,0.9725215517241379,1878,0.10856681034482758,0.3855064655172414,0.505926724137931
3645,2450061,2448,278,377,586,2170,2448,1.0,0.11356209150326797,0.886437908496732,1485,0.15400326797385622,0.23937908496732027,0.6066176470588235
3646,2450062,2813,255,423,1361,2558,2813,1.0,0.09065055101315321,0.9093494489868468,1029,0.15037326697476006,0.48382509776039817,0.36580163526484183
3647,2450063,1173,1106,1018,27,67,1173,1.0,0.9428815004262575,0.05711849957374254,128,0.8678601875532822,0.023017902813299233,0.10912190963341858
3648,2450064,924,748,439,101,176,924,1.0,0.8095238095238095,0.19047619047619047,384,0.4751082251082251,0.10930735930735931,0.4155844155844156
3649,2450065,1379,4,280,1098,1375,1379,1.0222551928783383,0.0029006526468455403,0.9970993473531544,1,0.20304568527918782,0.7962291515591008,0.0007251631617113851
3650,2450066,1693,151,233,999,1542,1693,1.0,0.08919078558771412,0.9108092144122859,461,0.13762551683402244,0.5900767867690491,0.2722976963969285
3651,2450067,2567,1664,1366,161,903,2567,1.0,0.6482275029216985,0.3517724970783015,1040,0.5321386832878847,0.06271912738605376,0.40514218932606155
3652,2450068,2668,713,532,925,1955,2668,1.0,0.2672413793103448,0.7327586206896551,1211,0.19940029985007496,0.3467016491754123,0.45389805097451275
3653,2450069,3168,4,403,1500,3164,3168,1.0,0.0012626262626262627,0.9987373737373737,1265,0.12720959595959597,0.4734848484848485,0.3993055555555556
3654,2450070,2535,888,727,476,1647,2535,1.0,0.3502958579881657,0.6497041420118344,1332,0.28678500986193295,0.18777120315581855,0.5254437869822485
3655,2450071,92,0,16,48,92,92,1.0,0.0,1.0,28,0.17391304347826086,0.5217391304347826,0.30434782608695654
3656,2450072,3658,1058,713,582,2600,3658,1.0,0.2892290869327501,0.7107709130672498,2363,0.19491525423728814,0.15910333515582287,0.645981410606889
3657,2450073,2075,114,438,1332,1961,2075,1.0,0.05493975903614458,0.9450602409638554,305,0.21108433734939758,0.6419277108433735,0.14698795180722893
3658,2450074,3614,462,288,1590,3152,3614,1.0,0.12783619258439402,0.872163807415606,1736,0.07969009407858328,0.4399557277255119,0.4803541781959048
3659,2450075,2474,1408,471,43,1066,2474,1.0,0.5691188358932903,0.4308811641067098,1960,0.19037995149555376,0.017380759902991108,0.7922392886014551
3660,2450076,1392,839,433,91,553,1392,1.0,0.6027298850574713,0.39727011494252873,868,0.3110632183908046,0.0653735632183908,0.6235632183908046
3661,2450077,1941,1594,677,31,347,1941,1.0,0.8212261720762494,0.17877382792375066,1233,0.3487892838742916,0.015971148892323546,0.6352395672333848
3662,2450078,2507,1250,729,535,1257,2507,1.0,0.49860390905464697,0.501396090945353,1243,0.29078579976067015,0.2134024730753889,0.49581172716394095
3663,2450079,1853,417,413,883,1436,1853,1.0,0.22504047490555856,0.7749595250944414,557,0.22288181327576903,0.47652455477603883,0.3005936319481921
3664,2450080,250,6,20,122,244,250,1.0,0.024,0.976,108,0.08,0.488,0.432
3665,2450081,777,700,553,10,77,777,1.0,0.9009009009009009,0.0990990990990991,214,0.7117117117117117,0.01287001287001287,0.2754182754182754
3666,2450082,4057,1734,853,520,2323,4057,1.0,0.42740941582450087,0.5725905841754991,2684,0.21025388217894997,0.12817352723687453,0.6615725905841755
3667,2450083,1495,2,123,585,1493,1495,1.0,0.0013377926421404682,0.9986622073578595,787,0.0822742474916388,0.391304347826087,0.5264214046822743
3668,2450084,1358,1135,827,28,223,1358,1.0,0.8357879234167894,0.1642120765832106,503,0.6089837997054491,0.020618556701030927,0.3703976435935199
3669,2450085,1278,654,752,100,624,1278,1.0,0.5117370892018779,0.48826291079812206,426,0.5884194053208138,0.0782472613458529,0.3333333333333333
3670,2450086,1836,743,350,394,1093,1836,1.0,0.4046840958605665,0.5953159041394336,1092,0.1906318082788671,0.21459694989106753,0.5947712418300654
3671,2450087,1177,973,610,87,204,1177,1.0,0.826677994902294,0.17332200509770604,480,0.5182667799490229,0.07391673746813934,0.4078164825828377
3672,2450088,2370,1324,346,231,1046,2370,1.0,0.5586497890295359,0.4413502109704641,1793,0.1459915611814346,0.09746835443037975,0.7565400843881857
3673,2450089,658,328,208,72,330,658,1.0,0.49848024316109424,0.5015197568389058,378,0.3161094224924012,0.1094224924012158,0.574468085106383
3674,2450090,36,19,19,8,17,36,1.0,0.5277777777777778,0.4722222222222222,9,0.5277777777777778,0.2222222222222222,0.25
3675,2450091,558,24,36,311,534,558,1.0,0.043010752688172046,0.956989247311828,211,0.06451612903225806,0.557347670250896,0.3781362007168459
3676,2450092,1243,194,238,466,1049,1243,1.0,0.15607401448109412,0.8439259855189059,539,0.1914722445695897,0.37489943684633953,0.4336283185840708
3677,2450093,970,343,311,75,627,970,1.0,0.35360824742268043,0.6463917525773196,584,0.32061855670103095,0.07731958762886598,0.6020618556701031
3678,2450094,1674,116,304,1103,1558,1674,1.0,0.06929510155316607,0.9307048984468339,267,0.1816009557945042,0.6589008363201911,0.15949820788530467
3679,2450095,648,131,125,252,517,648,1.0,0.2021604938271605,0.7978395061728395,271,0.19290123456790123,0.3888888888888889,0.4182098765432099
3680,2450096,789,371,204,66,418,789,1.0,0.47021546261089986,0.5297845373891001,519,0.2585551330798479,0.08365019011406843,0.6577946768060836
3682,2450098,454,237,40,91,217,454,1.0,0.5220264317180616,0.4779735682819383,323,0.0881057268722467,0.20044052863436124,0.711453744493392
3683,2450099,1430,875,253,106,555,1430,1.0,0.6118881118881119,0.3881118881118881,1071,0.17692307692307693,0.07412587412587412,0.7489510489510489
3684,2450100,3340,1070,537,1105,2270,3340,1.0,0.3203592814371258,0.6796407185628742,1698,0.16077844311377246,0.33083832335329344,0.5083832335329341
3686,2450102,180,0,46,114,180,180,1.0,0.0,1.0,20,0.25555555555555554,0.6333333333333333,0.1111111111111111
3687,2450103,159,68,0,3,91,159,1.0,0.4276729559748428,0.5723270440251572,156,0.0,0.018867924528301886,0.9811320754716981
3688,2450104,99,96,14,40,3,99,1.0,0.9696969696969697,0.030303030303030304,45,0.1414141414141414,0.40404040404040403,0.45454545454545453
3689,2450105,199,93,28,14,106,199,1.0,0.46733668341708545,0.5326633165829145,157,0.1407035175879397,0.07035175879396985,0.7889447236180904
3690,2450106,15,0,3,12,15,15,2.5,0.0,1.0,0,0.2,0.8,0.0
3691,2450107,4765,1715,0,1,3050,4765,1.0,0.35991605456453307,0.640083945435467,4764,0.0,0.0002098635886673662,0.9997901364113326
3692,2450108,598,69,42,252,529,598,1.0,0.11538461538461539,0.8846153846153846,304,0.07023411371237458,0.4214046822742475,0.5083612040133779
3693,2450109,145,0,24,92,145,145,1.0,0.0,1.0,29,0.16551724137931034,0.6344827586206897,0.2
3694,2470001,969,3,371,49,966,969,1.0,0.0030959752321981426,0.9969040247678018,549,0.3828689370485036,0.05056759545923633,0.56656346749226
3695,2470002,949,0,312,144,949,949,1.0,0.0,1.0,493,0.3287671232876712,0.1517386722866175,0.5194942044257113
3696,2470003,775,0,263,87,775,775,1.0,0.0,1.0,425,0.3393548387096774,0.11225806451612903,0.5483870967741935
3697,2470004,789,0,354,76,789,789,1.0,0.0,1.0,359,0.44866920152091255,0.09632446134347275,0.4550063371356147
3698,2470005,4,0,1,0,4,4,1.0,0.0,1.0,3,0.25,0.0,0.75
3699,2490001,720,15,155,73,705,720,1.0,0.020833333333333332,0.9791666666666666,492,0.2152777777777778,0.10138888888888889,0.6833333333333333
3700,2490002,359,0,77,160,359,359,1.0,0.0,1.0,122,0.21448467966573817,0.4456824512534819,0.3398328690807799
3701,2490003,1345,0,176,445,1345,1345,1.0,0.0,1.0,724,0.1308550185873606,0.3308550185873606,0.5382899628252789
3702,2490004,1221,2,427,278,1219,1221,1.0,0.001638001638001638,0.9983619983619983,516,0.3497133497133497,0.22768222768222768,0.4226044226044226
3703,2490005,164,0,124,19,164,164,1.0,0.0,1.0,21,0.7560975609756098,0.11585365853658537,0.12804878048780488
3704,2490006,1381,0,340,92,1381,1381,1.0,0.0,1.0,949,0.24619840695148443,0.0666183924692252,0.6871832005792904
3705,2490007,2635,25,510,826,2610,2635,1.0,0.009487666034155597,0.9905123339658444,1299,0.1935483870967742,0.31347248576850095,0.49297912713472486
3706,2490008,3777,49,496,986,3728,3777,1.0,0.012973259200423616,0.9870267407995764,2295,0.13132115435530844,0.2610537463595446,0.607625099285147
3707,2490009,1091,4,161,89,1087,1091,1.0,0.0036663611365719525,0.9963336388634281,841,0.14757103574702107,0.08157653528872594,0.770852428964253
3708,2490010,2634,9,715,172,2625,2634,1.0,0.003416856492027335,0.9965831435079726,1747,0.27145026575550496,0.06529992406985573,0.6632498101746394
3709,2490011,930,7,295,119,923,930,1.0,0.007526881720430108,0.9924731182795699,516,0.3172043010752688,0.12795698924731183,0.5548387096774193
3710,2490012,2462,24,575,354,2438,2462,1.0,0.00974817221770918,0.9902518277822908,1533,0.23354995938261575,0.1437855402112104,0.6226645004061738
3711,2490013,592,10,177,34,582,592,1.0,0.016891891891891893,0.9831081081081081,381,0.2989864864864865,0.057432432432432436,0.643581081081081
3712,2490014,136,0,65,67,136,136,1.0,0.0,1.0,4,0.47794117647058826,0.49264705882352944,0.029411764705882353
3713,2490015,2135,0,441,247,2135,2135,1.0,0.0,1.0,1447,0.20655737704918034,0.11569086651053864,0.6777517564402811
3714,2490016,1164,0,340,50,1164,1164,1.0,0.0,1.0,774,0.2920962199312715,0.0429553264604811,0.6649484536082474
3715,2490017,1274,10,471,211,1264,1274,1.0,0.007849293563579277,0.9921507064364207,592,0.36970172684458397,0.16562009419152277,0.46467817896389324
3716,2490018,435,0,122,55,435,435,1.0,0.0,1.0,258,0.28045977011494255,0.12643678160919541,0.593103448275862
3717,2490019,446,0,31,106,446,446,1.0,0.0,1.0,309,0.06950672645739911,0.23766816143497757,0.6928251121076233
3718,2490020,812,0,271,58,812,812,1.0,0.0,1.0,483,0.33374384236453203,0.07142857142857142,0.5948275862068966
3719,2490022,2398,4,523,157,2394,2398,1.0,0.0016680567139282735,0.9983319432860718,1718,0.21809841534612176,0.06547122602168473,0.7164303586321935
3720,2510001,622,0,55,267,622,622,1.0,0.0,1.0,300,0.08842443729903537,0.4292604501607717,0.48231511254019294
3721,2510002,6133,309,432,1782,5824,6133,1.0,0.05038317299853253,0.9496168270014674,3919,0.0704386107940649,0.2905592695255177,0.6390021196804174
3722,2510003,4645,194,400,1540,4451,4645,1.0,0.04176533907427341,0.9582346609257266,2705,0.0861141011840689,0.33153928955866524,0.5823466092572659
3723,2510004,8559,327,778,2690,8232,8559,1.0,0.03820539782684893,0.961794602173151,5091,0.09089846944736535,0.3142890524593995,0.5948124780932352
3724,2510005,3859,154,396,1710,3705,3859,1.0,0.03990671158331174,0.9600932884166883,1753,0.10261725835708733,0.44311997926924074,0.4542627623736719
3725,2510006,337,0,26,192,337,337,1.0,0.0,1.0,119,0.0771513353115727,0.56973293768546,0.35311572700296734
3726,2510007,6502,47,707,2784,6455,6502,1.0,0.00722854506305752,0.9927714549369425,3011,0.10873577360812058,0.42817594586281144,0.463088280529068
3727,2510008,9161,855,745,1876,8306,9161,1.0,0.09333042244296474,0.9066695775570353,6540,0.08132299967252483,0.20478113743041151,0.7138958628970636
3728,2510009,1178,0,122,499,1178,1178,1.0,0.0,1.0,557,0.1035653650254669,0.4235993208828523,0.47283531409168084
3729,2510010,4712,46,440,1196,4666,4712,1.0,0.009762308998302207,0.9902376910016978,3076,0.0933786078098472,0.2538200339558574,0.6528013582342954
3730,2510011,4255,36,416,1852,4219,4255,1.0,0.00846063454759107,0.991539365452409,1987,0.09776733254994124,0.4352526439482961,0.46698002350176265
3731,2510012,2927,10,277,1219,2917,2927,1.0,0.0034164673727365906,0.9965835326272634,1431,0.09463614622480356,0.41646737273659035,0.48889648103860606
3732,2510013,2491,2,196,824,2489,2491,1.0,0.0008028904054596548,0.9991971095945403,1471,0.07868325973504617,0.3307908470493778,0.590525893215576
3733,2510014,500,4,47,211,496,500,1.0,0.008,0.992,242,0.094,0.422,0.484
3734,2510015,1738,14,132,729,1724,1738,1.0,0.00805523590333717,0.9919447640966629,877,0.0759493670886076,0.4194476409666283,0.5046029919447641
3735,2510016,664,13,59,236,651,664,1.0,0.01957831325301205,0.9804216867469879,369,0.08885542168674698,0.35542168674698793,0.5557228915662651
3736,2510017,5332,198,389,1031,5134,5332,1.0,0.037134283570892726,0.9628657164291072,3912,0.07295573893473369,0.1933608402100525,0.7336834208552138
3737,2510018,5582,251,492,1411,5331,5582,1.0,0.04496596202078108,0.9550340379792189,3679,0.0881404514510928,0.2527767825152275,0.6590827660336797
3738,2510019,5666,113,665,2667,5553,5666,1.0,0.019943522767384397,0.9800564772326156,2334,0.11736674902929757,0.47070243558065655,0.4119308153900459
3739,2510020,2231,204,298,282,2027,2231,1.0,0.09143881667413715,0.9085611833258629,1651,0.13357238906320035,0.1264007171671896,0.7400268937696101
3740,2510021,1855,25,173,622,1830,1855,1.0,0.013477088948787063,0.9865229110512129,1060,0.09326145552560647,0.3353099730458221,0.5714285714285714
3741,2510022,5647,277,568,1499,5370,5647,1.0,0.04905259429785727,0.9509474057021428,3580,0.100584381087303,0.2654506817779352,0.6339649371347619
3742,2510023,2297,0,236,990,2297,2297,1.0,0.0,1.0,1071,0.10274270787984327,0.43099695254680015,0.46626033957335655
3743,2510024,1813,6,145,501,1807,1813,1.0,0.003309431880860452,0.9966905681191396,1167,0.07997793712079426,0.2763375620518478,0.643684500827358
3744,2510025,3127,318,197,494,2809,3127,1.0,0.1016949152542373,0.8983050847457628,2436,0.062999680204669,0.15797889350815478,0.7790214262871762
3745,2510026,1641,56,126,636,1585,1641,1.0,0.03412553321145643,0.9658744667885436,879,0.07678244972577697,0.3875685557586837,0.5356489945155393
3746,2510027,2270,0,202,955,2270,2270,1.0,0.0,1.0,1113,0.08898678414096917,0.42070484581497797,0.49030837004405287
3747,2510028,2256,0,230,776,2256,2256,1.0,0.0,1.0,1250,0.10195035460992907,0.34397163120567376,0.5540780141843972
3748,2510029,925,17,101,451,908,925,1.0,0.018378378378378378,0.9816216216216216,373,0.10918918918918918,0.4875675675675676,0.40324324324324323
3749,2510030,1292,0,89,445,1292,1292,1.0,0.0,1.0,758,0.06888544891640867,0.3444272445820433,0.586687306501548
3750,2510031,1601,24,127,516,1577,1601,1.0,0.014990630855715179,0.9850093691442848,958,0.07932542161149282,0.3222985633978763,0.5983760149906309
3751,2510032,4185,147,316,1245,4038,4185,1.0,0.03512544802867384,0.9648745519713262,2624,0.07550776583034648,0.2974910394265233,0.6270011947431302
3752,2510033,1468,10,102,489,1458,1468,1.0,0.006811989100817439,0.9931880108991825,877,0.06948228882833787,0.33310626702997276,0.5974114441416893
3753,2510034,3219,4,272,891,3215,3219,1.0,0.0012426219322771047,0.9987573780677229,2056,0.08449829139484312,0.2767940354147251,0.6387076731904318
3754,2510035,3824,0,395,1942,3824,3824,1.0,0.0,1.0,1487,0.1032949790794979,0.5078451882845189,0.3888598326359833
3755,2510036,1639,73,145,211,1566,1639,1.0,0.044539353264185476,0.9554606467358145,1283,0.08846857840146431,0.12873703477730322,0.7827943868212325
3756,2530101,1264,93,161,581,1171,1264,1.0,0.07357594936708861,0.9264240506329114,522,0.127373417721519,0.4596518987341772,0.4129746835443038
3757,2530102,231,31,70,72,200,231,1.0,0.1341991341991342,0.8658008658008658,89,0.30303030303030304,0.3116883116883117,0.3852813852813853
3758,2530103,595,34,121,182,561,595,1.0,0.05714285714285714,0.9428571428571428,292,0.20336134453781513,0.3058823529411765,0.4907563025210084
3759,2530201,2119,62,303,645,2057,2119,1.0,0.0292590844738084,0.9707409155261916,1171,0.14299197734780558,0.30438886267107124,0.5526191599811232
3760,2530202,311,2,50,126,309,311,1.0,0.006430868167202572,0.9935691318327974,135,0.1607717041800643,0.40514469453376206,0.4340836012861736
3761,2530203,167,3,36,129,164,167,1.0,0.017964071856287425,0.9820359281437125,2,0.2155688622754491,0.7724550898203593,0.011976047904191617
3762,2530301,184,1,17,134,183,184,1.0,0.005434782608695652,0.9945652173913043,33,0.09239130434782608,0.7282608695652174,0.1793478260869565
3763,2530302,7561,2464,85,547,5097,7561,1.0,0.32588281973283956,0.6741171802671604,6929,0.011241899219679937,0.07234492791958735,0.9164131728607328
3764,2530303,915,3,100,569,912,915,1.0,0.003278688524590164,0.9967213114754099,246,0.1092896174863388,0.6218579234972678,0.26885245901639343
3765,2530401,1447,1,96,693,1446,1447,1.0,0.000691085003455425,0.9993089149965446,658,0.0663441603317208,0.47892190739460955,0.45473393227366965
3766,2530402,1051,23,187,584,1028,1051,1.0,0.021883920076117985,0.978116079923882,280,0.1779257849666984,0.5556612749762131,0.2664129400570885
3767,2550001,1400,16,316,367,1384,1400,1.0,0.011428571428571429,0.9885714285714285,717,0.2257142857142857,0.2621428571428571,0.5121428571428571
3768,2550002,156,0,16,96,156,156,1.0,0.0,1.0,44,0.10256410256410256,0.6153846153846154,0.28205128205128205
3769,2550003,198,0,11,114,198,198,1.0,0.0,1.0,73,0.05555555555555555,0.5757575757575758,0.3686868686868687
3770,2550004,4068,905,195,388,3163,4068,1.0,0.22246804326450345,0.7775319567354966,3485,0.04793510324483776,0.09537856440511308,0.8566863323500492
3771,2550005,1074,13,145,241,1061,1074,1.0,0.012104283054003724,0.9878957169459963,688,0.13500931098696461,0.22439478584729983,0.6405959031657356
3772,2550006,246,0,14,167,246,246,1.0,0.0,1.0,65,0.056910569105691054,0.6788617886178862,0.26422764227642276
3773,2550007,844,0,46,370,844,844,1.0,0.0,1.0,428,0.054502369668246446,0.43838862559241704,0.5071090047393365
3774,2550008,196,1,34,87,195,196,1.0,0.00510204081632653,0.9948979591836735,75,0.17346938775510204,0.44387755102040816,0.3826530612244898
3775,2550009,174,51,34,103,123,174,1.0,0.29310344827586204,0.7068965517241379,37,0.19540229885057472,0.5919540229885057,0.21264367816091953
3776,2550010,358,0,22,171,358,358,1.0,0.0,1.0,165,0.061452513966480445,0.4776536312849162,0.46089385474860334
3777,2550011,553,16,102,266,537,553,1.0,0.028933092224231464,0.9710669077757685,185,0.1844484629294756,0.4810126582278481,0.3345388788426763
3778,2550012,933,38,100,245,895,933,1.0,0.04072883172561629,0.9592711682743837,588,0.10718113612004287,0.26259378349410506,0.6302250803858521
3779,2550013,31,2,5,25,29,31,1.0714285714285714,0.06451612903225806,0.9354838709677419,1,0.16129032258064516,0.8064516129032258,0.03225806451612903
3780,2550014,1006,43,271,159,963,1006,1.0,0.042743538767395624,0.9572564612326043,576,0.26938369781312127,0.15805168986083498,0.5725646123260437
3781,2550015,89,0,13,24,89,89,1.0,0.0,1.0,52,0.14606741573033707,0.2696629213483146,0.5842696629213483
3782,2570001,3895,366,491,901,3529,3895,1.0,0.09396662387676509,0.9060333761232349,2503,0.12605905006418486,0.2313222079589217,0.6426187419768935
3783,2570002,1661,87,132,549,1574,1661,1.0,0.052378085490668275,0.9476219145093318,980,0.07947019867549669,0.3305237808549067,0.5900060204695966
3784,2570003,3844,327,500,1580,3517,3844,1.0,0.08506763787721124,0.9149323621227887,1764,0.13007284079084286,0.41103017689906346,0.4588969823100936
3785,2570004,4668,520,537,1701,4148,4668,1.0,0.11139674378748929,0.8886032562125107,2430,0.11503856041131105,0.3643958868894602,0.5205655526992288
3786,2570005,3224,1211,946,304,2013,3224,1.0,0.3756203473945409,0.624379652605459,1974,0.293424317617866,0.09429280397022333,0.6122828784119106
3787,2570006,2030,163,185,801,1867,2030,1.0,0.08029556650246306,0.9197044334975369,1044,0.09113300492610837,0.39458128078817734,0.5142857142857142
3788,2570007,3870,726,598,1199,3144,3870,1.0,0.1875968992248062,0.8124031007751938,2073,0.1545219638242894,0.30981912144702844,0.5356589147286822
3789,2570008,2392,234,348,585,2158,2392,1.0,0.09782608695652174,0.9021739130434783,1459,0.1454849498327759,0.24456521739130435,0.6099498327759197
3790,2570009,1937,524,246,647,1413,1937,1.0,0.270521424883841,0.729478575116159,1044,0.12700051626226122,0.3340216830149716,0.5389778007227671
3791,2570010,2442,89,219,996,2353,2442,1.0,0.03644553644553645,0.9635544635544635,1227,0.08968058968058969,0.40786240786240785,0.5024570024570024
3792,2570011,2984,255,263,945,2729,2984,1.0,0.08545576407506703,0.914544235924933,1776,0.08813672922252011,0.31668900804289546,0.5951742627345844
3793,2570012,2385,17,161,736,2368,2385,1.0,0.007127882599580713,0.9928721174004193,1488,0.06750524109014674,0.30859538784067087,0.6238993710691824
3794,2570013,4235,664,378,717,3571,4235,1.0,0.15678866587957496,0.843211334120425,3140,0.08925619834710743,0.1693034238488784,0.7414403778040142
3795,2570014,2975,243,364,1010,2732,2975,1.0,0.08168067226890756,0.9183193277310925,1601,0.1223529411764706,0.33949579831932775,0.5381512605042017
3796,2570015,3487,96,236,1070,3391,3487,1.0,0.027530828792658446,0.9724691712073416,2181,0.06767995411528535,0.30685402925150557,0.6254660166332091
3797,2570016,3544,47,225,1259,3497,3544,1.0,0.013261851015801355,0.9867381489841986,2060,0.06348758465011287,0.3552483069977427,0.5812641083521445
3798,2570017,1402,15,142,921,1387,1402,1.0,0.010699001426533523,0.9893009985734664,339,0.10128388017118402,0.6569186875891584,0.24179743223965763
3799,2570018,2409,111,202,964,2298,2409,1.0,0.0460772104607721,0.9539227895392279,1243,0.08385222083852222,0.40016604400166045,0.5159817351598174
3800,2570019,3239,222,382,1052,3017,3239,1.0,0.06853967273849954,0.9314603272615004,1805,0.11793763507255325,0.3247916023464032,0.5572707625810436
3801,2570020,1688,41,159,531,1647,1688,1.0,0.02428909952606635,0.9757109004739336,998,0.09419431279620853,0.3145734597156398,0.5912322274881516
3802,2570021,2681,77,216,992,2604,2681,1.0,0.028720626631853787,0.9712793733681462,1473,0.08056695262961582,0.3700111898545319,0.5494218575158523
3803,2570022,1090,59,94,565,1031,1090,1.0,0.05412844036697248,0.9458715596330275,431,0.08623853211009175,0.518348623853211,0.39541284403669724
3804,2570023,1297,150,132,404,1147,1297,1.0,0.1156515034695451,0.8843484965304549,761,0.1017733230531997,0.31148804934464147,0.5867386276021588
3805,2570024,1376,37,233,572,1339,1376,1.0,0.02688953488372093,0.9731104651162791,571,0.1693313953488372,0.41569767441860467,0.41497093023255816
3806,2570025,1298,229,171,337,1069,1298,1.0,0.17642526964560862,0.8235747303543913,790,0.13174114021571648,0.2596302003081664,0.6086286594761171
3807,2570026,3004,1430,722,142,1574,3004,1.0,0.4760319573901465,0.5239680426098535,2140,0.2403462050599201,0.04727030625832224,0.7123834886817576
3808,2570027,3905,449,367,1351,3456,3905,1.0,0.11498079385403329,0.8850192061459667,2187,0.0939820742637644,0.34596670934699103,0.5600512163892446
3809,2570028,2019,150,185,668,1869,2019,1.0,0.07429420505200594,0.9257057949479941,1166,0.09162951956414066,0.3308568598315998,0.5775136206042595
3810,2570029,2718,495,484,656,2223,2718,1.0,0.18211920529801323,0.8178807947019867,1578,0.1780721118469463,0.24135393671817512,0.5805739514348786
3811,2570030,2061,43,154,691,2018,2061,1.0,0.020863658418243572,0.9791363415817564,1216,0.07472100921882581,0.33527413876758855,0.5900048520135857
3812,2591010,3195,43,341,1218,3152,3195,1.0,0.013458528951486698,0.9865414710485133,1636,0.10672926447574335,0.3812206572769953,0.5120500782472613
3813,2591110,4045,21,431,2110,4024,4045,1.0,0.00519159456118665,0.9948084054388133,1504,0.10655129789864029,0.5216316440049443,0.37181705809641535
3814,2592020,2271,9,221,1346,2262,2271,1.0,0.003963011889035667,0.9960369881109643,704,0.09731395860854249,0.5926904447380009,0.3099955966534566
3815,2592080,4579,43,344,1721,4536,4579,1.0,0.009390696658659096,0.9906093033413409,2514,0.07512557326927277,0.3758462546407513,0.549028172089976
3816,2593030,2310,19,220,1265,2291,2310,1.0,0.008225108225108226,0.9917748917748918,825,0.09523809523809523,0.5476190476190477,0.35714285714285715
3817,2593040,4454,60,399,1888,4394,4454,1.0,0.01347103726986978,0.9865289627301302,2167,0.08958239784463404,0.42388863942523575,0.48652896273013024
3818,2593060,471,0,63,327,471,471,1.0,0.0,1.0,81,0.1337579617834395,0.6942675159235668,0.17197452229299362
3819,2594050,3477,0,308,1229,3477,3477,1.0,0.0,1.0,1940,0.08858211101524302,0.3534656312913431,0.5579522576934138
3820,2594070,260,0,34,191,260,260,1.0,0.0,1.0,35,0.13076923076923078,0.7346153846153847,0.1346153846153846
3821,2594100,3027,15,407,1743,3012,3027,1.0,0.004955401387512388,0.9950445986124876,877,0.13445655764783615,0.5758176412289395,0.2897258011232243
3822,2610001,104,0,23,25,104,104,1.0,0.0,1.0,56,0.22115384615384615,0.2403846153846154,0.5384615384615384
3823,2610002,80,0,25,13,80,80,1.0,0.0,1.0,42,0.3125,0.1625,0.525
3824,2610003,13,0,7,5,13,13,1.0,0.0,1.0,1,0.5384615384615384,0.38461538461538464,0.07692307692307693
3825,2610004,42,0,8,26,42,42,1.0,0.0,1.0,8,0.19047619047619047,0.6190476190476191,0.19047619047619047
3826,2610005,48,0,8,5,48,48,1.0,0.0,1.0,35,0.16666666666666666,0.10416666666666667,0.7291666666666666
3827,2610006,83,0,11,10,83,83,1.0,0.0,1.0,62,0.13253012048192772,0.12048192771084337,0.7469879518072289
3828,2630101,199,1,20,88,198,199,1.0,0.005025125628140704,0.9949748743718593,91,0.10050251256281408,0.44221105527638194,0.457286432160804
3829,2630201,30,0,3,21,30,30,1.0,0.0,1.0,6,0.1,0.7,0.2
3830,2630202,94,0,7,67,94,94,1.0,0.0,1.0,20,0.07446808510638298,0.7127659574468085,0.2127659574468085
3831,2630301,91,0,18,65,91,91,1.0,0.0,1.0,8,0.1978021978021978,0.7142857142857143,0.08791208791208792
3832,2630302,43,0,3,33,43,43,1.0,0.0,1.0,7,0.06976744186046512,0.7674418604651163,0.16279069767441862
3833,2630401,123,0,15,60,123,123,1.0,0.0,1.0,48,0.12195121951219512,0.4878048780487805,0.3902439024390244
3834,2650101,2660,58,335,1483,2602,2660,1.0,0.02180451127819549,0.9781954887218045,842,0.12593984962406016,0.5575187969924812,0.3165413533834586
3835,2650107,937,0,116,475,937,937,1.0,0.0,1.0,346,0.12379935965848453,0.5069370330843116,0.36926360725720386
3836,2650109,1578,6,168,760,1572,1578,1.0,0.0038022813688212928,0.9961977186311787,650,0.10646387832699619,0.4816223067173637,0.41191381495564006
3837,2650113,1565,7,242,907,1558,1565,1.0,0.0044728434504792336,0.9955271565495207,416,0.1546325878594249,0.579552715654952,0.265814696485623
3838,2650118,751,18,76,164,733,751,1.0,0.023968042609853527,0.9760319573901465,511,0.10119840213049268,0.21837549933422104,0.6804260985352862
3839,2650119,2399,62,333,1038,2337,2399,1.0,0.025844101709045435,0.9741558982909546,1028,0.13880783659858273,0.4326802834514381,0.42851187994997914
3840,2650202,2559,6,244,1133,2553,2559,1.0,0.0023446658851113715,0.9976553341148886,1182,0.09534974599452911,0.4427510746385307,0.4618991793669402
3841,2650211,2418,89,133,457,2329,2418,1.0,0.036807278742762614,0.9631927212572374,1828,0.05500413564929694,0.18899917287014062,0.7559966914805625
3842,2650215,3328,9,315,1607,3319,3328,1.0,0.002704326923076923,0.9972956730769231,1406,0.0946514423076923,0.48287259615384615,0.42247596153846156
3843,2650220,2024,60,251,1367,1964,2024,1.0,0.029644268774703556,0.9703557312252964,406,0.12401185770750989,0.6753952569169961,0.20059288537549408
3844,2650303,788,2,87,544,786,788,1.0,0.0025380710659898475,0.9974619289340102,157,0.11040609137055837,0.6903553299492385,0.19923857868020303
3845,2650308,740,1,75,269,739,740,1.0,0.0013513513513513514,0.9986486486486487,396,0.10135135135135136,0.3635135135135135,0.5351351351351351
3846,2650312,4187,55,545,1521,4132,4187,1.0,0.013135896823501313,0.9868641031764986,2121,0.13016479579651302,0.36326725579173635,0.5065679484117507
3847,2650314,3239,101,378,617,3138,3239,1.0,0.031182463723371412,0.9688175362766286,2244,0.11670268601420192,0.19049089225069465,0.6928064217351034
3848,2650404,1098,2,74,464,1096,1098,1.0,0.0018214936247723133,0.9981785063752276,560,0.06739526411657559,0.4225865209471767,0.5100182149362478
3849,2650405,1492,9,242,930,1483,1492,1.0,0.006032171581769437,0.9939678284182306,320,0.16219839142091153,0.6233243967828418,0.21447721179624665
3850,2650406,3092,21,319,1537,3071,3092,1.0,0.006791720569210867,0.9932082794307892,1236,0.10316946959896507,0.49708926261319536,0.3997412677878396
3851,2650410,288,0,11,206,288,288,1.0,0.0,1.0,71,0.03819444444444445,0.7152777777777778,0.2465277777777778
3852,2650416,2009,30,213,873,1979,2009,1.0,0.014932802389248382,0.9850671976107516,923,0.10602289696366352,0.4345445495271279,0.4594325535092086
3853,2650417,1998,13,181,922,1985,1998,1.0,0.0065065065065065065,0.9934934934934935,895,0.09059059059059059,0.46146146146146144,0.44794794794794796
3854,2670001,806,0,52,452,806,806,1.0,0.0,1.0,302,0.06451612903225806,0.5607940446650124,0.3746898263027295
3855,2670002,486,1,32,191,485,486,1.0,0.00205761316872428,0.9979423868312757,263,0.06584362139917696,0.39300411522633744,0.5411522633744856
3856,2670003,248,0,13,145,248,248,1.0,0.0,1.0,90,0.05241935483870968,0.5846774193548387,0.3629032258064516
3857,2670004,456,1,39,200,455,456,1.0,0.0021929824561403508,0.9978070175438597,217,0.08552631578947369,0.43859649122807015,0.4758771929824561
3858,2670006,383,0,18,187,383,383,1.0,0.0,1.0,178,0.04699738903394256,0.48825065274151436,0.46475195822454307
3859,2670007,353,0,26,197,353,353,1.0,0.0,1.0,130,0.07365439093484419,0.5580736543909348,0.36827195467422097
3860,2670009,636,0,37,295,636,636,1.0,0.0,1.0,304,0.05817610062893082,0.4638364779874214,0.4779874213836478
3861,2690001,38,0,0,37,38,38,1.0,0.0,1.0,1,0.0,0.9736842105263158,0.02631578947368421
3862,2690002,39,0,0,29,39,39,1.0,0.0,1.0,10,0.0,0.7435897435897436,0.2564102564102564
3863,2690004,37,0,2,34,37,37,1.0,0.0,1.0,1,0.05405405405405406,0.918918918918919,0.02702702702702703
3864,2710001,587,0,119,272,587,587,1.0,0.0,1.0,196,0.20272572402044292,0.46337308347529815,0.3339011925042589
3865,2710002,593,0,165,141,593,593,1.0,0.0,1.0,287,0.2782462057335582,0.23777403035413153,0.4839797639123103
3866,2710003,578,3,128,116,575,578,1.0,0.005190311418685121,0.9948096885813149,334,0.22145328719723184,0.20069204152249134,0.5778546712802768
3867,2710004,839,0,110,351,839,839,1.0,0.0,1.0,378,0.13110846245530394,0.41835518474374256,0.4505363528009535
3868,2730011,2001,121,338,550,1880,2001,1.0,0.06046976511744128,0.9395302348825587,1113,0.16891554222888555,0.2748625687156422,0.5562218890554723
3869,2730012,1665,26,256,426,1639,1665,1.0,0.015615615615615615,0.9843843843843844,983,0.15375375375375375,0.25585585585585585,0.5903903903903904
3870,2730013,1782,200,449,303,1582,1782,1.0,0.1122334455667789,0.8877665544332211,1030,0.25196408529741865,0.17003367003367004,0.5780022446689114
3871,2730014,446,0,153,102,446,446,1.0,0.0,1.0,191,0.3430493273542601,0.22869955156950672,0.4282511210762332
3872,2730021,397,0,171,44,397,397,1.0,0.0,1.0,182,0.43073047858942065,0.11083123425692695,0.45843828715365237
3873,2730022,1323,85,206,167,1238,1323,1.0,0.06424792139077853,0.9357520786092215,950,0.15570672713529857,0.12622826908541193,0.7180650037792895
3874,2730023,1827,55,309,254,1772,1827,1.0,0.030103995621237,0.969896004378763,1264,0.16912972085385877,0.13902572523262177,0.6918445539135194
3875,2730024,2495,143,329,272,2352,2495,1.0,0.05731462925851703,0.942685370741483,1894,0.13186372745490982,0.10901803607214429,0.7591182364729459
3876,2730031,2009,25,346,375,1984,2009,1.0,0.012444001991040319,0.9875559980089597,1288,0.17222498755599802,0.1866600298656048,0.6411149825783972
3877,2730032,1351,67,282,306,1284,1351,1.0,0.049592894152479645,0.9504071058475203,763,0.20873427091043673,0.22649888971132495,0.5647668393782384
3878,2730033,704,4,165,264,700,704,1.0,0.005681818181818182,0.9943181818181818,275,0.234375,0.375,0.390625
3879,2730034,622,3,135,213,619,622,1.0,0.00482315112540193,0.9951768488745981,274,0.2170418006430868,0.342443729903537,0.4405144694533762
3880,2730035,936,6,276,260,930,936,1.0,0.00641025641025641,0.9935897435897436,400,0.2948717948717949,0.2777777777777778,0.42735042735042733
3881,2730041,346,11,176,38,335,346,1.0,0.031791907514450865,0.9682080924855492,132,0.5086705202312138,0.10982658959537572,0.3815028901734104
3882,2730042,1152,0,306,59,1152,1152,1.0,0.0,1.0,787,0.265625,0.051215277777777776,0.6831597222222222
3883,2730043,2036,1,419,294,2035,2036,1.0,0.0004911591355599214,0.99950884086444,1323,0.20579567779960709,0.1444007858546169,0.649803536345776
3884,2730044,810,64,130,81,746,810,1.0,0.07901234567901234,0.9209876543209876,599,0.16049382716049382,0.1,0.7395061728395061
3885,2730045,756,2,308,50,754,756,1.0,0.0026455026455026454,0.9973544973544973,398,0.4074074074074074,0.06613756613756613,0.5264550264550265
3886,2750101,665,27,77,335,638,665,1.0,0.0406015037593985,0.9593984962406015,253,0.11578947368421053,0.5037593984962406,0.3804511278195489
3887,2750201,206,1,30,149,205,206,1.0,0.0048543689320388345,0.9951456310679612,27,0.14563106796116504,0.7233009708737864,0.13106796116504854
3888,2750202,395,10,65,134,385,395,1.0,0.02531645569620253,0.9746835443037974,196,0.16455696202531644,0.3392405063291139,0.4962025316455696
3889,2750301,530,46,72,233,484,530,1.0,0.08679245283018867,0.9132075471698113,225,0.13584905660377358,0.439622641509434,0.42452830188679247
3890,2750302,85,0,12,52,85,85,1.0,0.0,1.0,21,0.1411764705882353,0.611764705882353,0.24705882352941178
3891,2750401,653,63,76,257,590,653,1.0,0.09647779479326186,0.9035222052067381,320,0.11638591117917305,0.39356814701378257,0.4900459418070444
3892,277001B,169,5,17,106,164,169,1.0,0.029585798816568046,0.9704142011834319,46,0.10059171597633136,0.6272189349112426,0.27218934911242604
3893,277001C,272,43,16,157,229,272,1.0,0.15808823529411764,0.8419117647058824,99,0.058823529411764705,0.5772058823529411,0.3639705882352941
3894,277001D,581,68,56,308,513,581,1.0,0.11703958691910499,0.882960413080895,217,0.0963855421686747,0.5301204819277109,0.37349397590361444
3895,277001E,695,17,80,333,678,695,1.0,0.02446043165467626,0.9755395683453237,282,0.11510791366906475,0.479136690647482,0.40575539568345326
3896,277001F,750,45,60,429,705,750,1.0,0.06,0.94,261,0.08,0.572,0.348
3897,277001G,604,6,50,231,598,604,1.0,0.009933774834437087,0.9900662251655629,323,0.08278145695364239,0.3824503311258278,0.5347682119205298
3898,277001H,522,11,29,244,511,522,1.0,0.0210727969348659,0.9789272030651341,249,0.05555555555555555,0.4674329501915709,0.47701149425287354
3899,277001I,166,12,11,61,154,166,1.0,0.07228915662650602,0.927710843373494,94,0.06626506024096386,0.3674698795180723,0.5662650602409639
3900,277002D,895,47,121,243,848,895,1.0,0.05251396648044693,0.9474860335195531,531,0.13519553072625698,0.27150837988826815,0.5932960893854748
3901,277002E,518,24,36,296,494,518,1.0,0.04633204633204633,0.9536679536679536,186,0.0694980694980695,0.5714285714285714,0.3590733590733591
3902,277002F,215,11,11,79,204,215,1.0,0.05116279069767442,0.9488372093023256,125,0.05116279069767442,0.3674418604651163,0.5813953488372093
3903,277002G,654,68,83,238,586,654,1.0,0.10397553516819572,0.8960244648318043,333,0.12691131498470948,0.363914373088685,0.5091743119266054
3904,277003D,1141,9,75,364,1132,1141,1.0,0.007887817703768623,0.9921121822962313,702,0.06573181419807186,0.31901840490797545,0.6152497808939527
3905,277003E,1103,48,76,593,1055,1103,1.0,0.043517679057116954,0.956482320942883,434,0.06890299184043518,0.5376246600181324,0.39347234814143245
3906,277003F,576,84,51,257,492,576,1.0,0.14583333333333334,0.8541666666666666,268,0.08854166666666667,0.4461805555555556,0.4652777777777778
3907,277003G,435,51,52,313,384,435,1.0,0.11724137931034483,0.8827586206896552,70,0.11954022988505747,0.7195402298850575,0.16091954022988506
3908,277003I,1416,29,91,641,1387,1416,1.0,0.020480225988700564,0.9795197740112994,684,0.06426553672316385,0.452683615819209,0.4830508474576271
3909,277004B,1817,3,167,797,1814,1817,1.0,0.001651073197578426,0.9983489268024216,853,0.09190974133186572,0.43863511282333517,0.46945514584479914
3910,277004C,382,60,52,133,322,382,1.0,0.15706806282722513,0.8429319371727748,197,0.13612565445026178,0.3481675392670157,0.5157068062827225
3911,277004D,1652,77,95,715,1575,1652,1.0,0.046610169491525424,0.9533898305084746,842,0.05750605326876514,0.4328087167070218,0.5096852300242131
3912,277004E,735,71,60,341,664,735,1.0,0.09659863945578231,0.9034013605442177,334,0.08163265306122448,0.4639455782312925,0.454421768707483
3913,277004F,1626,47,145,800,1579,1626,1.0,0.02890528905289053,0.9710947109471094,681,0.08917589175891759,0.4920049200492005,0.4188191881918819
3914,277004G,1889,149,130,951,1740,1889,1.0,0.07887771307570143,0.9211222869242985,808,0.06881948120698782,0.5034409740603494,0.4277395447326628
3915,2771A3B,1253,103,178,305,1150,1253,1.0,0.08220271348762968,0.9177972865123704,770,0.1420590582601756,0.24341580207501995,0.6145251396648045
3916,2771A5A,2604,584,297,420,2020,2604,1.0,0.22427035330261136,0.7757296466973886,1887,0.11405529953917051,0.16129032258064516,0.7246543778801844
3917,2771E7C,1188,92,126,554,1096,1188,1.0,0.07744107744107744,0.9225589225589226,508,0.10606060606060606,0.4663299663299663,0.4276094276094276
3918,2772A1A,1889,694,455,162,1195,1889,1.0,0.3673901535203812,0.6326098464796188,1272,0.24086818422445738,0.08575966119640022,0.6733721545791425
3919,2772B2A,2106,694,466,173,1412,2106,1.0,0.3295346628679962,0.6704653371320038,1467,0.22127255460588793,0.08214624881291548,0.6965811965811965
3920,2772C3A,2408,473,301,433,1935,2408,1.0,0.19642857142857142,0.8035714285714286,1674,0.125,0.1798172757475083,0.6951827242524917
3921,2773C7G,3667,414,495,1191,3253,3667,1.0,0.11289882737932916,0.8871011726206709,1981,0.13498772838832834,0.32478865557676573,0.5402236160349059
3922,2773H3C,1014,243,112,261,771,1014,1.0,0.23964497041420119,0.7603550295857988,641,0.11045364891518737,0.257396449704142,0.6321499013806706
3923,2774A6E,1635,185,187,697,1450,1635,1.0,0.11314984709480122,0.8868501529051988,751,0.11437308868501529,0.42629969418960245,0.45932721712538227
3924,2790001,1018,37,131,398,981,1018,1.0,0.036345776031434185,0.9636542239685658,489,0.12868369351669942,0.39096267190569745,0.48035363457760316
3925,2790002,837,30,148,108,807,837,1.0,0.035842293906810034,0.96415770609319,581,0.1768219832735962,0.12903225806451613,0.6941457586618877
3926,2790003,926,23,78,364,903,926,1.0,0.024838012958963283,0.9751619870410367,484,0.08423326133909287,0.3930885529157667,0.5226781857451404
3927,2790004,77,2,3,36,75,77,1.0,0.025974025974025976,0.974025974025974,38,0.03896103896103896,0.4675324675324675,0.4935064935064935
3928,2790005,513,7,54,188,506,513,1.0,0.01364522417153996,0.98635477582846,271,0.10526315789473684,0.3664717348927875,0.5282651072124757
3929,2790006,442,29,56,111,413,442,1.0,0.06561085972850679,0.9343891402714932,275,0.12669683257918551,0.251131221719457,0.6221719457013575
3930,2790007,212,10,9,56,202,212,1.0,0.04716981132075472,0.9528301886792453,147,0.04245283018867924,0.2641509433962264,0.6933962264150944
3931,2790008,2159,91,257,849,2068,2159,1.0,0.042149143121815655,0.9578508568781844,1053,0.1190365910143585,0.39323761000463175,0.4877257989810097
3932,2790009,1060,38,119,333,1022,1060,1.0,0.035849056603773584,0.9641509433962264,608,0.11226415094339623,0.3141509433962264,0.5735849056603773
3933,2790010,580,29,62,194,551,580,1.0,0.05,0.95,324,0.10689655172413794,0.33448275862068966,0.5586206896551724
3934,2790011,661,8,68,339,653,661,1.0,0.012102874432677761,0.9878971255673222,254,0.10287443267776097,0.5128593040847201,0.3842662632375189
3935,2790012,169,2,13,82,167,169,1.0,0.011834319526627219,0.9881656804733728,74,0.07692307692307693,0.48520710059171596,0.4378698224852071
3936,2810001,1976,221,304,880,1755,1976,1.0,0.1118421052631579,0.8881578947368421,792,0.15384615384615385,0.44534412955465585,0.4008097165991903
3937,2810002,3504,136,362,1493,3368,3504,1.0,0.03881278538812785,0.9611872146118722,1649,0.10331050228310502,0.4260844748858447,0.4706050228310502
3938,2810003,2863,26,199,608,2837,2863,1.0,0.009081383164512749,0.9909186168354872,2056,0.06950750960530912,0.21236465246245198,0.7181278379322389
3939,2810004,1284,10,116,501,1274,1284,1.0,0.00778816199376947,0.9922118380062306,667,0.09034267912772585,0.3901869158878505,0.5194704049844237
3940,2810005,442,0,38,168,442,442,1.0,0.0,1.0,236,0.08597285067873303,0.38009049773755654,0.5339366515837104
3941,2810006,440,0,40,255,440,440,1.0,0.0,1.0,145,0.09090909090909091,0.5795454545454546,0.32954545454545453
3942,2810007,739,0,72,343,739,739,1.0,0.0,1.0,324,0.09742895805142084,0.46414073071718537,0.43843031123139375
3943,2810008,2250,135,190,703,2115,2250,1.0,0.06,0.94,1357,0.08444444444444445,0.31244444444444447,0.6031111111111112
3944,2810009,1932,233,158,670,1699,1932,1.0,0.12060041407867494,0.879399585921325,1104,0.08178053830227744,0.34679089026915116,0.5714285714285714
3945,2830001,1265,34,219,286,1231,1265,1.0,0.026877470355731226,0.9731225296442688,760,0.17312252964426877,0.22608695652173913,0.6007905138339921
3946,2830002,760,3,122,56,757,760,1.0,0.003947368421052632,0.9960526315789474,582,0.16052631578947368,0.07368421052631578,0.7657894736842106
3947,2830004,75,3,9,46,72,75,1.0,0.04,0.96,20,0.12,0.6133333333333333,0.26666666666666666
3948,2830005,1533,36,220,101,1497,1533,1.0,0.023483365949119372,0.9765166340508806,1212,0.14350945857795172,0.06588388780169602,0.7906066536203522
3949,2830006,576,11,126,85,565,576,1.0,0.019097222222222224,0.9809027777777778,365,0.21875,0.14756944444444445,0.6336805555555556
3950,283003A,19,0,0,8,19,19,1.0,0.0,1.0,11,0.0,0.42105263157894735,0.5789473684210527
3951,2850001,1325,159,101,568,1166,1325,1.0,0.12,0.88,656,0.07622641509433963,0.4286792452830189,0.4950943396226415
3952,2850002,1596,76,191,723,1520,1596,1.0,0.047619047619047616,0.9523809523809523,682,0.11967418546365914,0.45300751879699247,0.4273182957393484
3953,2850007,269,11,29,119,258,269,1.0,0.040892193308550186,0.9591078066914498,121,0.10780669144981413,0.4423791821561338,0.44981412639405205
3954,2850008,554,26,69,438,528,554,1.0,0.04693140794223827,0.9530685920577617,47,0.12454873646209386,0.7906137184115524,0.08483754512635379
3955,2850009,1438,157,170,619,1281,1438,1.0,0.10917941585535466,0.8908205841446454,649,0.11821974965229486,0.43045897079276774,0.4513212795549374
3956,2850011,302,12,30,177,290,302,1.0,0.039735099337748346,0.9602649006622517,95,0.09933774834437085,0.5860927152317881,0.31456953642384106
3957,2850012,354,40,29,203,314,354,1.0,0.11299435028248588,0.8870056497175142,122,0.08192090395480225,0.5734463276836158,0.3446327683615819
3958,2850015,138,0,21,110,138,138,1.0,0.0,1.0,7,0.15217391304347827,0.7971014492753623,0.050724637681159424
3959,2850016,552,4,26,251,548,552,1.0,0.007246376811594203,0.9927536231884058,275,0.04710144927536232,0.45471014492753625,0.49818840579710144
3960,2850017,274,2,17,174,272,274,1.0,0.0072992700729927005,0.9927007299270073,83,0.06204379562043796,0.635036496350365,0.3029197080291971
3961,2850019,407,16,34,196,391,407,1.0,0.03931203931203931,0.9606879606879607,177,0.08353808353808354,0.48157248157248156,0.4348894348894349
3962,2850020,106,3,19,53,103,106,1.0,0.02830188679245283,0.9716981132075472,34,0.1792452830188679,0.5,0.32075471698113206
3963,2850023,1387,0,149,679,1387,1387,1.0,0.0,1.0,559,0.10742609949531362,0.48954578226387885,0.4030281182408075
3964,2850026,592,171,48,93,421,592,1.0,0.28885135135135137,0.7111486486486487,451,0.08108108108108109,0.1570945945945946,0.7618243243243243
3965,2850027,267,15,19,120,252,267,1.0,0.056179775280898875,0.9438202247191011,128,0.07116104868913857,0.449438202247191,0.4794007490636704
3966,2850029,1138,60,139,608,1078,1138,1.0,0.05272407732864675,0.9472759226713533,391,0.12214411247803164,0.5342706502636204,0.343585237258348
3967,2850030,2240,84,186,836,2156,2240,1.0,0.0375,0.9625,1218,0.08303571428571428,0.3732142857142857,0.54375
3968,2850031,1133,49,124,646,1084,1133,1.0,0.04324801412180053,0.9567519858781994,363,0.10944395410414828,0.5701676963812886,0.32038834951456313
3969,2850032,403,17,27,183,386,403,1.0,0.04218362282878412,0.9578163771712159,193,0.06699751861042183,0.45409429280397023,0.47890818858560796
3970,2870101,2619,417,298,636,2202,2619,1.0,0.15922107674684993,0.8407789232531501,1685,0.11378388697976327,0.24284077892325315,0.6433753340969836
3971,2870102,335,106,97,73,229,335,1.0,0.3164179104477612,0.6835820895522388,165,0.28955223880597014,0.21791044776119403,0.4925373134328358
3972,2870103,245,5,37,128,240,245,1.0,0.02040816326530612,0.9795918367346939,80,0.1510204081632653,0.5224489795918368,0.32653061224489793
3973,2870201,463,0,40,350,463,463,1.0,0.0,1.0,73,0.08639308855291576,0.755939524838013,0.15766738660907129
3974,2870202,1932,190,209,824,1742,1932,1.0,0.09834368530020704,0.901656314699793,899,0.10817805383022774,0.42650103519668736,0.46532091097308487
3975,2870203,371,21,39,187,350,371,1.0,0.05660377358490566,0.9433962264150944,145,0.10512129380053908,0.5040431266846361,0.3908355795148248
3976,2870301,174,5,15,73,169,174,1.0,0.028735632183908046,0.9712643678160919,86,0.08620689655172414,0.41954022988505746,0.4942528735632184
3977,2870302,1818,64,216,625,1754,1818,1.0,0.0352035203520352,0.9647964796479648,977,0.1188118811881188,0.34378437843784376,0.5374037403740374
3978,2870303,1060,0,172,467,1060,1060,1.0,0.0,1.0,421,0.16226415094339622,0.44056603773584907,0.39716981132075474
3979,2870304,191,49,40,91,142,191,1.0,0.25654450261780104,0.743455497382199,60,0.2094240837696335,0.47643979057591623,0.31413612565445026
3980,2870401,874,268,143,281,606,874,1.0,0.30663615560640733,0.6933638443935927,450,0.16361556064073227,0.32151029748283755,0.5148741418764302
3981,2870402,193,50,52,60,143,193,1.0,0.25906735751295334,0.7409326424870466,81,0.2694300518134715,0.31088082901554404,0.41968911917098445
3982,2870403,275,42,47,146,233,275,1.0,0.15272727272727274,0.8472727272727273,82,0.1709090909090909,0.5309090909090909,0.29818181818181816
3983,2870404,885,189,160,307,696,885,1.0,0.2135593220338983,0.7864406779661017,418,0.1807909604519774,0.34689265536723163,0.47231638418079097
3984,2870405,707,23,69,261,684,707,1.0,0.03253182461103253,0.9674681753889675,377,0.09759547383309759,0.36916548797736914,0.5332390381895332
3985,2890001,1580,115,149,742,1465,1580,1.0,0.07278481012658228,0.9272151898734177,689,0.09430379746835443,0.46962025316455697,0.4360759493670886
3986,2890002,373,38,24,196,335,373,1.0,0.10187667560321716,0.8981233243967829,153,0.064343163538874,0.5254691689008043,0.4101876675603217
3987,2890003,553,15,81,292,538,553,1.0,0.027124773960216998,0.972875226039783,180,0.14647377938517178,0.5280289330922242,0.325497287522604
3988,2890004,889,87,101,446,802,889,1.0,0.09786276715410573,0.9021372328458943,342,0.11361079865016872,0.5016872890888638,0.3847019122609674
3989,2890005,532,7,41,290,525,532,1.0,0.013157894736842105,0.9868421052631579,201,0.07706766917293233,0.5451127819548872,0.37781954887218044
3990,2890006,927,0,75,676,927,927,1.0,0.0,1.0,176,0.08090614886731391,0.7292340884573895,0.18985976267529667
3991,2890007,948,16,30,359,932,948,1.0,0.016877637130801686,0.9831223628691983,559,0.03164556962025317,0.37869198312236285,0.5896624472573839
3992,2890008,1280,61,110,487,1219,1280,1.0,0.04765625,0.95234375,683,0.0859375,0.38046875,0.53359375
3993,2890009,423,11,17,171,412,423,1.0,0.026004728132387706,0.9739952718676123,235,0.04018912529550828,0.40425531914893614,0.5555555555555556
3994,2890010,1059,85,74,587,974,1059,1.0,0.08026440037771483,0.9197355996222851,398,0.06987724268177525,0.554296506137866,0.37582625118035884
3995,2890011,1134,110,96,478,1024,1134,1.0,0.09700176366843033,0.9029982363315696,560,0.08465608465608465,0.42151675485008816,0.49382716049382713
3996,2890012,998,243,154,365,755,998,1.0,0.24348697394789579,0.7565130260521042,479,0.15430861723446893,0.3657314629258517,0.47995991983967934
3997,2890013,798,70,44,420,728,798,1.0,0.08771929824561403,0.9122807017543859,334,0.05513784461152882,0.5263157894736842,0.41854636591478694
3998,2890014,244,24,24,97,220,244,1.0,0.09836065573770492,0.9016393442622951,123,0.09836065573770492,0.3975409836065574,0.5040983606557377
3999,289001A,226,11,14,93,215,226,1.0,0.048672566371681415,0.9513274336283186,119,0.061946902654867256,0.41150442477876104,0.5265486725663717
4000,289005A,92,0,2,17,92,92,1.0,0.0,1.0,73,0.021739130434782608,0.18478260869565216,0.7934782608695652
4001,289014A,394,28,26,98,366,394,1.0,0.07106598984771574,0.9289340101522843,270,0.06598984771573604,0.24873096446700507,0.6852791878172588
4002,2910001,866,66,76,279,800,866,1.0,0.07621247113163972,0.9237875288683602,511,0.08775981524249422,0.32217090069284066,0.5900692840646651
4003,2910002,893,85,79,512,808,893,1.0,0.09518477043673013,0.9048152295632699,302,0.08846584546472565,0.5733482642777156,0.3381858902575588
4004,2910003,1887,51,157,1086,1836,1887,1.0,0.02702702702702703,0.972972972972973,644,0.08320084790673025,0.575516693163752,0.34128245892951775
4005,2910004,707,135,73,270,572,707,1.0,0.19094766619519093,0.809052333804809,364,0.10325318246110325,0.38189533239038187,0.5148514851485149
4006,2910005,3526,307,251,1077,3219,3526,1.0,0.08706749858196257,0.9129325014180374,2198,0.07118547929665343,0.3054452637549631,0.6233692569483834
4007,2910006,1186,66,76,462,1120,1186,1.0,0.05564924114671164,0.9443507588532883,648,0.06408094435075885,0.38954468802698144,0.5463743676222597
4008,2910007,2853,252,295,650,2601,2853,1.0,0.08832807570977919,0.9116719242902208,1908,0.10339992989835262,0.2278303540133193,0.668769716088328
4009,2910008,2593,38,122,999,2555,2593,1.0,0.014654839953721558,0.9853451600462785,1472,0.047049749325106055,0.3852680293096799,0.5676822213652141
4010,2910009,2641,0,146,1086,2641,2641,1.0,0.0,1.0,1409,0.05528209011737978,0.4112078758046195,0.5335100340780008
4011,2910010,3995,465,401,1273,3530,3995,1.0,0.11639549436795996,0.8836045056320401,2321,0.10037546933667084,0.31864831038798497,0.5809762202753442
4012,2910011,667,207,259,204,460,667,1.0,0.3103448275862069,0.6896551724137931,204,0.38830584707646176,0.3058470764617691,0.3058470764617691
4013,2910012,1488,89,166,541,1399,1488,1.0,0.05981182795698925,0.9401881720430108,781,0.11155913978494623,0.3635752688172043,0.5248655913978495
4014,2910013,659,15,30,281,644,659,1.0,0.02276176024279211,0.9772382397572079,348,0.04552352048558422,0.4264036418816389,0.5280728376327769
4015,2910014,6557,1549,67,306,5008,6557,1.0,0.23623608357480555,0.7637639164251945,6184,0.010218087540033552,0.04666768339179503,0.9431142290681714
4016,2910015,748,93,72,188,655,748,1.0,0.12433155080213903,0.8756684491978609,488,0.0962566844919786,0.25133689839572193,0.6524064171122995
4017,2910016,422,14,43,190,408,422,1.0,0.03317535545023697,0.966824644549763,189,0.1018957345971564,0.45023696682464454,0.44786729857819907
4018,2910017,572,3,32,324,569,572,1.0,0.005244755244755245,0.9947552447552448,216,0.055944055944055944,0.5664335664335665,0.3776223776223776
4019,2910018,1317,568,555,166,749,1317,1.0,0.4312832194381169,0.568716780561883,596,0.4214123006833713,0.126044039483675,0.4525436598329537
4020,2910019,2124,718,313,675,1406,2124,1.0,0.3380414312617702,0.6619585687382298,1136,0.14736346516007534,0.3177966101694915,0.5348399246704332
4021,2910020,1359,849,526,24,510,1359,1.0,0.6247240618101545,0.37527593818984545,809,0.38704930095658574,0.017660044150110375,0.5952906548933039
4022,2910021,3067,44,238,1490,3023,3067,1.0,0.014346266710140202,0.9856537332898598,1339,0.07760026084121291,0.4858167590479296,0.4365829801108575
4023,2910022,5163,311,385,1262,4852,5163,1.0,0.06023629672670928,0.9397637032732907,3516,0.07456904900251791,0.24443153205500678,0.6809994189424753
4024,2910023,1910,0,124,687,1910,1910,1.0,0.0,1.0,1099,0.06492146596858639,0.35968586387434553,0.5753926701570681
4025,2910024,805,42,67,453,763,805,1.0,0.05217391304347826,0.9478260869565217,285,0.08322981366459627,0.5627329192546584,0.35403726708074534
4026,2910025,1143,150,66,434,993,1143,1.0,0.13123359580052493,0.868766404199475,643,0.05774278215223097,0.37970253718285213,0.5625546806649169
4027,2910026,3528,58,196,928,3470,3528,1.0,0.016439909297052153,0.9835600907029478,2404,0.05555555555555555,0.26303854875283444,0.68140589569161
4028,2910027,246,78,23,145,168,246,1.0,0.3170731707317073,0.6829268292682927,78,0.09349593495934959,0.5894308943089431,0.3170731707317073
4029,2910028,893,54,43,304,839,893,1.0,0.060470324748040316,0.9395296752519597,546,0.048152295632698766,0.3404255319148936,0.6114221724524076
4030,2910029,1306,30,62,498,1276,1306,1.0,0.022970903522205207,0.9770290964777948,746,0.04747320061255743,0.38131699846860645,0.5712098009188361
4031,2910030,1336,174,259,529,1162,1336,1.0,0.13023952095808383,0.8697604790419161,548,0.19386227544910178,0.39595808383233533,0.4101796407185629
4032,2930101,2040,397,266,659,1643,2040,1.0,0.1946078431372549,0.8053921568627451,1115,0.1303921568627451,0.32303921568627453,0.5465686274509803
4033,2930102,763,13,61,278,750,763,1.0,0.01703800786369594,0.9829619921363041,424,0.0799475753604194,0.36435124508519,0.5557011795543906
4034,2930103,753,23,77,331,730,753,1.0,0.03054448871181939,0.9694555112881806,345,0.10225763612217796,0.4395750332005312,0.4581673306772908
4035,2930104,829,12,60,340,817,829,1.0,0.014475271411338963,0.985524728588661,429,0.07237635705669482,0.4101326899879373,0.517490952955368
4036,2930201,863,212,130,198,651,863,1.0,0.24565469293163383,0.7543453070683661,535,0.15063731170336037,0.22943221320973348,0.6199304750869061
4037,2930202,969,345,335,58,624,969,1.0,0.3560371517027864,0.6439628482972136,576,0.3457172342621259,0.05985552115583075,0.5944272445820433
4038,2930203,220,46,87,33,174,220,1.0,0.20909090909090908,0.7909090909090909,100,0.39545454545454545,0.15,0.45454545454545453
4039,2930204,606,80,69,222,526,606,1.0,0.132013201320132,0.8679867986798679,315,0.11386138613861387,0.36633663366336633,0.5198019801980198
4040,2930205,583,107,105,186,476,583,1.0,0.1835334476843911,0.8164665523156089,292,0.18010291595197256,0.3190394511149228,0.5008576329331046
4041,2930206,357,34,40,167,323,357,1.0,0.09523809523809523,0.9047619047619048,150,0.11204481792717087,0.4677871148459384,0.42016806722689076
4042,2930301,1933,428,235,567,1505,1933,1.0,0.2214174857734092,0.7785825142265907,1131,0.12157268494568028,0.2933264355923435,0.5851008794619762
4043,2930302,1036,255,93,243,781,1036,1.0,0.24613899613899615,0.7538610038610039,700,0.08976833976833977,0.23455598455598456,0.6756756756756757
4044,2930303,265,29,18,90,236,265,1.0,0.10943396226415095,0.8905660377358491,157,0.06792452830188679,0.33962264150943394,0.5924528301886792
4045,2930304,878,250,77,368,628,878,1.0,0.2847380410022779,0.715261958997722,433,0.08769931662870159,0.4191343963553531,0.49316628701594534
4046,2930305,450,85,39,151,365,450,1.0,0.18888888888888888,0.8111111111111111,260,0.08666666666666667,0.33555555555555555,0.5777777777777777
4047,2930401,2266,601,374,520,1665,2266,1.0,0.26522506619594,0.73477493380406,1372,0.1650485436893204,0.2294792586054722,0.6054721977052074
4048,2930402,461,10,35,230,451,461,1.0,0.021691973969631236,0.9783080260303688,196,0.07592190889370933,0.49891540130151846,0.42516268980477223
4049,2930403,359,43,37,172,316,359,1.0,0.11977715877437325,0.8802228412256268,150,0.10306406685236769,0.479108635097493,0.4178272980501393
4050,2930404,382,29,33,208,353,382,1.0,0.07591623036649214,0.9240837696335078,141,0.08638743455497382,0.5445026178010471,0.36910994764397903
4051,2930405,300,8,21,158,292,300,1.0,0.02666666666666667,0.9733333333333334,121,0.07,0.5266666666666666,0.4033333333333333
4052,2930406,178,4,16,109,174,178,1.0,0.02247191011235955,0.9775280898876404,53,0.0898876404494382,0.6123595505617978,0.29775280898876405
4053,2950106,506,2,11,158,504,506,1.0,0.003952569169960474,0.9960474308300395,337,0.021739130434782608,0.31225296442687744,0.66600790513834
4054,2950202,146,0,7,99,146,146,1.0,0.0,1.0,40,0.04794520547945205,0.678082191780822,0.273972602739726
4055,2950207A,383,1,17,207,382,383,1.0,0.0026109660574412533,0.9973890339425587,159,0.044386422976501305,0.5404699738903395,0.4151436031331593
4056,2950207B,3,0,0,1,3,3,1.0,0.0,1.0,2,0.0,0.3333333333333333,0.6666666666666666
4057,2950303,434,4,30,232,430,434,1.0,0.009216589861751152,0.9907834101382489,172,0.06912442396313365,0.5345622119815668,0.39631336405529954
4058,2950308,145,0,10,83,145,145,1.0,0.0,1.0,52,0.06896551724137931,0.5724137931034483,0.3586206896551724
4059,2950404,399,4,38,191,395,399,1.0,0.010025062656641603,0.9899749373433584,170,0.09523809523809523,0.47869674185463656,0.42606516290726815
4060,2950409,169,0,6,73,169,169,1.0,0.0,1.0,90,0.03550295857988166,0.4319526627218935,0.5325443786982249
4061,2970001,887,0,41,209,887,887,1.0,0.0,1.0,637,0.046223224351747465,0.23562570462232243,0.7181510710259301
4062,2970002,1189,4,114,419,1185,1189,1.0,0.00336417157275021,0.9966358284272497,656,0.095878889823381,0.3523969722455845,0.5517241379310345
4063,2970003,1154,10,206,219,1144,1154,1.0,0.008665511265164644,0.9913344887348353,729,0.17850953206239167,0.18977469670710573,0.6317157712305026
4064,2970004,1016,12,107,409,1004,1016,1.0,0.011811023622047244,0.9881889763779528,500,0.10531496062992125,0.40255905511811024,0.4921259842519685
4065,2970005,206,1,20,168,205,206,1.0,0.0048543689320388345,0.9951456310679612,18,0.0970873786407767,0.8155339805825242,0.08737864077669903
4066,2970006,153,0,19,121,153,153,1.0,0.0,1.0,13,0.12418300653594772,0.7908496732026143,0.08496732026143791
4067,2970007,47,0,7,22,47,47,1.0,0.0,1.0,18,0.14893617021276595,0.46808510638297873,0.3829787234042553
4068,2970008,108,14,10,85,94,108,1.0,0.12962962962962962,0.8703703703703703,13,0.09259259259259259,0.7870370370370371,0.12037037037037036
4069,2970009,1168,29,173,411,1139,1168,1.0,0.02482876712328767,0.9751712328767124,584,0.1481164383561644,0.3518835616438356,0.5
4070,2970010,508,81,61,204,427,508,1.0,0.1594488188976378,0.8405511811023622,243,0.12007874015748031,0.4015748031496063,0.47834645669291337
4071,2970011,985,170,9,38,815,985,1.0,0.17258883248730963,0.8274111675126904,938,0.009137055837563452,0.03857868020304569,0.9522842639593908
4072,2970012,137,3,18,69,134,137,1.0,0.021897810218978103,0.9781021897810219,50,0.13138686131386862,0.5036496350364964,0.36496350364963503
4073,2970013,523,1,31,277,522,523,1.0,0.0019120458891013384,0.9980879541108987,215,0.05927342256214149,0.5296367112810707,0.4110898661567878
4074,2970014,932,6,103,503,926,932,1.0,0.006437768240343348,0.9935622317596566,326,0.11051502145922747,0.5396995708154506,0.3497854077253219
4075,2990101,226,0,38,179,226,226,1.0,0.0,1.0,9,0.168141592920354,0.7920353982300885,0.03982300884955752
4076,2990102,666,0,52,320,666,666,1.0,0.0,1.0,294,0.07807807807807808,0.4804804804804805,0.44144144144144143
4077,2990108,1019,0,130,499,1019,1019,1.0,0.0,1.0,390,0.12757605495583907,0.4896957801766438,0.38272816486751715
4078,2990109,2587,0,306,1716,2587,2587,1.0,0.0,1.0,565,0.11828372632392734,0.6633165829145728,0.21839969076149982
4079,2990203,2141,0,246,1051,2141,2141,1.0,0.0,1.0,844,0.11489957963568426,0.4908921064922933,0.39420831387202243
4080,2990204,905,0,139,452,905,905,1.0,0.0,1.0,314,0.15359116022099448,0.4994475138121547,0.3469613259668508
4081,2990205,883,0,102,325,883,883,1.0,0.0,1.0,456,0.11551528878822197,0.36806342015855037,0.5164212910532276
4082,2990307,4607,9,385,1330,4598,4607,1.0,0.0019535489472541786,0.9980464510527458,2892,0.08356848274365096,0.2886911222053397,0.6277403950510093
4083,2990410,3999,18,424,1738,3981,3999,1.0,0.00450112528132033,0.9954988747186797,1837,0.10602650662665666,0.4346086521630408,0.4593648412103026
4084,3010001,21,0,3,16,21,21,1.0,0.0,1.0,2,0.14285714285714285,0.7619047619047619,0.09523809523809523
4085,3010002,8,0,0,8,8,8,1.6,0.0,1.0,0,0.0,1.0,0.0
4086,3010003,24,0,4,20,24,24,1.1428571428571428,0.0,1.0,0,0.16666666666666666,0.8333333333333334,0.0
4087,3010004,15,0,2,10,15,15,1.0,0.0,1.0,3,0.13333333333333333,0.6666666666666666,0.2
4088,3030001,3934,193,679,510,3741,3934,1.0,0.04905948144382308,0.9509405185561769,2745,0.17259786476868327,0.12963904422979156,0.6977630910015251
4089,3030003,4266,440,698,316,3826,4266,1.0,0.10314111579934365,0.8968588842006564,3252,0.1636193155180497,0.07407407407407407,0.7623066104078763
4090,3030004,1272,118,345,93,1154,1272,1.0,0.09276729559748427,0.9072327044025157,834,0.27122641509433965,0.07311320754716981,0.6556603773584906
4091,3030005,561,26,210,95,535,561,1.0,0.04634581105169341,0.9536541889483066,256,0.37433155080213903,0.16934046345811052,0.4563279857397504
4092,3030007,2029,24,298,1124,2005,2029,1.0,0.011828486939379004,0.988171513060621,607,0.14687037949728932,0.5539674716609168,0.299162148841794
4093,3030008,4226,380,272,529,3846,4226,1.0,0.08991954566966398,0.910080454330336,3425,0.06436346426881212,0.1251774727875059,0.810459062943682
4094,3030009,2713,61,359,906,2652,2713,1.0,0.02248433468485072,0.9775156653151493,1448,0.13232583855510505,0.3339476594176189,0.5337265020272761
4095,3030010,1966,169,200,186,1797,1966,1.0,0.08596134282807731,0.9140386571719227,1580,0.1017293997965412,0.09460834181078331,0.8036622583926755
4096,3030012,1972,15,264,986,1957,1972,1.0,0.007606490872210953,0.992393509127789,722,0.13387423935091278,0.5,0.3661257606490872
4097,3030013,2780,122,349,788,2658,2780,1.0,0.04388489208633094,0.956115107913669,1643,0.12553956834532373,0.28345323741007195,0.5910071942446044
4098,3030014,1787,67,246,376,1720,1787,1.0,0.03749300503637381,0.9625069949636262,1165,0.13766088416340236,0.21040850587576945,0.6519306099608282
4099,3030015,2531,18,431,576,2513,2531,1.0,0.007111813512445673,0.9928881864875543,1524,0.17028842354800475,0.22757803239826155,0.6021335440537336
4100,3030016,1933,31,240,355,1902,1933,1.0,0.01603724780134506,0.9839627521986549,1338,0.12415933781686497,0.18365235385411277,0.6921883083290222
4101,3030017,1937,165,228,145,1772,1937,1.0,0.08518327310273618,0.9148167268972638,1564,0.11770779556014456,0.0748580278781621,0.8074341765616934
4102,3030018,1987,44,297,338,1943,1987,1.0,0.02214393558127831,0.9778560644187216,1352,0.14947156517362858,0.17010568696527428,0.6804227478610971
4103,3030019,3939,266,580,260,3673,3939,1.0,0.06752982990606753,0.9324701700939325,3099,0.14724549378014726,0.066006600660066,0.7867479055597868
4104,3030020,1697,1236,649,24,461,1697,1.0,0.7283441367118444,0.27165586328815555,1024,0.38243959929286975,0.014142604596346494,0.6034177961107837
4105,3030021,3509,169,382,625,3340,3509,1.0,0.0481618694784839,0.9518381305215161,2502,0.10886292390994586,0.17811342262752922,0.7130236534625249
4106,3030022,2797,202,330,800,2595,2797,1.0,0.07222023596710761,0.9277797640328924,1667,0.11798355380765105,0.2860207365033965,0.5959957096889524
4107,3030023,1739,24,267,583,1715,1739,1.0,0.013801035077630822,0.9861989649223691,889,0.1535365152386429,0.33525014376078205,0.511213341000575
4108,3030024,3384,97,384,519,3287,3384,1.0,0.028664302600472813,0.9713356973995272,2481,0.11347517730496454,0.15336879432624115,0.7331560283687943
4109,3030025,3269,205,444,332,3064,3269,1.0,0.06271030896298563,0.9372896910370144,2493,0.13582135209544202,0.10156011012542061,0.7626185377791374
4110,3030026,3967,338,628,384,3629,3967,1.0,0.0852029241240232,0.9147970758759768,2955,0.1583060247038064,0.09679858835391984,0.7448953869422738
4111,3030027,5316,500,591,1028,4816,5316,1.0,0.09405568096313018,0.9059443190368698,3697,0.11117381489841986,0.19337848006019565,0.6954477050413845
4112,3030028,3073,83,449,1088,2990,3073,1.0,0.027009437032216074,0.972990562967784,1536,0.1461112918971689,0.35405141555483244,0.4998372925479987
4113,3030029,3048,510,458,517,2538,3048,1.0,0.1673228346456693,0.8326771653543307,2073,0.15026246719160105,0.1696194225721785,0.6801181102362205
4114,3030030,3617,219,443,1171,3398,3617,1.0,0.060547414984794025,0.939452585015206,2003,0.12247719104230025,0.32374896322919544,0.5537738457285043
4115,3030033,4426,96,275,1370,4330,4426,1.0,0.021690013556258474,0.9783099864437416,2781,0.062132851333032084,0.30953456845910526,0.6283325802078626
4116,3030035,609,4,78,318,605,609,1.0,0.006568144499178982,0.993431855500821,213,0.12807881773399016,0.5221674876847291,0.3497536945812808
4117,3030036,2533,162,361,877,2371,2533,1.0,0.06395578365574418,0.9360442163442558,1295,0.14251875246742993,0.34622976707461506,0.511251480457955
4118,3030038,2112,97,360,342,2015,2112,1.0,0.045928030303030304,0.9540719696969697,1410,0.17045454545454544,0.16193181818181818,0.6676136363636364
4119,3030039,1865,3,196,1000,1862,1865,1.0,0.0016085790884718498,0.9983914209115281,669,0.10509383378016086,0.5361930294906166,0.3587131367292225
4120,3030040,1290,605,450,36,685,1290,1.0,0.4689922480620155,0.5310077519379846,804,0.3488372093023256,0.027906976744186046,0.6232558139534884
4121,3030041,2403,9,319,1042,2394,2403,1.0,0.003745318352059925,0.9962546816479401,1042,0.13275072825634623,0.43362463587182687,0.43362463587182687
4122,3030043,968,84,35,242,884,968,1.0,0.08677685950413223,0.9132231404958677,691,0.03615702479338843,0.25,0.7138429752066116
4123,3030044,1532,76,147,519,1456,1532,1.0,0.04960835509138381,0.9503916449086162,866,0.09595300261096605,0.3387728459530026,0.5652741514360313
4124,3030045,455,5,57,200,450,455,1.0,0.01098901098901099,0.989010989010989,198,0.12527472527472527,0.43956043956043955,0.4351648351648352
4125,3030046,2867,17,230,1379,2850,2867,1.0,0.005929543076386466,0.9940704569236135,1258,0.08022322985699337,0.4809905824904081,0.4387861876525985
4126,3030047,3571,295,411,1052,3276,3571,1.0,0.08260991318958275,0.9173900868104172,2108,0.11509381125735088,0.2945953514421731,0.5903108373004761
4127,3030049,3161,164,205,236,2997,3161,1.0,0.05188231572287251,0.9481176842771275,2720,0.06485289465359063,0.07465991774754824,0.8604871875988611
4128,3030050,3498,200,226,329,3298,3498,1.0,0.05717552887364208,0.9428244711263579,2943,0.06460834762721555,0.09405374499714123,0.8413379073756432
4129,3030051,281,15,61,111,266,281,1.0,0.05338078291814947,0.9466192170818505,109,0.21708185053380782,0.39501779359430605,0.3879003558718861
4130,3030052,3002,93,276,1027,2909,3002,1.0,0.030979347101932047,0.9690206528980679,1699,0.09193870752831446,0.34210526315789475,0.5659560293137909
4131,3030053,6144,428,485,894,5716,6144,1.0,0.06966145833333333,0.9303385416666666,4765,0.07893880208333333,0.1455078125,0.7755533854166666
4132,3030054,3298,50,388,1868,3248,3298,1.0,0.015160703456640388,0.9848392965433597,1042,0.11764705882352941,0.5664038811400849,0.3159490600363857
4133,3030056,1067,23,53,203,1044,1067,1.0,0.02155576382380506,0.9784442361761949,811,0.04967197750702906,0.190253045923149,0.7600749765698219
4134,3030058,1874,0,168,625,1874,1874,1.0,0.0,1.0,1081,0.08964781216648879,0.3335112059765208,0.5768409818569904
4135,3030059,5089,621,427,917,4468,5089,1.0,0.12202790332088818,0.8779720966791118,3745,0.08390646492434663,0.18019257221458046,0.7359009628610729
4136,3030060,1043,12,175,703,1031,1043,1.0,0.011505273250239693,0.9884947267497604,165,0.16778523489932887,0.6740172579098753,0.15819750719079578
4137,3030062,3172,210,321,1232,2962,3172,1.0,0.06620428751576292,0.9337957124842371,1619,0.10119798234552332,0.3883984867591425,0.5104035308953342
4138,3030063,261,11,23,33,250,261,1.0,0.0421455938697318,0.9578544061302682,205,0.08812260536398467,0.12643678160919541,0.7854406130268199
4139,3030065,1808,113,125,271,1695,1808,1.0,0.0625,0.9375,1412,0.06913716814159292,0.14988938053097345,0.7809734513274337
4140,3030066,2598,25,284,1476,2573,2598,1.0,0.00962278675904542,0.9903772132409546,838,0.10931485758275597,0.5681293302540416,0.32255581216320245
4141,3030067,2874,139,319,881,2735,2874,1.0,0.04836464857341684,0.9516353514265832,1674,0.11099512874043145,0.30654140570633265,0.5824634655532359
4142,3030072,3730,141,481,1118,3589,3730,1.0,0.03780160857908847,0.9621983914209116,2131,0.1289544235924933,0.2997319034852547,0.571313672922252
4143,3030075,1365,0,149,695,1365,1365,1.0,0.0,1.0,521,0.10915750915750916,0.5091575091575091,0.38168498168498166
4144,3030076,2516,148,200,671,2368,2516,1.0,0.058823529411764705,0.9411764705882353,1645,0.0794912559618442,0.26669316375198726,0.6538155802861685
4145,3030078,2400,0,168,1149,2400,2400,1.0,0.0,1.0,1083,0.07,0.47875,0.45125
4147,3030102,579,0,30,246,579,579,1.0,0.0,1.0,303,0.05181347150259067,0.42487046632124353,0.5233160621761658
4148,3030104,1359,30,41,346,1329,1359,1.0,0.02207505518763797,0.977924944812362,972,0.03016924208977189,0.2545989698307579,0.7152317880794702
4149,3030109,1981,55,182,1093,1926,1981,1.0,0.027763755678950026,0.9722362443210499,706,0.09187279151943463,0.5517415446744068,0.3563856638061585
4150,3030110,2658,4,247,1489,2654,2658,1.0,0.0015048908954100827,0.9984951091045899,922,0.09292701279157262,0.5601956358164033,0.3468773513920241
4151,3030111,944,2,67,376,942,944,1.0,0.00211864406779661,0.9978813559322034,501,0.07097457627118645,0.3983050847457627,0.5307203389830508
4152,3030112,315,9,16,151,306,315,1.0,0.02857142857142857,0.9714285714285714,148,0.050793650793650794,0.4793650793650794,0.46984126984126984
4153,3030114,930,0,215,149,930,930,1.0,0.0,1.0,566,0.23118279569892472,0.16021505376344086,0.6086021505376344
4154,3030118,2218,210,286,732,2008,2218,1.0,0.09467989179440937,0.9053201082055906,1200,0.12894499549143373,0.33002705139765554,0.5410279531109107
4155,3030119,3667,166,524,917,3501,3667,1.0,0.045268611944368695,0.9547313880556313,2226,0.14289610035451322,0.2500681756203981,0.6070357240250887
4156,3030120,4309,101,265,1411,4208,4309,1.0,0.023439313065676492,0.9765606869343235,2633,0.06149918774657693,0.3274541656996983,0.6110466465537248
4157,3030121,2459,49,142,1134,2410,2459,1.0,0.019926799511996746,0.9800732004880033,1183,0.05774705164701098,0.46116307442049614,0.48108987393249286
4158,3030122,1353,31,180,596,1322,1353,1.0,0.022912047302291204,0.9770879526977088,577,0.13303769401330376,0.44050258684405025,0.42645971914264597
4159,3030123,2263,165,256,955,2098,2263,1.0,0.07291206363234644,0.9270879363676535,1052,0.11312417145382236,0.4220061864781264,0.46486964206805126
4160,3030124,1760,40,230,1065,1720,1760,1.0,0.022727272727272728,0.9772727272727273,465,0.13068181818181818,0.6051136363636364,0.26420454545454547
4161,3030125,2204,20,296,1167,2184,2204,1.0,0.009074410163339383,0.9909255898366606,741,0.13430127041742287,0.529491833030853,0.33620689655172414
4162,3030126,2079,123,267,737,1956,2079,1.0,0.05916305916305916,0.9408369408369408,1075,0.12842712842712842,0.3544973544973545,0.517075517075517
4163,3030127,2938,29,355,1392,2909,2938,1.0,0.009870660313138189,0.9901293396868618,1191,0.12083049693669162,0.47379169503063306,0.4053778080326753
4164,3030128,1695,0,184,1189,1695,1695,1.0,0.0,1.0,322,0.10855457227138643,0.7014749262536873,0.18997050147492625
4165,3030129,2984,104,315,1382,2880,2984,1.0,0.03485254691689008,0.9651474530831099,1287,0.10556300268096515,0.4631367292225201,0.4313002680965147
4166,3030135,102,0,1,86,102,102,1.0,0.0,1.0,15,0.00980392156862745,0.8431372549019608,0.14705882352941177
4167,3030138,686,0,43,304,686,686,1.0,0.0,1.0,339,0.06268221574344024,0.44314868804664725,0.49416909620991256
4168,3030140,2990,0,242,1332,2990,2990,1.0,0.0,1.0,1416,0.08093645484949832,0.4454849498327759,0.4735785953177257
4169,3030141,3143,190,431,1240,2953,3143,1.0,0.060451797645561564,0.9395482023544385,1472,0.13713013044861597,0.39452752147629655,0.4683423480750875
4170,3030151,1207,10,83,490,1197,1207,1.0,0.008285004142502071,0.9917149958574979,634,0.0687655343827672,0.40596520298260147,0.5252692626346314
4171,3030152,2071,204,273,679,1867,2071,1.0,0.09850313858039594,0.9014968614196041,1119,0.13182037662964752,0.32786093674553357,0.540318686624819
4172,3030153,2314,1231,636,51,1083,2314,1.0,0.5319792566983578,0.4680207433016422,1627,0.2748487467588591,0.022039757994814176,0.7031114952463267
4173,3030154,3120,149,269,1363,2971,3120,1.0,0.04775641025641025,0.9522435897435897,1488,0.08621794871794872,0.43685897435897436,0.47692307692307695
4174,3030155,1756,0,127,993,1756,1756,1.0,0.0,1.0,636,0.07232346241457858,0.5654897494305239,0.3621867881548975
4176,3030178,341,0,17,133,341,341,1.0,0.0,1.0,191,0.04985337243401759,0.39002932551319647,0.5601173020527859
4177,3050001A,309,4,43,118,305,309,1.0,0.012944983818770227,0.9870550161812298,148,0.13915857605177995,0.3818770226537217,0.47896440129449835
4178,3050001B,52,0,3,15,52,52,1.0,0.0,1.0,34,0.057692307692307696,0.28846153846153844,0.6538461538461539
4179,3050002,521,1,49,152,520,521,1.0,0.0019193857965451055,0.9980806142034548,320,0.09404990403071017,0.29174664107485604,0.6142034548944337
4180,3050003,548,0,98,204,548,548,1.0,0.0,1.0,246,0.17883211678832117,0.3722627737226277,0.4489051094890511
4181,3050004,467,1,42,239,466,467,1.0,0.0021413276231263384,0.9978586723768736,186,0.08993576017130621,0.5117773019271948,0.39828693790149894
4182,3050005,39,0,1,12,39,39,1.0,0.0,1.0,26,0.02564102564102564,0.3076923076923077,0.6666666666666666
4183,3050006,438,3,67,177,435,438,1.0,0.00684931506849315,0.9931506849315068,194,0.15296803652968036,0.4041095890410959,0.4429223744292237
4184,3050007,49,0,0,34,49,49,1.0,0.0,1.0,15,0.0,0.6938775510204082,0.30612244897959184
4185,3050008,87,0,4,20,87,87,1.0,0.0,1.0,63,0.04597701149425287,0.22988505747126436,0.7241379310344828
4186,3050009,328,0,55,218,328,328,1.0,0.0,1.0,55,0.1676829268292683,0.6646341463414634,0.1676829268292683
4187,3050010,36,0,0,2,36,36,1.0,0.0,1.0,34,0.0,0.05555555555555555,0.9444444444444444
4188,3050011,100,0,7,44,100,100,1.0,0.0,1.0,49,0.07,0.44,0.49
4189,3050012,311,9,37,61,302,311,1.0,0.028938906752411574,0.9710610932475884,213,0.1189710610932476,0.19614147909967847,0.684887459807074
4190,3050013,183,0,8,79,183,183,1.0,0.0,1.0,96,0.04371584699453552,0.43169398907103823,0.5245901639344263
4191,3050014,598,31,92,64,567,598,1.0,0.051839464882943144,0.9481605351170569,442,0.15384615384615385,0.10702341137123746,0.7391304347826086
4192,3070101,1258,8,109,703,1250,1258,1.0,0.006359300476947536,0.9936406995230525,446,0.08664546899841018,0.5588235294117647,0.35453100158982515
4193,3070102,195,0,19,89,195,195,1.0,0.0,1.0,87,0.09743589743589744,0.4564102564102564,0.4461538461538462
4194,3070202,141,0,14,98,141,141,1.0,0.0,1.0,29,0.09929078014184398,0.6950354609929078,0.20567375886524822
4195,3070301,1143,28,107,541,1115,1143,1.0,0.024496937882764653,0.9755030621172354,495,0.09361329833770779,0.47331583552055995,0.4330708661417323
4196,3070302,247,0,22,147,247,247,1.0,0.0,1.0,78,0.08906882591093117,0.5951417004048583,0.3157894736842105
4197,3070401,1152,10,72,285,1142,1152,1.0,0.008680555555555556,0.9913194444444444,795,0.0625,0.24739583333333334,0.6901041666666666
4198,3070402,391,0,25,213,391,391,1.0,0.0,1.0,153,0.0639386189258312,0.5447570332480819,0.391304347826087
4199,3070403,211,0,14,86,211,211,1.0,0.0,1.0,111,0.06635071090047394,0.4075829383886256,0.5260663507109005
4200,3090001,928,166,86,51,762,928,1.0,0.1788793103448276,0.8211206896551724,791,0.09267241379310345,0.05495689655172414,0.8523706896551724
4201,3090002,514,257,106,24,257,514,1.0,0.5,0.5,384,0.20622568093385213,0.04669260700389105,0.7470817120622568
4202,3090003,8737,640,496,631,8097,8737,1.0,0.073251688222502,0.926748311777498,7610,0.05677005837243905,0.07222158635687306,0.8710083552706879
4203,3090004,80,16,20,18,64,80,1.0,0.2,0.8,42,0.25,0.225,0.525
4204,3090005,1436,272,243,76,1164,1436,1.0,0.1894150417827298,0.8105849582172702,1117,0.1692200557103064,0.052924791086350974,0.7778551532033426
4205,3090006,854,120,193,70,734,854,1.0,0.1405152224824356,0.8594847775175644,591,0.2259953161592506,0.08196721311475409,0.6920374707259953
4206,3090007,2213,748,388,222,1465,2213,1.0,0.3380027112516945,0.6619972887483054,1603,0.175327609579756,0.10031631269769543,0.7243560777225486
4207,3090008,1615,391,335,283,1224,1615,1.0,0.24210526315789474,0.7578947368421053,997,0.20743034055727555,0.17523219814241486,0.6173374613003096
4208,3090009,1273,459,240,100,814,1273,1.0,0.3605655930871956,0.6394344069128044,933,0.1885310290652003,0.07855459544383346,0.7329143754909663
4209,3090010,2245,1096,806,66,1149,2245,1.0,0.488195991091314,0.5118040089086859,1373,0.35902004454342984,0.029398663697104678,0.6115812917594655
4210,3090011,1707,9,389,995,1698,1707,1.0,0.005272407732864675,0.9947275922671354,323,0.22788517867603983,0.5828939660222613,0.18922085530169888
4211,3090012,4120,2891,1670,58,1229,4120,1.0,0.7016990291262136,0.29830097087378643,2392,0.4053398058252427,0.01407766990291262,0.5805825242718446
4212,3090013,51,11,5,3,40,51,1.0,0.21568627450980393,0.7843137254901961,43,0.09803921568627451,0.058823529411764705,0.8431372549019608
4213,3090014,2577,1470,742,47,1107,2577,1.0,0.570430733410943,0.42956926658905703,1788,0.28793170353123787,0.01823826154443151,0.6938300349243306
4214,3090015,314,8,49,112,306,314,1.0,0.025477707006369428,0.9745222929936306,153,0.15605095541401273,0.35668789808917195,0.4872611464968153
4215,3090016,755,65,70,272,690,755,1.0,0.08609271523178808,0.9139072847682119,413,0.09271523178807947,0.36026490066225164,0.5470198675496689
4216,3090017,1263,369,241,245,894,1263,1.0,0.2921615201900237,0.7078384798099763,777,0.19081551860649248,0.19398258115597783,0.6152019002375297
4217,3090018,1641,131,116,162,1510,1641,1.0,0.07982937233394272,0.9201706276660573,1363,0.07068860450944546,0.09872029250457039,0.8305911029859842
4218,3090019,3602,118,480,1337,3484,3602,1.0,0.032759578012215435,0.9672404219877846,1785,0.13325930038867295,0.3711826762909495,0.49555802332037757
4219,3090020,885,179,129,38,706,885,1.0,0.20225988700564973,0.7977401129943503,718,0.14576271186440679,0.04293785310734463,0.8112994350282486
4220,3090021,1582,169,76,99,1413,1582,1.0,0.106826801517067,0.893173198482933,1407,0.04804045512010114,0.06257901390644753,0.8893805309734514
4221,3090022,783,408,113,69,375,783,1.0,0.5210727969348659,0.4789272030651341,601,0.14431673052362706,0.08812260536398467,0.7675606641123882
4222,3090023,2814,42,426,1809,2772,2814,1.0,0.014925373134328358,0.9850746268656716,579,0.1513859275053305,0.6428571428571429,0.20575692963752665
4223,3090024,992,135,198,260,857,992,1.0,0.13608870967741934,0.8639112903225806,534,0.19959677419354838,0.2620967741935484,0.5383064516129032
4224,3090025,2354,338,454,257,2016,2354,1.0,0.14358538657604078,0.8564146134239592,1643,0.19286321155480035,0.10917587085811385,0.6979609175870858
4225,3090026,979,119,141,84,860,979,1.0,0.12155260469867211,0.8784473953013279,754,0.14402451481103168,0.08580183861082738,0.7701736465781409
4226,3090027,1899,654,376,72,1245,1899,1.0,0.344391785150079,0.655608214849921,1451,0.1979989468141127,0.037914691943127965,0.7640863612427593
4227,3090028,1398,341,248,414,1057,1398,1.0,0.24391988555078684,0.7560801144492132,736,0.17739628040057226,0.296137339055794,0.5264663805436338
4228,3090029,1472,333,224,194,1139,1472,1.0,0.2262228260869565,0.7737771739130435,1054,0.15217391304347827,0.13179347826086957,0.7160326086956522
4229,3090030,2035,355,441,578,1680,2035,1.0,0.17444717444717445,0.8255528255528255,1016,0.2167076167076167,0.284029484029484,0.49926289926289924
4230,3090031,3260,1178,535,734,2082,3260,1.0,0.36134969325153377,0.6386503067484662,1991,0.16411042944785276,0.22515337423312884,0.6107361963190184
4231,3090032,1092,55,165,474,1037,1092,1.0,0.05036630036630037,0.9496336996336996,453,0.1510989010989011,0.4340659340659341,0.41483516483516486
4232,3090033,1761,118,318,792,1643,1761,1.0,0.06700738216922203,0.9329926178307779,651,0.18057921635434412,0.4497444633730835,0.3696763202725724
4233,3090034,1492,111,254,643,1381,1492,1.0,0.07439678284182305,0.925603217158177,595,0.17024128686327078,0.4309651474530831,0.3987935656836461
4234,3090035,1422,322,287,160,1100,1422,1.0,0.22644163150492264,0.7735583684950773,975,0.20182841068917018,0.11251758087201125,0.6856540084388185
4235,3090036,1043,29,185,485,1014,1043,1.0,0.027804410354745925,0.9721955896452541,373,0.17737296260786195,0.4650047938638543,0.3576222435282838
4236,3090037,1317,163,274,248,1154,1317,1.0,0.12376613515565679,0.8762338648443432,795,0.20804859529233105,0.18830675778283978,0.6036446469248291
4237,3090038,870,225,195,135,645,870,1.0,0.25862068965517243,0.7413793103448276,540,0.22413793103448276,0.15517241379310345,0.6206896551724138
4238,3090039,1389,621,284,78,768,1389,1.0,0.4470842332613391,0.5529157667386609,1027,0.2044636429085673,0.056155507559395246,0.7393808495320374
4239,3090040,2500,315,456,789,2185,2500,1.0,0.126,0.874,1255,0.1824,0.3156,0.502
4240,3090041,1999,306,347,543,1693,1999,1.0,0.15307653826913456,0.8469234617308654,1109,0.17358679339669836,0.27163581790895447,0.5547773886943472
4241,3090042,1561,222,328,185,1339,1561,1.0,0.14221652786675207,0.8577834721332479,1048,0.21012171684817424,0.1185137732222934,0.6713645099295323
4242,3090043,1151,228,103,141,923,1151,1.0,0.19808861859252824,0.8019113814074718,907,0.0894874022589053,0.12250217202432667,0.788010425716768
4243,3090044,4594,529,426,1605,4065,4594,1.0,0.1151501959077057,0.8848498040922943,2563,0.09272964736612974,0.3493687418371789,0.5579016107966913
4244,3090045,869,83,122,134,786,869,1.0,0.09551208285385501,0.904487917146145,613,0.14039125431530494,0.15420023014959724,0.7054085155350979
4245,3090046,517,115,70,41,402,517,1.0,0.22243713733075435,0.7775628626692457,406,0.13539651837524178,0.07930367504835589,0.7852998065764023
4246,3090047,484,107,109,111,377,484,1.0,0.22107438016528927,0.7789256198347108,264,0.22520661157024793,0.22933884297520662,0.5454545454545454
4247,3090048,849,238,134,57,611,849,1.0,0.28032979976442873,0.7196702002355713,658,0.15783274440518258,0.06713780918727916,0.7750294464075382
4248,3090049,700,315,98,136,385,700,1.0,0.45,0.55,466,0.14,0.19428571428571428,0.6657142857142857
4249,3090050,2620,752,389,302,1868,2620,1.0,0.2870229007633588,0.7129770992366412,1929,0.1484732824427481,0.11526717557251909,0.7362595419847329
4250,3090051,5294,585,746,1777,4709,5294,1.0,0.11050245561012467,0.8894975443898754,2771,0.1409142425387231,0.3356630147336607,0.5234227427276161
4251,3090052,901,6,182,477,895,901,1.0,0.006659267480577136,0.9933407325194229,242,0.20199778024417314,0.5294117647058824,0.2685904550499445
4252,3090054,842,80,94,243,762,842,1.0,0.09501187648456057,0.9049881235154394,505,0.11163895486935867,0.28859857482185275,0.5997624703087886
4253,3090055,1092,3,117,493,1089,1092,1.0,0.0027472527472527475,0.9972527472527473,482,0.10714285714285714,0.45146520146520147,0.4413919413919414
4254,3090056,1278,182,292,153,1096,1278,1.0,0.14241001564945227,0.8575899843505478,833,0.22848200312989045,0.11971830985915492,0.6517996870109546
4255,3090057,1598,258,239,257,1340,1598,1.0,0.16145181476846057,0.8385481852315394,1102,0.14956195244055068,0.16082603254067585,0.6896120150187734
4256,3090058,4541,855,636,835,3686,4541,1.0,0.18828451882845187,0.8117154811715481,3070,0.14005725611098876,0.18388020259854657,0.6760625412904646
4257,3090059,3727,235,471,1625,3492,3727,1.0,0.06305339415079152,0.9369466058492085,1631,0.12637510061711832,0.436007512744835,0.43761738663804667
4258,3090060,4470,282,605,1656,4188,4470,1.0,0.06308724832214765,0.9369127516778524,2209,0.13534675615212527,0.3704697986577181,0.4941834451901566
4259,3090061,4095,468,576,1437,3627,4095,1.0,0.11428571428571428,0.8857142857142857,2082,0.14065934065934066,0.3509157509157509,0.5084249084249084
4260,3090062,5082,360,664,1859,4722,5082,1.0,0.07083825265643448,0.9291617473435655,2559,0.1306572215663125,0.3658008658008658,0.5035419126328218
4261,3090063,2989,39,373,1575,2950,2989,1.0,0.013047842087654735,0.9869521579123453,1041,0.124790899966544,0.5269320843091335,0.3482770157243225
4262,3090064,1451,22,165,422,1429,1451,1.0,0.015161957270847692,0.9848380427291523,864,0.11371467953135768,0.29083390764989664,0.5954514128187457
4263,3090065,1253,29,139,451,1224,1253,1.0,0.02314445331205108,0.9768555466879489,663,0.11093375897845172,0.3599361532322426,0.5291300877893057
4264,3090066,1279,17,151,619,1262,1279,1.0,0.013291634089132134,0.9867083659108679,509,0.11806098514464425,0.4839718530101642,0.39796716184519154
4265,3090067,3450,107,363,1248,3343,3450,1.0,0.03101449275362319,0.9689855072463768,1839,0.10521739130434783,0.3617391304347826,0.5330434782608696
4266,3090068,1250,13,153,488,1237,1250,1.0,0.0104,0.9896,609,0.1224,0.3904,0.4872
4267,3090069,1597,3,143,724,1594,1597,1.0,0.001878522229179712,0.9981214777708203,730,0.08954289292423294,0.4533500313087038,0.4571070757670632
4268,3090070,442,1,31,192,441,442,1.0,0.0022624434389140274,0.997737556561086,219,0.07013574660633484,0.4343891402714932,0.49547511312217196
4269,3090071,1098,262,124,291,836,1098,1.0,0.23861566484517305,0.761384335154827,683,0.11293260473588343,0.2650273224043716,0.6220400728597449
4270,3090072,1091,105,176,395,986,1091,1.0,0.09624197983501374,0.9037580201649863,520,0.1613198900091659,0.3620531622364803,0.4766269477543538
4271,3090073,1085,82,109,482,1003,1085,1.0,0.07557603686635944,0.9244239631336405,494,0.10046082949308756,0.44423963133640554,0.4552995391705069
4272,3090074,813,47,70,392,766,813,1.0,0.05781057810578106,0.942189421894219,351,0.08610086100861009,0.4821648216482165,0.4317343173431734
4273,3090075,3359,4,313,1562,3355,3359,1.0,0.0011908306043465317,0.9988091693956535,1484,0.0931824947901161,0.4650193509973206,0.44179815421256324
4274,3090076,2847,2,254,931,2845,2847,1.0,0.0007024938531787847,0.9992975061468212,1662,0.08921671935370566,0.3270108886547243,0.58377239199157
4275,3090077,1821,127,177,695,1694,1821,1.0,0.06974190005491489,0.9302580999450851,949,0.09719934102141681,0.3816584294343767,0.5211422295442065
4276,3090078,3785,289,517,1662,3496,3785,1.0,0.07635402906208719,0.9236459709379128,1606,0.1365918097754293,0.4391017173051519,0.42430647291941875
4277,3090079,2075,56,228,512,2019,2075,1.0,0.026987951807228915,0.9730120481927711,1335,0.10987951807228916,0.24674698795180722,0.6433734939759036
4278,3090080,2059,48,130,1196,2011,2059,1.0,0.023312287518212724,0.9766877124817873,733,0.06313744536182612,0.5808644973288004,0.3559980573093735
4279,3090081,4219,88,367,2016,4131,4219,1.0,0.020858023228253142,0.9791419767717469,1836,0.0869874377814648,0.47783835031998106,0.43517421189855415
4280,3090082,2392,9,285,1365,2383,2392,1.0,0.003762541806020067,0.9962374581939799,742,0.11914715719063546,0.5706521739130435,0.3102006688963211
4281,3090083,779,74,57,260,705,779,1.0,0.09499358151476252,0.9050064184852374,462,0.07317073170731707,0.3337612323491656,0.5930680359435173
4282,3090084,2331,150,327,954,2181,2331,1.0,0.06435006435006435,0.9356499356499357,1050,0.1402831402831403,0.4092664092664093,0.45045045045045046
4283,3090085,892,340,207,161,552,892,1.0,0.3811659192825112,0.6188340807174888,524,0.2320627802690583,0.1804932735426009,0.5874439461883408
4284,3090086,2503,914,636,343,1589,2503,1.0,0.3651618058330004,0.6348381941669996,1524,0.2540950858969237,0.13703555733120257,0.6088693567718737
4285,3090087,2847,365,374,323,2482,2847,1.0,0.1282051282051282,0.8717948717948718,2150,0.13136635054443274,0.11345275728837373,0.7551808921671935
4286,3090088,832,262,79,115,570,832,1.0,0.31490384615384615,0.6850961538461539,638,0.09495192307692307,0.13822115384615385,0.7668269230769231
4287,3090089,131,26,19,9,105,131,1.0,0.1984732824427481,0.8015267175572519,103,0.1450381679389313,0.06870229007633588,0.7862595419847328
4288,3090090,491,36,112,111,455,491,1.0,0.07331975560081466,0.9266802443991853,268,0.22810590631364563,0.22606924643584522,0.5458248472505092
4289,3090091,1975,81,267,1047,1894,1975,1.0,0.0410126582278481,0.958987341772152,661,0.1351898734177215,0.530126582278481,0.3346835443037975
4290,3110001,126,0,20,94,126,126,1.0,0.0,1.0,12,0.15873015873015872,0.746031746031746,0.09523809523809523
4291,3110003,157,0,22,135,157,157,1.0827586206896551,0.0,1.0,0,0.14012738853503184,0.8598726114649682,0.0
4292,311002A,58,0,8,50,58,58,1.9333333333333333,0.0,1.0,0,0.13793103448275862,0.8620689655172413,0.0
4293,311002B,78,0,5,52,78,78,1.0,0.0,1.0,21,0.0641025641025641,0.6666666666666666,0.2692307692307692
4294,311004A,45,0,3,42,45,45,1.5,0.0,1.0,0,0.06666666666666667,0.9333333333333333,0.0
4295,311004B,67,0,9,58,67,67,1.0806451612903225,0.0,1.0,0,0.13432835820895522,0.8656716417910447,0.0
4296,3130101,4912,1404,192,736,3508,4912,1.0,0.28583061889250816,0.7141693811074918,3984,0.03908794788273615,0.1498371335504886,0.8110749185667753
4297,3130202,1689,206,249,821,1483,1689,1.0,0.12196566015393724,0.8780343398460627,619,0.14742451154529307,0.4860864416814683,0.3664890467732386
4298,3130303,1653,258,392,519,1395,1653,1.0,0.1560798548094374,0.8439201451905626,742,0.23714458560193588,0.3139745916515426,0.44888082274652147
4299,3130404,1863,42,134,952,1821,1863,1.0,0.02254428341384863,0.9774557165861514,777,0.07192699946323135,0.511003757380569,0.4170692431561997
4300,3150001,807,90,154,197,717,807,1.0,0.11152416356877323,0.8884758364312267,456,0.19083023543990088,0.24411400247831475,0.5650557620817844
4301,3150002,1471,128,185,509,1343,1471,1.0,0.08701563562202583,0.9129843643779741,777,0.1257647858599592,0.3460231135282121,0.5282121006118287
4302,3150003,627,106,88,280,521,627,1.0,0.16905901116427433,0.8309409888357256,259,0.14035087719298245,0.44657097288676234,0.4130781499202552
4303,3150004,637,214,113,212,423,637,1.0,0.3359497645211931,0.6640502354788069,312,0.17739403453689168,0.3328100470957614,0.4897959183673469
4304,3150005,771,117,130,344,654,771,1.0,0.1517509727626459,0.8482490272373541,297,0.16861219195849547,0.4461738002594034,0.3852140077821012
4305,3150006,969,290,216,334,679,969,1.0,0.29927760577915374,0.7007223942208463,419,0.22291021671826625,0.3446852425180599,0.4324045407636739
4306,3150007,949,411,300,171,538,949,1.0,0.43308746048472074,0.5669125395152792,478,0.31612223393045313,0.18018967334035826,0.5036880927291886
4307,3150008,853,348,142,393,505,853,1.0,0.4079718640093787,0.5920281359906213,318,0.16647127784290738,0.46072684642438455,0.37280187573270807
4308,3150009,444,79,64,173,365,444,1.0,0.17792792792792791,0.8220720720720721,207,0.14414414414414414,0.38963963963963966,0.46621621621621623
4309,3150010,562,46,103,120,516,562,1.0,0.08185053380782918,0.9181494661921709,339,0.18327402135231316,0.21352313167259787,0.603202846975089
4310,3170002,773,8,73,207,765,773,1.0,0.01034928848641656,0.9896507115135834,493,0.0944372574385511,0.2677878395860285,0.6377749029754204
4311,3170004,632,6,45,246,626,632,1.0,0.00949367088607595,0.990506329113924,341,0.07120253164556962,0.38924050632911394,0.5395569620253164
4312,317003A,277,0,13,132,277,277,1.0,0.0,1.0,132,0.04693140794223827,0.47653429602888087,0.47653429602888087
4313,317004A,269,0,8,115,269,269,1.0,0.0,1.0,146,0.02973977695167286,0.4275092936802974,0.5427509293680297
4314,3190101,722,0,96,407,722,722,1.0,0.0,1.0,219,0.1329639889196676,0.5637119113573407,0.3033240997229917
4315,3190210,722,0,95,271,722,722,1.0,0.0,1.0,356,0.13157894736842105,0.37534626038781166,0.4930747922437673
4316,3190302,700,2,97,446,698,700,1.0,0.002857142857142857,0.9971428571428571,157,0.13857142857142857,0.6371428571428571,0.22428571428571428
4317,3190405,817,0,92,441,817,817,1.0,0.0,1.0,284,0.11260709914320685,0.5397796817625459,0.34761321909424725
4318,3210002,651,0,97,349,651,651,1.0,0.0,1.0,205,0.1490015360983103,0.5360983102918587,0.31490015360983103
4319,3210004,1315,0,165,600,1315,1315,1.0,0.0,1.0,550,0.12547528517110265,0.45627376425855515,0.41825095057034223
4320,3210005,1885,234,358,752,1651,1885,1.0,0.12413793103448276,0.8758620689655172,775,0.18992042440318302,0.3989389920424403,0.41114058355437666
4321,3210006,1531,309,221,515,1222,1531,1.0,0.20182887001959504,0.798171129980405,795,0.14435009797517961,0.3363814500326584,0.519268451992162
4322,3210007,201,0,10,86,201,201,1.0,0.0,1.0,105,0.04975124378109453,0.42786069651741293,0.5223880597014925
4323,3210008,1189,140,131,397,1049,1189,1.0,0.11774600504625736,0.8822539949537427,661,0.11017661900756939,0.33389402859545836,0.5559293523969723
4324,3210009,185,30,61,75,155,185,1.0,0.16216216216216217,0.8378378378378378,49,0.32972972972972975,0.40540540540540543,0.2648648648648649
4325,3210010,494,0,36,209,494,494,1.0,0.0,1.0,249,0.0728744939271255,0.4230769230769231,0.5040485829959515
4326,3210012,253,0,26,127,253,253,1.0,0.0,1.0,100,0.10276679841897234,0.5019762845849802,0.3952569169960474
4327,3210013,453,73,146,148,380,453,1.0,0.16114790286975716,0.8388520971302428,159,0.32229580573951433,0.32671081677704195,0.3509933774834437
4328,321001A,2589,76,324,1283,2513,2589,1.0,0.02935496330629587,0.9706450366937042,982,0.12514484356894554,0.49555813055233683,0.37929702587871766
4329,321001B,4117,610,552,1383,3507,4117,1.0,0.1481661403934904,0.8518338596065096,2182,0.1340782122905028,0.3359242166626184,0.5299975710468788
4330,321001C,874,500,485,140,374,874,1.0,0.5720823798627003,0.4279176201372998,249,0.5549199084668193,0.16018306636155608,0.28489702517162474
4331,321001D,2373,150,323,305,2223,2373,1.0,0.0632111251580278,0.9367888748419722,1745,0.13611462284028655,0.12852928782132322,0.7353560893383903
4332,321001E,1899,429,399,457,1470,1899,1.0,0.2259083728278041,0.7740916271721959,1043,0.21011058451816747,0.24065297525013166,0.5492364402317009
4333,321001F,1249,13,163,242,1236,1249,1.0,0.010408326661329063,0.9895916733386709,844,0.13050440352281825,0.19375500400320256,0.6757405924739792
4334,321003A,2916,203,393,595,2713,2916,1.0,0.0696159122085048,0.9303840877914952,1928,0.13477366255144033,0.20404663923182442,0.6611796982167353
4335,321003B,667,1,90,377,666,667,1.0,0.0014992503748125937,0.9985007496251874,200,0.13493253373313344,0.5652173913043478,0.29985007496251875
4336,323001A,773,4,301,48,769,773,1.0,0.00517464424320828,0.9948253557567918,424,0.38939197930142305,0.062095730918499355,0.5485122897800776
4337,323001B,2128,0,717,276,2128,2128,1.0,0.0,1.0,1135,0.3369360902255639,0.12969924812030076,0.5333646616541353
4338,323001C,5342,34,1091,224,5308,5342,1.0,0.00636465743167353,0.9936353425683264,4027,0.20423062523399477,0.04193186072631973,0.7538375140396855
4339,323002A,851,0,349,38,851,851,1.0,0.0,1.0,464,0.4101057579318449,0.04465334900117509,0.54524089306698
4340,323002BA,320,0,78,17,320,320,1.0,0.0,1.0,225,0.24375,0.053125,0.703125
4341,323002BB,483,0,171,35,483,483,1.0,0.0,1.0,277,0.35403726708074534,0.07246376811594203,0.5734989648033126
4342,323002BC,2017,0,670,141,2017,2017,1.0,0.0,1.0,1206,0.3321764997521071,0.06990580069410014,0.5979176995537928
4343,323002C,2479,0,573,87,2479,2479,1.0,0.0,1.0,1819,0.23114158935054457,0.03509479628882614,0.7337636143606293
4344,323002D,172,0,35,35,172,172,1.0,0.0,1.0,102,0.20348837209302326,0.20348837209302326,0.5930232558139535
4345,323003A,2682,7,938,300,2675,2682,1.0,0.002609992542878449,0.9973900074571216,1444,0.3497390007457122,0.11185682326621924,0.5384041759880686
4346,323003B,4672,88,1073,261,4584,4672,1.0,0.018835616438356163,0.9811643835616438,3338,0.22966609589041095,0.05586472602739726,0.7144691780821918
4347,323003C,338,0,156,138,338,338,1.0,0.0,1.0,44,0.46153846153846156,0.40828402366863903,0.1301775147928994
4348,323004A,711,0,308,76,711,711,1.0,0.0,1.0,327,0.43319268635724334,0.10689170182841069,0.459915611814346
4349,323004B,2152,0,794,297,2152,2152,1.0,0.0,1.0,1061,0.36895910780669144,0.13801115241635686,0.4930297397769517
4350,323004C,1194,0,435,93,1194,1194,1.0,0.0,1.0,666,0.36432160804020103,0.07788944723618091,0.5577889447236181
4351,323004D,2524,0,613,105,2524,2524,1.0,0.0,1.0,1806,0.24286846275752774,0.04160063391442155,0.7155309033280507
4352,325001A,1243,78,117,780,1165,1243,1.0,0.06275140788415125,0.9372485921158488,346,0.09412711182622686,0.6275140788415124,0.27835880933226065
4353,325001B,1321,0,144,800,1321,1321,1.0,0.0,1.0,377,0.10900832702498107,0.6056018168054504,0.2853898561695685
4354,325001C,2786,96,403,1105,2690,2786,1.0,0.03445800430725054,0.9655419956927495,1278,0.14465183058147882,0.39662598707824837,0.4587221823402728
4355,325001D,2946,8,403,1067,2938,2946,1.0,0.0027155465037338763,0.9972844534962662,1476,0.13679565512559402,0.3621860149355058,0.5010183299389002
4356,325002A,1222,15,136,516,1207,1222,1.0,0.012274959083469721,0.9877250409165302,570,0.11129296235679215,0.42225859247135844,0.4664484451718494
4357,325002B,3134,34,364,1325,3100,3134,1.0,0.010848755583918315,0.9891512444160817,1445,0.11614550095724314,0.4227823867262285,0.4610721123165284
4358,325002C,5312,48,467,1456,5264,5312,1.0,0.009036144578313253,0.9909638554216867,3389,0.08791415662650602,0.2740963855421687,0.6379894578313253
4359,325003A,1018,0,186,454,1018,1018,1.0,0.0,1.0,378,0.18271119842829076,0.44597249508840864,0.3713163064833006
4360,325003B,613,0,88,255,613,613,1.0,0.0,1.0,270,0.14355628058727568,0.4159869494290375,0.44045676998368677
4361,325003C,3442,2,425,790,3440,3442,1.0,0.0005810575246949448,0.999418942475305,2227,0.12347472399767577,0.2295177222545032,0.647007553747821
4362,325003D,5105,780,950,351,4325,5105,1.0,0.15279138099902057,0.8472086190009794,3804,0.1860920666013712,0.06875612144955925,0.7451518119490695
4363,325004A,1891,0,217,656,1891,1891,1.0,0.0,1.0,1018,0.11475409836065574,0.34690639873083023,0.5383395029085141
4364,325004B,4484,34,537,1176,4450,4484,1.0,0.007582515611061552,0.9924174843889384,2771,0.11975914362176628,0.2622658340767172,0.6179750223015165
4365,325004C,2071,27,347,348,2044,2071,1.0,0.013037180106228875,0.9869628198937711,1376,0.16755190729116368,0.16803476581361662,0.6644133268952197
4366,3270001,443,7,36,123,436,443,1.0,0.01580135440180587,0.9841986455981941,284,0.08126410835214447,0.27765237020316025,0.6410835214446953
4367,3270002,442,1,55,153,441,442,1.0,0.0022624434389140274,0.997737556561086,234,0.1244343891402715,0.34615384615384615,0.5294117647058824
4368,3270003,418,3,38,170,415,418,1.0,0.007177033492822967,0.992822966507177,210,0.09090909090909091,0.40669856459330145,0.5023923444976076
4369,3270004,244,0,32,115,244,244,1.0,0.0,1.0,97,0.13114754098360656,0.4713114754098361,0.3975409836065574
4370,3270005,74,0,3,45,74,74,1.0,0.0,1.0,26,0.04054054054054054,0.6081081081081081,0.35135135135135137
4371,3270006,84,0,7,59,84,84,1.0,0.0,1.0,18,0.08333333333333333,0.7023809523809523,0.21428571428571427
4372,3290101A,1099,9,38,290,1090,1099,1.0,0.00818926296633303,0.991810737033667,771,0.034576888080072796,0.26387625113739765,0.7015468607825296
4373,3290101B,46,1,1,8,45,46,1.0,0.021739130434782608,0.9782608695652174,37,0.021739130434782608,0.17391304347826086,0.8043478260869565
4374,3290102,2325,30,220,841,2295,2325,1.0,0.012903225806451613,0.9870967741935484,1264,0.09462365591397849,0.36172043010752686,0.5436559139784947
4375,3290103,3487,125,261,1347,3362,3487,1.0,0.03584743332377402,0.964152566676226,1879,0.07484944078004015,0.3862919414969888,0.5388586177229711
4376,3290104,1289,195,138,224,1094,1289,1.0,0.15128006206361522,0.8487199379363848,927,0.10705973622963538,0.17377812257564004,0.7191621411947245
4377,3290105,2436,320,210,598,2116,2436,1.0,0.13136288998357964,0.8686371100164204,1628,0.08620689655172414,0.24548440065681446,0.6683087027914614
4378,3290107,4024,225,265,1523,3799,4024,1.0,0.05591451292246521,0.9440854870775348,2236,0.0658548707753479,0.37847912524850896,0.5556660039761432
4379,3290110,3308,0,129,1637,3308,3308,1.0,0.0,1.0,1542,0.03899637243047158,0.4948609431680774,0.466142684401451
4380,3290201,2894,62,164,1101,2832,2894,1.0,0.021423635107118175,0.9785763648928818,1629,0.056668970283344854,0.38044229440221145,0.5628887353144437
4381,3290202,5131,25,217,2348,5106,5131,1.0,0.004872344572208147,0.9951276554277918,2566,0.04229195088676671,0.4576106022217891,0.5000974468914442
4382,3290203,795,22,39,317,773,795,1.0,0.027672955974842768,0.9723270440251572,439,0.04905660377358491,0.3987421383647799,0.5522012578616352
4383,3290204,2965,144,214,1684,2821,2965,1.0,0.04856661045531197,0.951433389544688,1067,0.07217537942664418,0.5679595278246206,0.35986509274873524
4384,3290205,819,20,74,629,799,819,1.0,0.02442002442002442,0.9755799755799756,116,0.09035409035409035,0.7680097680097681,0.14163614163614163
4385,3290206,1754,17,118,1157,1737,1754,1.0,0.009692132269099202,0.9903078677309008,479,0.06727480045610035,0.6596351197263398,0.27309007981755984
4386,3290207,3829,357,284,1594,3472,3829,1.0,0.09323583180987204,0.906764168190128,1951,0.0741708017759206,0.41629668320710367,0.5095325150169757
4387,3290208,1339,104,129,337,1235,1339,1.0,0.07766990291262135,0.9223300970873787,873,0.09634055265123226,0.25168035847647496,0.6519790888722927
4388,3290210,2562,58,164,801,2504,2562,1.0,0.02263856362217018,0.9773614363778298,1597,0.06401249024199844,0.3126463700234192,0.6233411397345824
4389,3290211,991,12,47,435,979,991,1.0,0.012108980827447022,0.987891019172553,509,0.04742684157416751,0.4389505549949546,0.513622603430878
4390,3290212,2327,177,213,729,2150,2327,1.0,0.07606360120326601,0.923936398796734,1385,0.09153416415986249,0.31327889987107865,0.5951869359690589
4391,3290302,4109,0,289,1045,4109,4109,1.0,0.0,1.0,2775,0.07033341445607204,0.2543197858359698,0.6753467997079582
4392,3290303,470,0,40,77,470,470,1.0,0.0,1.0,353,0.0851063829787234,0.16382978723404254,0.7510638297872341
4393,3290304,2825,220,281,166,2605,2825,1.0,0.07787610619469026,0.9221238938053097,2378,0.09946902654867257,0.05876106194690266,0.8417699115044248
4394,3290305,2322,531,339,65,1791,2322,1.0,0.22868217054263565,0.7713178294573644,1918,0.14599483204134367,0.027993109388458226,0.8260120585701981
4395,3290306,2641,342,599,264,2299,2641,1.0,0.12949640287769784,0.8705035971223022,1778,0.2268080272624006,0.09996213555471413,0.6732298371828853
4396,3290307,1686,104,132,522,1582,1686,1.0,0.06168446026097272,0.9383155397390273,1032,0.07829181494661921,0.3096085409252669,0.6120996441281139
4397,3290308,7270,1781,1120,484,5489,7270,1.0,0.2449793672627235,0.7550206327372765,5666,0.15405777166437415,0.06657496561210453,0.7793672627235213
4398,3290309,816,61,46,95,755,816,1.0,0.07475490196078431,0.9252450980392157,675,0.056372549019607844,0.11642156862745098,0.8272058823529411
4399,3290310,501,23,53,91,478,501,1.0,0.04590818363273453,0.9540918163672655,357,0.10578842315369262,0.18163672654690619,0.7125748502994012
4400,3290402,363,5,26,198,358,363,1.0,0.013774104683195593,0.9862258953168044,139,0.07162534435261708,0.5454545454545454,0.38292011019283745
4401,3290403,3419,100,245,1990,3319,3419,1.0,0.029248318221702253,0.9707516817782977,1184,0.07165837964317051,0.5820415326118749,0.3463000877449547
4402,3290404,2852,99,239,1586,2753,2852,1.0,0.0347124824684432,0.9652875175315568,1027,0.08380084151472651,0.5561009817671809,0.3600981767180926
4403,3290405,3939,469,237,1499,3470,3939,1.0,0.11906575272911907,0.880934247270881,2203,0.060167555217060166,0.38055343995938057,0.5592790048235593
4404,3290406,1962,20,138,781,1942,1962,1.0,0.010193679918450561,0.9898063200815495,1043,0.07033639143730887,0.3980632008154944,0.5316004077471967
4405,3290407,4896,275,340,1496,4621,4896,1.0,0.05616830065359477,0.9438316993464052,3060,0.06944444444444445,0.3055555555555556,0.625
4406,3290408,2462,16,125,1076,2446,2462,1.0,0.006498781478472786,0.9935012185215272,1261,0.05077173030056864,0.4370430544272949,0.5121852152721365
4407,3290409,2902,49,150,1105,2853,2902,1.0,0.016884906960716747,0.9831150930392832,1647,0.051688490696071676,0.38077188146106133,0.5675396278428669
4408,3290410,712,1,24,299,711,712,1.0,0.0014044943820224719,0.9985955056179775,389,0.033707865168539325,0.4199438202247191,0.5463483146067416
4409,3290411,3997,4,186,2316,3993,3997,1.0,0.0010007505629221916,0.9989992494370779,1495,0.04653490117588191,0.5794345759319489,0.37403052289216915
4410,329108A,867,8,31,194,859,867,1.0,0.00922722029988466,0.9907727797001153,642,0.03575547866205306,0.223760092272203,0.740484429065744
4411,329307A,423,21,37,104,402,423,1.0,0.04964539007092199,0.950354609929078,282,0.08747044917257683,0.2458628841607565,0.6666666666666666
4412,329309A,205,5,6,15,200,205,1.0,0.024390243902439025,0.975609756097561,184,0.02926829268292683,0.07317073170731707,0.8975609756097561
4413,329402A,793,10,81,487,783,793,1.0,0.012610340479192938,0.987389659520807,225,0.1021437578814628,0.6141235813366961,0.2837326607818411
4414,3310101,2781,349,378,1010,2432,2781,1.0,0.12549442646530026,0.8745055735346997,1393,0.13592233009708737,0.3631787126932758,0.5008989572096368
4415,3310105,1454,19,153,459,1435,1454,1.0,0.013067400275103164,0.9869325997248969,842,0.10522696011004126,0.3156808803301238,0.579092159559835
4416,3310203,394,0,49,176,394,394,1.0,0.0,1.0,169,0.12436548223350254,0.4467005076142132,0.4289340101522843
4417,3310207,610,74,121,144,536,610,1.0,0.12131147540983607,0.8786885245901639,345,0.19836065573770492,0.2360655737704918,0.5655737704918032
4418,3310210,440,34,83,231,406,440,1.0,0.07727272727272727,0.9227272727272727,126,0.18863636363636363,0.525,0.2863636363636364
4419,3310212,2352,366,505,567,1986,2352,1.0,0.1556122448979592,0.8443877551020408,1280,0.2147108843537415,0.24107142857142858,0.54421768707483
4420,3310316,731,57,92,301,674,731,1.0,0.07797537619699042,0.9220246238030095,338,0.12585499316005472,0.4117647058823529,0.46238030095759236
4421,3310317,1097,80,132,474,1017,1097,1.0,0.07292616226071102,0.927073837739289,491,0.1203281677301732,0.43208751139471285,0.44758432087511396
4422,3310318,3098,201,412,829,2897,3098,1.0,0.06488056810845706,0.9351194318915429,1857,0.1329890251775339,0.26759199483537766,0.5994189799870885
4423,3310419,2575,217,389,581,2358,2575,1.0,0.08427184466019418,0.9157281553398058,1605,0.15106796116504853,0.22563106796116505,0.6233009708737864
4424,3310420,2284,119,322,709,2165,2284,1.0,0.0521015761821366,0.9478984238178634,1253,0.14098073555166374,0.3104203152364273,0.5485989492119089
4425,3330001,1015,0,82,505,1015,1015,1.0,0.0,1.0,428,0.08078817733990148,0.4975369458128079,0.42167487684729066
4426,3330002,621,0,44,253,621,621,1.0,0.0,1.0,324,0.07085346215780998,0.4074074074074074,0.5217391304347826
4427,3330006,234,1,20,152,233,234,1.0,0.004273504273504274,0.9957264957264957,62,0.08547008547008547,0.6495726495726496,0.26495726495726496
4428,3330008,551,2,38,318,549,551,1.0,0.003629764065335753,0.9963702359346642,195,0.06896551724137931,0.5771324863883848,0.35390199637023595
4429,3330009,731,0,63,374,731,731,1.0,0.0,1.0,294,0.08618331053351573,0.5116279069767442,0.4021887824897401
4430,3330011,162,0,12,102,162,162,1.0,0.0,1.0,48,0.07407407407407407,0.6296296296296297,0.2962962962962963
4431,3350001,1247,20,116,467,1227,1247,1.0,0.01603849238171612,0.9839615076182838,664,0.09302325581395349,0.3744987971130714,0.5324779470729751
4432,3350002,174,2,19,154,172,174,1.035928143712575,0.011494252873563218,0.9885057471264368,1,0.10919540229885058,0.8850574712643678,0.005747126436781609
4433,3350003,1183,19,151,415,1164,1183,1.0,0.016060862214708368,0.9839391377852916,617,0.12764158918005072,0.3508030431107354,0.5215553677092138
4434,3350004,594,3,89,270,591,594,1.0,0.005050505050505051,0.9949494949494949,235,0.14983164983164984,0.45454545454545453,0.3956228956228956
4435,3350025,2791,803,102,223,1988,2791,1.0,0.28771049802938015,0.7122895019706198,2466,0.03654604084557506,0.07989967753493371,0.8835542816194912
4436,3350046,571,8,61,227,563,571,1.0,0.014010507880910683,0.9859894921190894,283,0.10683012259194395,0.3975481611208406,0.4956217162872154
4437,3370002,2342,0,180,1189,2342,2342,1.0,0.0,1.0,973,0.07685738684884715,0.5076857386848848,0.41545687446626817
4438,3370003,1306,4,100,636,1302,1306,1.0,0.0030627871362940277,0.996937212863706,570,0.07656967840735068,0.4869831546707504,0.43644716692189894
4439,3370004,912,0,42,284,912,912,1.0,0.0,1.0,586,0.046052631578947366,0.31140350877192985,0.6425438596491229
4440,3370005,983,1,63,477,982,983,1.0,0.001017293997965412,0.9989827060020345,443,0.06408952187182096,0.4852492370295015,0.4506612410986775
4441,3370006,1169,21,66,512,1148,1169,1.0,0.017964071856287425,0.9820359281437125,591,0.05645851154833191,0.43798118049615054,0.5055603079555175
4442,3370007,1114,2,93,522,1112,1114,1.0,0.0017953321364452424,0.9982046678635548,499,0.08348294434470377,0.46858168761220825,0.447935368043088
4443,3370008,623,3,59,355,620,623,1.0,0.004815409309791332,0.9951845906902087,209,0.09470304975922954,0.5698234349919743,0.33547351524879615
4444,3370009,1223,3,132,534,1220,1223,1.0,0.0024529844644317253,0.9975470155355682,557,0.10793131643499591,0.4366312346688471,0.455437448896157
4445,3370010,1147,4,101,465,1143,1147,1.0,0.0034873583260680036,0.9965126416739319,581,0.08805579773321709,0.40540540540540543,0.5065387968613775
4446,3370011,1341,3,112,510,1338,1341,1.0,0.0022371364653243847,0.9977628635346756,719,0.08351976137211037,0.38031319910514544,0.5361670395227442
4447,3370012,179,0,14,63,179,179,1.0,0.0,1.0,102,0.0782122905027933,0.35195530726256985,0.5698324022346368
4448,3370013,1071,4,74,537,1067,1071,1.0,0.003734827264239029,0.996265172735761,460,0.06909430438842204,0.5014005602240896,0.4295051353874883
4449,3370014,268,0,15,104,268,268,1.0,0.0,1.0,149,0.055970149253731345,0.3880597014925373,0.5559701492537313
4450,3370015,470,7,42,230,463,470,1.0,0.014893617021276596,0.9851063829787234,198,0.08936170212765958,0.48936170212765956,0.42127659574468085
4451,3370016,258,0,23,131,258,258,1.0,0.0,1.0,104,0.08914728682170543,0.5077519379844961,0.40310077519379844
4452,3390001,2915,380,313,536,2535,2915,1.0,0.13036020583190394,0.869639794168096,2066,0.10737564322469983,0.18387650085763294,0.7087478559176672
4453,3390002,2232,122,155,677,2110,2232,1.0,0.05465949820788531,0.9453405017921147,1400,0.06944444444444445,0.3033154121863799,0.6272401433691757
4454,3390003,5167,1000,548,2085,4167,5167,1.0,0.19353590090961872,0.8064640990903813,2534,0.10605767369847106,0.40352235339655507,0.49041997290497386
4455,3390004,2306,211,351,842,2095,2306,1.0,0.09150043365134432,0.9084995663486557,1113,0.15221162185602774,0.36513443191673894,0.4826539462272333
4456,3390005,262,17,24,171,245,262,1.0,0.0648854961832061,0.9351145038167938,67,0.0916030534351145,0.6526717557251909,0.25572519083969464
4457,3390006,4574,324,363,1803,4250,4574,1.0,0.07083515522518584,0.9291648447748142,2408,0.07936160909488413,0.3941845212068212,0.5264538696982947
4458,3390007,2977,30,154,805,2947,2977,1.0,0.010077258985555929,0.9899227410144441,2018,0.0517299294591871,0.27040644944575076,0.6778636210950622
4459,3390008,3418,21,187,1276,3397,3418,1.0,0.006143943826799298,0.9938560561732007,1955,0.05471035693387946,0.37331772966647164,0.5719719133996489
4460,3390009,1978,119,183,766,1859,1978,1.0,0.06016177957532862,0.9398382204246714,1029,0.09251769464105157,0.3872598584428716,0.5202224469160769
4461,3390010,3160,815,763,369,2345,3160,1.0,0.2579113924050633,0.7420886075949367,2028,0.24145569620253166,0.11677215189873418,0.6417721518987342
4462,3390011,2194,36,170,816,2158,2194,1.0,0.016408386508659983,0.98359161349134,1208,0.07748404740200547,0.37192342752962626,0.5505925250683683
4463,3390012,2328,0,159,630,2328,2328,1.0,0.0,1.0,1539,0.06829896907216494,0.2706185567010309,0.6610824742268041
4464,3390013,6132,161,313,2566,5971,6132,1.0,0.026255707762557076,0.973744292237443,3253,0.05104370515329419,0.41846053489889107,0.5304957599478147
4465,3390014,4305,104,412,1452,4201,4305,1.0,0.02415795586527294,0.9758420441347271,2441,0.0957026713124274,0.3372822299651568,0.5670150987224158
4466,3390015,3593,87,338,2279,3506,3593,1.0,0.024213748956303925,0.9757862510436961,976,0.09407180629000834,0.6342888950737545,0.27163929863623715
4467,3390016,4623,13,252,1485,4610,4623,1.0,0.0028120268224096907,0.9971879731775903,2886,0.054510058403634,0.3212199870214147,0.6242699545749514
4468,3390017,4227,11,239,1323,4216,4227,1.0,0.0026023184291459663,0.9973976815708541,2665,0.05654128223326236,0.3129879347054649,0.6304707830612728
4469,3390019,3183,251,360,1429,2932,3183,1.0,0.07885642475651901,0.921143575243481,1394,0.11310084825636192,0.44894753377317,0.4379516179704681
4470,3390020,2919,198,363,761,2721,2919,1.0,0.06783144912641316,0.9321685508735869,1795,0.12435765673175746,0.26070572113737583,0.6149366221308668
4471,3390021,4756,527,389,1152,4229,4756,1.0,0.11080740117746005,0.88919259882254,3215,0.08179142136248949,0.24222035323801513,0.6759882253994953
4472,3390022,4628,38,410,2081,4590,4628,1.0,0.008210890233362144,0.9917891097666378,2137,0.08859118409680207,0.4496542783059637,0.4617545375972342
4473,3390023,3519,215,499,1040,3304,3519,1.0,0.06109690252912759,0.9389030974708724,1980,0.14180164819551008,0.29553850525717534,0.5626598465473146
4474,3390024,4802,425,431,1335,4377,4802,1.0,0.08850478967097043,0.9114952103290296,3036,0.0897542690545606,0.278009162848813,0.6322365680966264
4475,3390025,4811,62,221,1419,4749,4811,1.0,0.012887133652047392,0.9871128663479526,3171,0.045936395759717315,0.29494907503637496,0.6591145292039077
4476,3390026,2784,0,171,784,2784,2784,1.0,0.0,1.0,1829,0.061422413793103446,0.28160919540229884,0.6569683908045977
4477,3390027,5011,351,477,1736,4660,5011,1.0,0.07004589902215126,0.9299541009778487,2798,0.0951905807224107,0.3464378367591299,0.5583715825184594
4478,3390028,3754,60,206,1477,3694,3754,1.0,0.015982951518380393,0.9840170484816196,2071,0.05487480021310602,0.393446989877464,0.55167820990943
4479,3390031,4232,111,564,2088,4121,4232,1.0,0.02622873345935728,0.9737712665406427,1580,0.1332703213610586,0.4933837429111531,0.3733459357277883
4480,3390032,3368,612,492,1114,2756,3368,1.0,0.18171021377672208,0.8182897862232779,1762,0.14608076009501186,0.3307600950118765,0.5231591448931117
4481,3390033,3124,45,322,1316,3079,3124,1.0,0.01440460947503201,0.985595390524968,1486,0.10307298335467349,0.4212548015364917,0.47567221510883484
4482,3390034,3980,195,275,1598,3785,3980,1.0,0.048994974874371856,0.9510050251256281,2107,0.06909547738693467,0.4015075376884422,0.5293969849246232
4483,3390035,6175,707,608,2377,5468,6175,1.0,0.11449392712550607,0.8855060728744939,3190,0.09846153846153846,0.3849392712550607,0.5165991902834008
4484,3390036,3303,24,282,1167,3279,3303,1.0,0.007266121707538601,0.9927338782924614,1854,0.08537693006357856,0.3533151680290645,0.5613079019073569
4485,3390037,2874,12,256,768,2862,2874,1.0,0.0041753653444676405,0.9958246346555324,1850,0.08907446068197634,0.267223382045929,0.6437021572720947
4486,3390039,5824,137,296,2316,5687,5824,1.0,0.023523351648351648,0.9764766483516484,3212,0.050824175824175824,0.39766483516483514,0.551510989010989
4487,3390040,6335,381,347,2277,5954,6335,1.0,0.060142067876874504,0.9398579321231255,3711,0.0547750591949487,0.359431728492502,0.5857932123125493
4488,3390041,4784,4,219,1565,4780,4784,1.0,0.0008361204013377926,0.9991638795986622,3000,0.045777591973244144,0.3271321070234114,0.6270903010033445
4489,3390042,1004,9,40,315,995,1004,1.0,0.008964143426294821,0.9910358565737052,649,0.0398406374501992,0.3137450199203187,0.646414342629482
4490,3390043,4775,159,363,1997,4616,4775,1.0,0.03329842931937173,0.9667015706806282,2415,0.07602094240837697,0.4182198952879581,0.5057591623036649
4491,3390044,3891,343,292,862,3548,3891,1.0,0.08815214597789771,0.9118478540221023,2737,0.07504497558468261,0.22153687997943974,0.7034181444358777
4492,3390045,2674,139,335,1479,2535,2674,1.0,0.051982049364248314,0.9480179506357517,860,0.12528047868362005,0.5531039640987285,0.32161555721765145
4493,3390046,5077,381,497,1660,4696,5077,1.0,0.07504431751034076,0.9249556824896592,2920,0.09789245617490644,0.32696474295844,0.5751428008666535
4494,3390047,5534,619,671,1507,4915,5534,1.0,0.11185399349475966,0.8881460065052403,3356,0.12125045175280087,0.27231658836284783,0.6064329598843513
4495,3390048,2460,27,374,1393,2433,2460,1.0,0.01097560975609756,0.9890243902439024,693,0.15203252032520326,0.566260162601626,0.2817073170731707
4496,3390049,2344,5,395,1224,2339,2344,1.0,0.0021331058020477816,0.9978668941979523,725,0.16851535836177475,0.5221843003412969,0.30930034129692835
4497,3390050,3336,0,291,1901,3336,3336,1.0,0.0,1.0,1144,0.08723021582733813,0.5698441247002398,0.34292565947242204
4498,3390051,4164,630,409,787,3534,4164,1.0,0.15129682997118155,0.8487031700288185,2968,0.09822286263208453,0.18900096061479346,0.712776176753122
4499,3390052,5620,155,271,1314,5465,5620,1.0,0.027580071174377226,0.9724199288256228,4035,0.04822064056939502,0.23380782918149468,0.7179715302491103
4500,3390053,3471,179,253,1369,3292,3471,1.0,0.0515701526937482,0.9484298473062518,1849,0.07288965715932008,0.3944108326130798,0.5326995102276001
4501,3390054,2508,80,153,547,2428,2508,1.0,0.03189792663476874,0.9681020733652312,1808,0.061004784688995214,0.21810207336523127,0.7208931419457735
4502,3390055,1698,3,89,467,1695,1698,1.0,0.0017667844522968198,0.9982332155477032,1142,0.052414605418138985,0.2750294464075383,0.6725559481743227
4503,3390056,3564,117,411,1412,3447,3564,1.0,0.03282828282828283,0.9671717171717171,1741,0.11531986531986532,0.3961840628507295,0.4884960718294052
4504,3390057,3084,41,250,1241,3043,3084,1.0,0.013294422827496757,0.9867055771725033,1593,0.08106355382619974,0.4023994811932555,0.5165369649805448
4505,3390058,2164,8,368,1519,2156,2164,1.0,0.0036968576709796672,0.9963031423290203,277,0.17005545286506468,0.7019408502772643,0.128003696857671
4506,3390059,1410,0,199,1012,1410,1410,1.0,0.0,1.0,199,0.14113475177304965,0.7177304964539007,0.14113475177304965
4507,3390060,3283,210,187,427,3073,3283,1.0,0.06396588486140725,0.9360341151385928,2669,0.05696009747182455,0.1300639658848614,0.812975936643314
4508,3390061,4340,80,725,2398,4260,4340,1.0,0.018433179723502304,0.9815668202764977,1217,0.16705069124423963,0.5525345622119816,0.2804147465437788
4509,3390062,3080,9,435,1544,3071,3080,1.0,0.002922077922077922,0.9970779220779221,1101,0.14123376623376624,0.5012987012987012,0.3574675324675325
4510,3390063,5500,327,441,2846,5173,5500,1.0,0.059454545454545454,0.9405454545454546,2213,0.08018181818181819,0.5174545454545455,0.40236363636363637
4511,3390064,2899,23,183,755,2876,2899,1.0,0.00793377026560883,0.9920662297343912,1961,0.06312521559158331,0.26043463263194205,0.6764401517764747
4512,3390065,6027,137,353,2322,5890,6027,1.0,0.022731043636966982,0.977268956363033,3352,0.0585697693711631,0.3852663016426083,0.5561639289862287
4513,3390066,4873,254,237,1766,4619,4873,1.0,0.052123948286476506,0.9478760517135235,2870,0.048635337574389495,0.36240508926739173,0.5889595731582188
4514,3390067,2978,57,458,1328,2921,2978,1.0,0.019140362659503023,0.980859637340497,1192,0.15379449294828745,0.44593687038280727,0.40026863666890533
4515,3390068,4791,313,532,2140,4478,4791,1.0,0.06533082863702776,0.9346691713629722,2119,0.11104153621373408,0.4466708411605093,0.4422876226257566
4516,3390069,4109,73,683,2220,4036,4109,1.0,0.01776587977610124,0.9822341202238988,1206,0.16622049160379654,0.5402774397663666,0.29350206862983697
4517,3390070,2613,0,418,1594,2613,2613,1.0,0.0,1.0,601,0.15996938384998086,0.6100267891312667,0.23000382701875238
4518,3390071,3294,0,581,2273,3294,3294,1.0,0.0,1.0,440,0.17638129933211902,0.6900425015179114,0.13357619914996965
4519,3390072,3299,54,236,2364,3245,3299,1.0,0.016368596544407397,0.9836314034555926,699,0.07153682934222491,0.7165807820551683,0.21188238860260686
4520,3390073,1892,68,197,649,1824,1892,1.0,0.035940803382663845,0.9640591966173362,1046,0.10412262156448203,0.3430232558139535,0.5528541226215645
4521,3390074,4108,98,286,1959,4010,4108,1.0,0.02385589094449854,0.9761441090555014,1863,0.06962025316455696,0.47687439143135346,0.4535053554040896
4522,3390075,7441,409,777,2638,7032,7441,1.0,0.054965730412578954,0.9450342695874211,4026,0.10442144873000941,0.35452224163418894,0.5410563096358016
4523,3390076,4204,64,279,2133,4140,4204,1.0,0.015223596574690771,0.9847764034253093,1792,0.06636536631779258,0.5073739295908658,0.4262607040913416
4524,3390077,4535,0,373,2439,4535,4535,1.0,0.0,1.0,1723,0.08224917309812568,0.5378169790518191,0.37993384785005513
4525,3390078,4346,4,651,2587,4342,4346,1.0,0.0009203865623561896,0.9990796134376438,1108,0.14979291302346986,0.5952600092038656,0.2549470777726645
4526,3390079,2747,265,358,1042,2482,2747,1.0,0.09646887513651256,0.9035311248634874,1347,0.13032398980706225,0.379322897706589,0.4903531124863487
4527,3390080,5610,245,618,2458,5365,5610,1.0,0.04367201426024955,0.9563279857397504,2534,0.11016042780748662,0.4381461675579323,0.45169340463458113
4528,3390081,3740,0,517,1857,3740,3740,1.0,0.0,1.0,1366,0.13823529411764707,0.496524064171123,0.36524064171122994
4529,3390082,6982,334,317,1274,6648,6982,1.0,0.047837295903752505,0.9521627040962475,5391,0.04540246347751361,0.18246920653107992,0.7721283299914065
4530,3390083,1838,0,79,511,1838,1838,1.0,0.0,1.0,1248,0.04298150163220892,0.2780195865070729,0.6789989118607181
4531,3390084,6225,793,745,1410,5432,6225,1.0,0.12738955823293172,0.8726104417670683,4070,0.11967871485943775,0.22650602409638554,0.6538152610441768
4532,3390085,3474,82,259,1520,3392,3474,1.0,0.02360391479562464,0.9763960852043754,1695,0.0745538284398388,0.43753598157743234,0.48791018998272884
4533,3390086,4054,134,268,1720,3920,4054,1.0,0.03305377405032067,0.9669462259496794,2066,0.06610754810064134,0.4242723236309818,0.5096201282683769
4534,3390087,633,48,47,194,585,633,1.0,0.07582938388625593,0.9241706161137441,392,0.07424960505529225,0.30647709320695105,0.6192733017377567
4535,3390090,1977,26,71,524,1951,1977,1.0,0.013151239251390997,0.986848760748609,1382,0.035912999494183105,0.265048052604957,0.6990389479008599
4536,3390092,5320,1117,554,1455,4203,5320,1.0,0.2099624060150376,0.7900375939849624,3311,0.10413533834586466,0.27349624060150374,0.6223684210526316
4537,3390093,4706,44,282,1137,4662,4706,1.0,0.009349766255843604,0.9906502337441564,3287,0.05992350191245219,0.24160645983850404,0.6984700382490437
4538,3390094,2497,200,219,885,2297,2497,1.0,0.08009611533840609,0.9199038846615939,1393,0.08770524629555466,0.35442531037244696,0.5578694433319984
4539,3390095,4450,247,404,1208,4203,4450,1.0,0.05550561797752809,0.9444943820224719,2838,0.09078651685393259,0.27146067415730335,0.6377528089887641
4540,3410101,3191,30,269,1019,3161,3191,1.0,0.00940144155437167,0.9905985584456283,1903,0.08429959260419931,0.3193356314634911,0.5963647759323096
4541,3410201,1514,61,129,929,1453,1514,1.0,0.040290620871862616,0.9597093791281374,456,0.08520475561426684,0.6136063408190224,0.3011889035667107
4542,3410202,1852,12,109,956,1840,1852,1.0,0.0064794816414686825,0.9935205183585313,787,0.058855291576673865,0.5161987041036717,0.4249460043196544
4543,3410203,86,3,10,30,83,86,1.0,0.03488372093023256,0.9651162790697675,46,0.11627906976744186,0.3488372093023256,0.5348837209302325
4544,3410301,2461,119,231,501,2342,2461,1.0,0.048354327509142626,0.9516456724908574,1729,0.0938642828118651,0.20357578220235675,0.7025599349857782
4545,3410401,1197,1,80,488,1196,1197,1.0,0.000835421888053467,0.9991645781119465,629,0.06683375104427736,0.4076858813700919,0.5254803675856308
4546,3410402,982,215,136,45,767,982,1.0,0.2189409368635438,0.7810590631364562,801,0.1384928716904277,0.045824847250509164,0.8156822810590632
4547,3430101,866,299,337,88,567,866,1.0,0.34526558891454967,0.6547344110854504,441,0.3891454965357968,0.10161662817551963,0.5092378752886836
4548,3430102,518,216,208,66,302,518,1.0,0.416988416988417,0.583011583011583,244,0.4015444015444015,0.1274131274131274,0.47104247104247104
4549,3430103,576,139,184,218,437,576,1.0,0.24131944444444445,0.7586805555555556,174,0.3194444444444444,0.3784722222222222,0.3020833333333333
4550,3430202,1084,248,178,488,836,1084,1.0,0.22878228782287824,0.7712177121771218,418,0.16420664206642066,0.45018450184501846,0.3856088560885609
4551,3430203,1357,262,214,397,1095,1357,1.0,0.19307295504789979,0.8069270449521002,746,0.15770081061164334,0.29255711127487105,0.5497420781134856
4552,3430302,1151,218,224,441,933,1151,1.0,0.1894005212858384,0.8105994787141616,486,0.19461337966985232,0.3831450912250217,0.42224152910512597
4553,3430303,1359,144,158,545,1215,1359,1.0,0.10596026490066225,0.8940397350993378,656,0.11626195732155997,0.4010301692420898,0.48270787343635024
4554,3430401,2358,690,353,983,1668,2358,1.0,0.2926208651399491,0.7073791348600509,1022,0.14970313825275658,0.4168787107718405,0.43341815097540287
4555,3450001,233,1,9,168,232,233,1.0,0.004291845493562232,0.9957081545064378,56,0.03862660944206009,0.721030042918455,0.24034334763948498
4556,3450002,66,0,5,48,66,66,1.0,0.0,1.0,13,0.07575757575757576,0.7272727272727273,0.19696969696969696
4557,3450003,18,0,1,17,18,18,1.0588235294117647,0.0,1.0,0,0.05555555555555555,0.9444444444444444,0.0
4558,3450004,168,0,20,134,168,168,1.0,0.0,1.0,14,0.11904761904761904,0.7976190476190477,0.08333333333333333
4559,3450005,137,0,7,89,137,137,1.0,0.0,1.0,41,0.051094890510948905,0.6496350364963503,0.29927007299270075
4560,3450006,214,1,13,82,213,214,1.0,0.004672897196261682,0.9953271028037384,119,0.06074766355140187,0.38317757009345793,0.5560747663551402
4561,3470012,2218,112,227,941,2106,2218,1.0,0.05049594229035167,0.9495040577096483,1050,0.10234445446348062,0.4242560865644725,0.4733994589720469
4562,3470013,1273,153,119,606,1120,1273,1.0,0.1201885310290652,0.8798114689709348,548,0.09347996857816182,0.4760408483896308,0.4304791830322074
4563,3470014,3481,195,346,1219,3286,3481,1.0,0.0560183855214019,0.9439816144785981,1916,0.09939672507900028,0.350186727951738,0.5504165469692617
4564,3470015,2012,290,176,785,1722,2012,1.0,0.1441351888667992,0.8558648111332008,1051,0.0874751491053678,0.39015904572564614,0.5223658051689861
4565,3470016,2302,159,295,1326,2143,2302,1.0,0.06907037358818419,0.9309296264118158,681,0.12814943527367506,0.5760208514335361,0.2958297132927889
4566,3470017,851,283,62,216,568,851,1.0,0.3325499412455934,0.6674500587544065,573,0.07285546415981199,0.25381903642773207,0.6733254994124559
4567,3470021,1748,107,202,778,1641,1748,1.0,0.06121281464530892,0.9387871853546911,768,0.11556064073226545,0.4450800915331808,0.43935926773455375
4568,3470022,180,69,40,20,111,180,1.0,0.38333333333333336,0.6166666666666667,120,0.2222222222222222,0.1111111111111111,0.6666666666666666
4569,3470023,327,56,109,54,271,327,1.0,0.1712538226299694,0.8287461773700305,164,0.3333333333333333,0.1651376146788991,0.5015290519877675
4570,3470024,1472,641,387,189,831,1472,1.0,0.43546195652173914,0.5645380434782609,896,0.26290760869565216,0.12839673913043478,0.6086956521739131
4571,3470025,58,6,28,13,52,58,1.0,0.10344827586206896,0.896551724137931,17,0.4827586206896552,0.22413793103448276,0.29310344827586204
4572,3470026,4291,1250,782,910,3041,4291,1.0,0.2913073875553484,0.7086926124446516,2599,0.18224190165462595,0.21207177814029363,0.6056863202050804
4573,3470027,1617,1323,717,40,294,1617,1.0,0.8181818181818182,0.18181818181818182,860,0.44341372912801486,0.024737167594310452,0.5318491032776747
4574,3470030,1154,442,112,108,712,1154,1.0,0.3830155979202773,0.6169844020797227,934,0.09705372616984402,0.09358752166377816,0.8093587521663779
4575,3470031,1175,232,147,142,943,1175,1.0,0.1974468085106383,0.8025531914893617,886,0.1251063829787234,0.12085106382978723,0.7540425531914894
4576,3470032,6589,1712,760,735,4877,6589,1.0,0.25982698436788587,0.7401730156321141,5094,0.11534375474275307,0.11154955228410988,0.773106692973137
4577,3470033,5783,583,864,2101,5200,5783,1.0,0.10081272695832613,0.8991872730416739,2818,0.14940342382846272,0.3633062424347225,0.4872903337368148
4578,3470034,171,51,27,64,120,171,1.0,0.2982456140350877,0.7017543859649122,80,0.15789473684210525,0.3742690058479532,0.4678362573099415
4579,3470041,1097,297,180,369,800,1097,1.0,0.2707383773928897,0.7292616226071102,548,0.1640838650865998,0.33637192342752964,0.4995442114858706
4580,3470042,2017,189,234,562,1828,2017,1.0,0.09370352007932573,0.9062964799206743,1221,0.11601388200297472,0.27863163113534956,0.6053544868616758
4581,3470043,1576,300,258,535,1276,1576,1.0,0.19035532994923857,0.8096446700507615,783,0.16370558375634517,0.33946700507614214,0.49682741116751267
4582,3470044,2041,140,143,909,1901,2041,1.0,0.06859382655561,0.93140617344439,989,0.07006369426751592,0.4453699167074963,0.4845663890249878
4583,3470045,836,85,75,416,751,836,1.0,0.10167464114832536,0.8983253588516746,345,0.08971291866028708,0.49760765550239233,0.4126794258373206
4584,3470046,1055,32,120,435,1023,1055,1.0,0.03033175355450237,0.9696682464454977,500,0.11374407582938388,0.41232227488151657,0.47393364928909953
4585,3470047,1171,45,55,452,1126,1171,1.0,0.03842869342442357,0.9615713065755764,664,0.04696840307429547,0.3859948761742101,0.5670367207514945
4586,3490101,2352,402,382,654,1950,2352,1.0,0.17091836734693877,0.8290816326530612,1316,0.16241496598639457,0.2780612244897959,0.5595238095238095
4587,3490103,1931,461,231,889,1470,1931,1.0,0.23873640600725013,0.7612635939927499,811,0.1196271361988607,0.46038322112894875,0.4199896426721906
4588,3490104,839,69,82,275,770,839,1.0,0.08224076281287247,0.9177592371871275,482,0.09773539928486293,0.32777115613825986,0.5744934445768772
4589,3490105,405,8,34,133,397,405,1.0,0.019753086419753086,0.980246913580247,238,0.08395061728395062,0.32839506172839505,0.5876543209876544
4590,3490106,606,27,73,221,579,606,1.0,0.04455445544554455,0.9554455445544554,312,0.12046204620462046,0.36468646864686466,0.5148514851485149
4591,3490107,1405,44,152,373,1361,1405,1.0,0.03131672597864769,0.9686832740213523,880,0.10818505338078292,0.26548042704626335,0.6263345195729537
4592,3490108,408,15,41,205,393,408,1.0,0.03676470588235294,0.9632352941176471,162,0.10049019607843138,0.5024509803921569,0.39705882352941174
4593,3490109,425,25,47,189,400,425,1.0,0.058823529411764705,0.9411764705882353,189,0.11058823529411765,0.4447058823529412,0.4447058823529412
4594,3490200,1032,562,293,84,470,1032,1.0,0.5445736434108527,0.45542635658914726,655,0.28391472868217055,0.08139534883720931,0.6346899224806202
4595,3490201,621,490,456,15,131,621,1.0,0.789049919484702,0.2109500805152979,150,0.7342995169082126,0.024154589371980676,0.24154589371980675
4596,3490202,1122,93,220,78,1029,1122,1.0,0.08288770053475936,0.9171122994652406,824,0.19607843137254902,0.06951871657754011,0.7344028520499108
4597,3490203,2314,535,390,786,1779,2314,1.0,0.23120138288677614,0.7687986171132238,1138,0.16853932584269662,0.33967156439066554,0.49178910976663787
4598,3490204,297,65,66,119,232,297,1.0,0.21885521885521886,0.7811447811447811,112,0.2222222222222222,0.4006734006734007,0.3771043771043771
4599,3490205,1021,36,110,552,985,1021,1.0,0.03525954946131244,0.9647404505386875,359,0.10773751224289912,0.5406464250734574,0.3516160626836435
4600,3490206,864,36,50,271,828,864,1.0,0.041666666666666664,0.9583333333333334,543,0.05787037037037037,0.3136574074074074,0.6284722222222222
4601,3490300,3440,700,436,732,2740,3440,1.0,0.20348837209302326,0.7965116279069767,2272,0.12674418604651164,0.2127906976744186,0.6604651162790698
4602,3490301,417,57,53,104,360,417,1.0,0.1366906474820144,0.8633093525179856,260,0.12709832134292565,0.24940047961630696,0.6235011990407674
4603,3490303,1177,59,155,451,1118,1177,1.0,0.05012744265080714,0.9498725573491928,571,0.13169073916737467,0.38317757009345793,0.4851316907391674
4604,3490304,687,6,46,320,681,687,1.0,0.008733624454148471,0.9912663755458515,321,0.06695778748180495,0.4657933042212518,0.4672489082969432
4605,3490305,783,10,73,217,773,783,1.0,0.01277139208173691,0.9872286079182631,493,0.09323116219667944,0.2771392081736909,0.6296296296296297
4606,3490306,404,7,27,151,397,404,1.0,0.017326732673267328,0.9826732673267327,226,0.06683168316831684,0.37376237623762376,0.5594059405940595
4607,3490307,615,15,62,203,600,615,1.0,0.024390243902439025,0.975609756097561,350,0.1008130081300813,0.3300813008130081,0.5691056910569106
4608,3490308,315,2,22,188,313,315,1.0,0.006349206349206349,0.9936507936507937,105,0.06984126984126984,0.5968253968253968,0.3333333333333333
4609,3490400,1608,284,178,875,1324,1608,1.0,0.17661691542288557,0.8233830845771144,555,0.11069651741293532,0.5441542288557214,0.3451492537313433
4610,3490401,881,135,95,176,746,881,1.0,0.1532349602724177,0.8467650397275823,610,0.10783200908059024,0.19977298524404086,0.6923950056753689
4611,3490402,2368,397,239,917,1971,2368,1.0,0.16765202702702703,0.832347972972973,1212,0.10092905405405406,0.3872466216216216,0.5118243243243243
4612,3490403,1300,42,91,711,1258,1300,1.0,0.03230769230769231,0.9676923076923077,498,0.07,0.546923076923077,0.3830769230769231
4613,3490404,1292,62,150,458,1230,1292,1.0,0.047987616099071206,0.9520123839009288,684,0.11609907120743033,0.3544891640866873,0.5294117647058824
4614,3490405,825,30,76,367,795,825,1.0,0.03636363636363636,0.9636363636363636,382,0.09212121212121212,0.4448484848484848,0.463030303030303
4615,3490406,241,6,20,133,235,241,1.0,0.024896265560165973,0.975103734439834,88,0.08298755186721991,0.5518672199170125,0.3651452282157676
4616,3510001,1047,228,120,501,819,1047,1.0,0.2177650429799427,0.7822349570200573,426,0.11461318051575932,0.4785100286532951,0.4068767908309456
4617,3510002,453,104,53,154,349,453,1.0,0.22958057395143489,0.7704194260485652,246,0.11699779249448124,0.33995584988962474,0.543046357615894
4618,3510003,728,0,55,401,728,728,1.0,0.0,1.0,272,0.07554945054945054,0.5508241758241759,0.37362637362637363
4619,3510004,179,123,30,85,56,179,1.0,0.6871508379888268,0.3128491620111732,64,0.16759776536312848,0.4748603351955307,0.3575418994413408
4620,3510005,582,0,31,304,582,582,1.0,0.0,1.0,247,0.05326460481099656,0.5223367697594502,0.42439862542955326
4621,3510006,1267,432,274,250,835,1267,1.0,0.3409629044988161,0.659037095501184,743,0.21625887924230466,0.19731649565903708,0.5864246250986582
4622,3510007,296,172,51,93,124,296,1.0,0.581081081081081,0.4189189189189189,152,0.17229729729729729,0.3141891891891892,0.5135135135135135
4623,3510008A,565,74,76,131,491,565,1.0,0.13097345132743363,0.8690265486725663,358,0.13451327433628318,0.23185840707964603,0.6336283185840708
4624,3510008B,116,32,21,36,84,116,1.0,0.27586206896551724,0.7241379310344828,59,0.1810344827586207,0.3103448275862069,0.5086206896551724
4625,3510009,479,69,82,90,410,479,1.0,0.1440501043841336,0.8559498956158664,307,0.17118997912317327,0.18789144050104384,0.6409185803757829
4626,3510010,488,36,43,191,452,488,1.0,0.07377049180327869,0.9262295081967213,254,0.08811475409836066,0.39139344262295084,0.5204918032786885
4627,3510011,654,0,94,367,654,654,1.0,0.0,1.0,193,0.1437308868501529,0.5611620795107034,0.29510703363914376
4628,3510012,210,103,23,108,107,210,1.0,0.49047619047619045,0.5095238095238095,79,0.10952380952380952,0.5142857142857142,0.3761904761904762
4629,3510013,1169,0,101,404,1169,1169,1.0,0.0,1.0,664,0.08639863130881095,0.3455945252352438,0.5680068434559452
4630,3510014,224,153,153,68,71,224,1.0,0.6830357142857143,0.3169642857142857,3,0.6830357142857143,0.30357142857142855,0.013392857142857142
4631,3510015,292,52,37,254,240,292,1.0505415162454874,0.1780821917808219,0.821917808219178,1,0.1267123287671233,0.8698630136986302,0.003424657534246575
4632,3510016,585,73,37,154,512,585,1.0,0.12478632478632479,0.8752136752136752,394,0.06324786324786325,0.26324786324786326,0.6735042735042736
4633,3510017,111,77,57,16,34,111,1.0,0.6936936936936937,0.3063063063063063,38,0.5135135135135135,0.14414414414414414,0.34234234234234234
4634,3510018,302,83,25,136,219,302,1.0,0.27483443708609273,0.7251655629139073,141,0.08278145695364239,0.4503311258278146,0.46688741721854304
4635,3510019,203,109,26,143,94,203,1.0,0.5369458128078818,0.4630541871921182,34,0.12807881773399016,0.7044334975369458,0.16748768472906403
4636,3510020,178,123,128,23,55,178,1.0,0.6910112359550562,0.3089887640449438,27,0.7191011235955056,0.12921348314606743,0.15168539325842698
4637,3510021,493,0,17,112,493,493,1.0,0.0,1.0,364,0.034482758620689655,0.22718052738336714,0.7383367139959433
4638,3510022,467,114,143,91,353,467,1.0,0.24411134903640258,0.7558886509635975,233,0.30620985010706636,0.1948608137044968,0.4989293361884368
4639,3530001,1443,57,138,377,1386,1443,1.0,0.0395010395010395,0.9604989604989606,928,0.09563409563409564,0.26126126126126126,0.6431046431046431
4640,3530002,1169,51,131,537,1118,1169,1.0,0.04362703165098375,0.9563729683490163,501,0.11206159110350727,0.4593669803250642,0.42857142857142855
4641,3530003,2241,267,228,542,1974,2241,1.0,0.11914323962516733,0.8808567603748326,1471,0.10174029451137885,0.24185631414547076,0.6564033913431504
4642,3530004,1832,103,341,340,1729,1832,1.0,0.056222707423580785,0.9437772925764192,1151,0.1861353711790393,0.185589519650655,0.6282751091703057
4643,3530005,169,0,21,100,169,169,1.0,0.0,1.0,48,0.1242603550295858,0.591715976331361,0.28402366863905326
4644,3530006,1233,0,149,447,1233,1233,1.0,0.0,1.0,637,0.12084347120843471,0.36253041362530414,0.5166261151662611
4645,3530007,259,0,17,152,259,259,1.0,0.0,1.0,90,0.06563706563706563,0.5868725868725869,0.3474903474903475
4646,3530008,158,0,15,97,158,158,1.0,0.0,1.0,46,0.0949367088607595,0.6139240506329114,0.2911392405063291
4647,3530009,2049,13,176,690,2036,2049,1.0,0.00634455832113226,0.9936554416788678,1183,0.08589555880917521,0.3367496339677892,0.5773548072230357
4648,3550001,3004,215,254,272,2789,3004,1.0,0.07157123834886818,0.9284287616511319,2478,0.08455392809587217,0.09054593874833555,0.8249001331557922
4649,3550002,3407,69,587,645,3338,3407,1.0,0.020252421485177575,0.9797475785148224,2175,0.17229233930143822,0.18931611388318167,0.6383915468153801
4650,3550003,3694,154,797,1227,3540,3694,1.0,0.041689225771521385,0.9583107742284787,1670,0.215755278830536,0.33216025988088793,0.45208446128857604
4651,3550004,3140,220,754,472,2920,3140,1.0,0.07006369426751592,0.9299363057324841,1914,0.24012738853503185,0.1503184713375796,0.6095541401273885
4652,3550005,1627,55,354,578,1572,1627,1.0,0.03380454824830977,0.9661954517516902,695,0.2175783650891211,0.3552550706822373,0.4271665642286417
4653,3550006,3571,74,510,1014,3497,3571,1.0,0.02072248669840381,0.9792775133015962,2047,0.1428171380565668,0.28395407448893867,0.5732287874544946
4654,3550007,908,75,222,61,833,908,1.0,0.08259911894273128,0.9174008810572687,625,0.2444933920704846,0.0671806167400881,0.6883259911894273
4655,3550008,4430,205,732,912,4225,4430,1.0,0.046275395033860044,0.95372460496614,2786,0.16523702031602708,0.20586907449209932,0.6288939051918736
4656,3550009,2319,0,331,688,2319,2319,1.0,0.0,1.0,1300,0.14273393704182838,0.29667960327727466,0.5605864596808969
4657,3550010,1341,20,141,476,1321,1341,1.0,0.014914243102162566,0.9850857568978374,724,0.10514541387024609,0.35495898583146906,0.5398956002982849
4658,3550011,742,0,151,165,742,742,1.0,0.0,1.0,426,0.20350404312668463,0.2223719676549865,0.5741239892183289
4659,3550012,1356,13,349,181,1343,1356,1.0,0.009587020648967551,0.9904129793510325,826,0.25737463126843657,0.13348082595870206,0.6091445427728613
4660,3550013,1349,0,462,77,1349,1349,1.0,0.0,1.0,810,0.3424759080800593,0.05707931801334322,0.6004447739065975
4661,3550014,339,0,61,138,339,339,1.0,0.0,1.0,140,0.17994100294985252,0.40707964601769914,0.41297935103244837
4662,3550015,1362,47,169,200,1315,1362,1.0,0.03450807635829662,0.9654919236417033,993,0.12408223201174744,0.14684287812041116,0.7290748898678414
4663,3550016,418,14,66,96,404,418,1.0,0.03349282296650718,0.9665071770334929,256,0.15789473684210525,0.22966507177033493,0.6124401913875598
4664,3550017,4115,165,687,652,3950,4115,1.0,0.040097205346294046,0.959902794653706,2776,0.1669501822600243,0.15844471445929525,0.6746051032806805
4665,3550018,4789,480,504,717,4309,4789,1.0,0.10022969304656504,0.899770306953435,3568,0.1052411776988933,0.14971810398830654,0.7450407183128002
4666,3550019,3350,45,582,1351,3305,3350,1.0,0.013432835820895522,0.9865671641791045,1417,0.17373134328358208,0.40328358208955223,0.4229850746268657
4667,3550020,3745,240,809,381,3505,3745,1.0,0.06408544726301736,0.9359145527369827,2555,0.21602136181575435,0.10173564753004005,0.6822429906542056
4668,3550021,244,22,66,129,222,244,1.0,0.09016393442622951,0.9098360655737705,49,0.27049180327868855,0.5286885245901639,0.20081967213114754
4669,3550022,450,0,87,95,450,450,1.0,0.0,1.0,268,0.19333333333333333,0.2111111111111111,0.5955555555555555
4670,3550023,2072,49,231,946,2023,2072,1.0,0.02364864864864865,0.9763513513513513,895,0.11148648648648649,0.45656370656370654,0.43194980694980695
4671,3550024,1497,119,189,60,1378,1497,1.0,0.07949231796927188,0.9205076820307281,1248,0.12625250501002003,0.04008016032064128,0.8336673346693386
4672,3550025,864,13,50,130,851,864,1.0,0.015046296296296295,0.9849537037037037,684,0.05787037037037037,0.15046296296296297,0.7916666666666666
4673,3550026,4690,115,703,1563,4575,4690,1.0,0.024520255863539446,0.9754797441364605,2424,0.14989339019189765,0.33326226012793175,0.5168443496801706
4674,3550027,772,0,221,119,772,772,1.0,0.0,1.0,432,0.2862694300518135,0.15414507772020725,0.5595854922279793
4675,3550028,230,0,16,109,230,230,1.0,0.0,1.0,105,0.06956521739130435,0.47391304347826085,0.45652173913043476
4676,3550029,3620,160,640,1136,3460,3620,1.0,0.04419889502762431,0.9558011049723757,1844,0.17679558011049723,0.3138121546961326,0.5093922651933702
4677,3550030,457,120,114,7,337,457,1.0,0.26258205689277897,0.737417943107221,336,0.24945295404814005,0.015317286652078774,0.7352297592997812
4678,3550031,1427,20,147,43,1407,1427,1.0,0.01401541695865452,0.9859845830413455,1237,0.10301331464611072,0.030133146461107218,0.866853538892782
4679,3550032,2748,186,360,485,2562,2748,1.0,0.06768558951965066,0.9323144104803494,1903,0.13100436681222707,0.1764919941775837,0.6925036390101892
4680,3550033,1183,76,147,44,1107,1183,1.0,0.06424344885883347,0.9357565511411665,992,0.1242603550295858,0.037193575655114115,0.8385460693153001
4681,3550034,842,62,140,61,780,842,1.0,0.07363420427553444,0.9263657957244655,641,0.166270783847981,0.07244655581947744,0.7612826603325415
4682,3550035,1013,0,333,46,1013,1013,1.0,0.0,1.0,634,0.32872655478775914,0.045409674234945706,0.6258637709772952
4683,3550036,1078,0,310,143,1078,1078,1.0,0.0,1.0,625,0.287569573283859,0.1326530612244898,0.5797773654916512
4684,3550037,1547,0,482,151,1547,1547,1.0,0.0,1.0,914,0.31157078215901746,0.09760827407886231,0.5908209437621202
4685,3550038,925,288,232,16,637,925,1.0,0.31135135135135134,0.6886486486486486,677,0.2508108108108108,0.017297297297297298,0.7318918918918919
4686,3550039,1070,53,159,105,1017,1070,1.0,0.04953271028037383,0.9504672897196261,806,0.1485981308411215,0.09813084112149532,0.7532710280373832
4687,3550040,3787,89,480,1678,3698,3787,1.0,0.02350145233694217,0.9764985476630579,1629,0.12674940586216002,0.4430947979931344,0.43015579614470556
4688,3550041,324,0,151,33,324,324,1.0,0.0,1.0,140,0.4660493827160494,0.10185185185185185,0.43209876543209874
4689,3550042,375,7,83,178,368,375,1.0,0.018666666666666668,0.9813333333333333,114,0.22133333333333333,0.4746666666666667,0.304
4690,3550043,860,67,186,44,793,860,1.0,0.07790697674418605,0.922093023255814,630,0.21627906976744185,0.05116279069767442,0.7325581395348837
4691,3550044,1181,0,270,48,1181,1181,1.0,0.0,1.0,863,0.2286198137171888,0.04064352243861134,0.7307366638441999
4692,3550045,944,95,140,30,849,944,1.0,0.10063559322033898,0.899364406779661,774,0.1483050847457627,0.03177966101694915,0.8199152542372882
4693,3550046,485,0,77,17,485,485,1.0,0.0,1.0,391,0.15876288659793814,0.03505154639175258,0.8061855670103093
4694,3550047,850,90,106,18,760,850,1.0,0.10588235294117647,0.8941176470588236,726,0.12470588235294118,0.021176470588235293,0.8541176470588235
4695,3550048,1556,42,388,304,1514,1556,1.0,0.02699228791773779,0.9730077120822622,864,0.2493573264781491,0.1953727506426735,0.5552699228791774
4696,3550049,1142,0,173,414,1142,1142,1.0,0.0,1.0,555,0.15148861646234676,0.36252189141856395,0.4859894921190893
4697,3550050,785,35,131,120,750,785,1.0,0.044585987261146494,0.9554140127388535,534,0.16687898089171974,0.15286624203821655,0.6802547770700637
4698,3550051,2851,136,464,280,2715,2851,1.0,0.047702560505085936,0.9522974394949141,2107,0.16274991231146965,0.09821115398105927,0.7390389337074711
4699,3550052,749,10,300,79,739,749,1.0,0.01335113484646195,0.986648865153538,370,0.40053404539385845,0.1054739652870494,0.4939919893190921
4700,3550053,976,6,248,70,970,976,1.0,0.006147540983606557,0.9938524590163934,658,0.2540983606557377,0.07172131147540983,0.6741803278688525
4701,3550054,1418,0,510,139,1418,1418,1.0,0.0,1.0,769,0.35966149506346967,0.09802538787023977,0.5423131170662906
4702,3550055,917,0,400,114,917,917,1.0,0.0,1.0,403,0.4362050163576881,0.12431842966194111,0.4394765539803708
4703,3550056,1916,58,281,89,1858,1916,1.0,0.030271398747390398,0.9697286012526096,1546,0.14665970772442588,0.04645093945720251,0.8068893528183716
4704,3550057,987,0,214,114,987,987,1.0,0.0,1.0,659,0.21681864235055726,0.11550151975683891,0.6676798378926039
4705,3550058,1093,0,370,387,1093,1093,1.0,0.0,1.0,336,0.33851784080512354,0.35407136322049404,0.3074107959743824
4706,3550059,2018,91,394,412,1927,2018,1.0,0.04509415262636274,0.9549058473736373,1212,0.1952428146679881,0.20416253716551042,0.6005946481665014
4707,3550060,1369,34,317,50,1335,1369,1.0,0.02483564645726808,0.9751643535427319,1002,0.23155588020452886,0.036523009495982466,0.7319211102994887
4708,3550061,1118,142,291,16,976,1118,1.0,0.12701252236135957,0.8729874776386404,811,0.26028622540250446,0.014311270125223614,0.725402504472272
4709,3550062,1403,4,236,61,1399,1403,1.0,0.002851033499643621,0.9971489665003563,1106,0.16821097647897362,0.043478260869565216,0.7883107626514612
4710,3550063,2543,130,549,904,2413,2543,1.0,0.051120723554856466,0.9488792764451436,1090,0.21588674793550924,0.35548564687377116,0.42862760519071963
4711,3550064,917,21,192,461,896,917,1.0,0.022900763358778626,0.9770992366412213,264,0.2093784078516903,0.5027262813522355,0.28789531079607417
4712,3550065,5731,300,681,1208,5431,5731,1.0,0.05234688536032106,0.9476531146396789,3842,0.1188274297679288,0.21078345838422613,0.670389111847845
4713,3550066,2015,225,370,317,1790,2015,1.0,0.11166253101736973,0.8883374689826302,1328,0.18362282878411912,0.15732009925558313,0.6590570719602977
4714,3550067,5402,187,621,1069,5215,5402,1.0,0.03461680858941133,0.9653831914105887,3712,0.11495742317660126,0.1978896704924102,0.6871529063309886
4715,3550068,1765,20,290,143,1745,1765,1.0,0.0113314447592068,0.9886685552407932,1332,0.1643059490084986,0.08101983002832862,0.7546742209631728
4716,3550069,2320,35,557,312,2285,2320,1.0,0.015086206896551725,0.9849137931034483,1451,0.24008620689655172,0.13448275862068965,0.6254310344827586
4717,3550070,3829,190,672,416,3639,3829,1.0,0.04962131104727083,0.9503786889527291,2741,0.17550274223034734,0.10864455471402455,0.7158527030556281
4718,3550071,2538,10,463,109,2528,2538,1.0,0.003940110323089046,0.996059889676911,1966,0.18242710795902287,0.042947202521670606,0.7746256895193065
4719,3550072,2180,22,402,234,2158,2180,1.0,0.010091743119266056,0.9899082568807339,1544,0.18440366972477065,0.10733944954128441,0.708256880733945
4720,3550073,2130,134,438,109,1996,2130,1.0,0.06291079812206572,0.9370892018779343,1583,0.2056338028169014,0.05117370892018779,0.7431924882629108
4721,3550074,2003,0,531,106,2003,2003,1.0,0.0,1.0,1366,0.2651023464802796,0.05292061907139291,0.6819770344483275
4722,3550075,2389,0,671,136,2389,2389,1.0,0.0,1.0,1582,0.2808706571787359,0.05692758476349937,0.6622017580577647
4723,3550076,1268,44,245,36,1224,1268,1.0,0.03470031545741325,0.9652996845425867,987,0.19321766561514195,0.028391167192429023,0.7783911671924291
4724,3550077,467,53,100,16,414,467,1.0,0.11349036402569593,0.8865096359743041,351,0.21413276231263384,0.034261241970021415,0.7516059957173448
4725,3550078,1509,301,560,105,1208,1509,1.0,0.19946984758117958,0.8005301524188204,844,0.3711066931742876,0.06958250497017893,0.5593108018555335
4726,3550079,1684,190,324,93,1494,1684,1.0,0.11282660332541568,0.8871733966745843,1267,0.19239904988123516,0.05522565320665083,0.752375296912114
4727,3550080,1784,257,607,74,1527,1784,1.0,0.14405829596412556,0.8559417040358744,1103,0.34024663677130046,0.04147982062780269,0.6182735426008968
4728,3550081,4177,34,498,1698,4143,4177,1.0,0.008139813263107493,0.9918601867368925,1981,0.11922432367728035,0.406511850610486,0.47426382571223363
4729,3550082,947,29,141,54,918,947,1.0,0.030623020063357972,0.9693769799366421,752,0.14889123548046462,0.057022175290390706,0.7940865892291447
4730,3550083,1655,82,307,84,1573,1655,1.0,0.04954682779456193,0.950453172205438,1264,0.18549848942598188,0.05075528700906345,0.7637462235649547
4731,3550084,1299,25,189,144,1274,1299,1.0,0.01924557351809084,0.9807544264819091,966,0.14549653579676675,0.11085450346420324,0.74364896073903
4732,3550085,705,0,156,32,705,705,1.0,0.0,1.0,517,0.22127659574468084,0.04539007092198582,0.7333333333333333
4733,3550086,634,0,161,206,634,634,1.0,0.0,1.0,267,0.2539432176656151,0.3249211356466877,0.42113564668769715
4734,3550087,1804,0,385,274,1804,1804,1.0,0.0,1.0,1145,0.21341463414634146,0.15188470066518847,0.63470066518847
4735,3550088,2804,60,554,669,2744,2804,1.0,0.021398002853067047,0.978601997146933,1581,0.19757489300998574,0.23858773181169757,0.5638373751783167
4736,3550089,865,35,166,117,830,865,1.0,0.04046242774566474,0.9595375722543352,582,0.19190751445086704,0.1352601156069364,0.6728323699421965
4737,3550090,1155,101,226,189,1054,1155,1.0,0.08744588744588745,0.9125541125541126,740,0.19567099567099566,0.16363636363636364,0.6406926406926406
4738,3550091,4528,119,563,802,4409,4528,1.0,0.026280918727915194,0.9737190812720848,3163,0.12433745583038869,0.1771201413427562,0.6985424028268551
4739,3550092A,2148,79,411,638,2069,2148,1.0,0.03677839851024209,0.9632216014897579,1099,0.19134078212290503,0.29702048417132215,0.5116387337057728
4740,3550092B,94,3,18,28,91,94,1.0,0.031914893617021274,0.9680851063829787,48,0.19148936170212766,0.2978723404255319,0.5106382978723404
4741,3550093,3284,240,719,239,3044,3284,1.0,0.0730816077953715,0.9269183922046285,2326,0.21894031668696712,0.07277710109622412,0.7082825822168087
4742,3550094,2240,175,433,484,2065,2240,1.0,0.078125,0.921875,1323,0.19330357142857144,0.21607142857142858,0.590625
4743,3550095,1114,12,236,99,1102,1114,1.0,0.010771992818671455,0.9892280071813285,779,0.2118491921005386,0.08886894075403949,0.699281867145422
4744,3550096,1007,0,241,97,1007,1007,1.0,0.0,1.0,669,0.23932472691161866,0.09632571996027806,0.6643495531281033
4745,3550097,1146,80,358,85,1066,1146,1.0,0.06980802792321117,0.9301919720767888,703,0.31239092495637,0.07417102966841187,0.6134380453752182
4746,3550098,2420,250,674,101,2170,2420,1.0,0.10330578512396695,0.8966942148760331,1645,0.2785123966942149,0.04173553719008265,0.6797520661157025
4747,3550099,824,18,196,42,806,824,1.0,0.021844660194174758,0.9781553398058253,586,0.23786407766990292,0.050970873786407765,0.7111650485436893
4748,3550100,1474,14,254,252,1460,1474,1.0,0.009497964721845319,0.9905020352781547,968,0.1723202170963365,0.17096336499321574,0.6567164179104478
4749,3550101,3856,4,541,831,3852,3856,1.0,0.001037344398340249,0.9989626556016598,2484,0.14030082987551867,0.21550829875518673,0.6441908713692946
4750,3550102,1466,8,359,509,1458,1466,1.0,0.005457025920873124,0.9945429740791268,598,0.24488403819918145,0.3472032742155525,0.40791268758526605
4751,3550103,2481,46,262,614,2435,2481,1.0,0.018540910923014912,0.9814590890769851,1605,0.10560257960499798,0.24748085449415558,0.6469165659008465
4752,3550104,1029,0,352,48,1029,1029,1.0,0.0,1.0,629,0.34207968901846453,0.04664723032069971,0.6112730806608357
4753,3550105,1461,0,466,79,1461,1461,1.0,0.0,1.0,916,0.3189596167008898,0.054072553045859,0.6269678302532512
4754,3550106,3738,110,582,636,3628,3738,1.0,0.029427501337613696,0.9705724986623863,2520,0.15569823434991975,0.17014446227929375,0.6741573033707865
4755,3550107,3976,51,548,1767,3925,3976,1.0,0.012826961770623743,0.9871730382293763,1661,0.13782696177062373,0.4444164989939638,0.41775653923541245
4756,3550108,902,0,185,50,902,902,1.0,0.0,1.0,667,0.20509977827050999,0.05543237250554324,0.7394678492239468
4757,3550109,574,0,124,161,574,574,1.0,0.0,1.0,289,0.21602787456445993,0.2804878048780488,0.5034843205574913
4758,3550110,1873,3,233,408,1870,1873,1.0,0.001601708489054992,0.9983982915109451,1232,0.12439935931660438,0.21783235451147892,0.6577682861719167
4759,3550111,1534,79,184,274,1455,1534,1.0,0.051499348109517604,0.9485006518904824,1076,0.11994784876140809,0.17861799217731422,0.7014341590612777
4760,3550112,2547,35,577,695,2512,2547,1.0,0.013741656851197487,0.9862583431488026,1275,0.22654102866117,0.2728700431880644,0.5005889281507656
4761,3550113,580,80,180,16,500,580,1.0,0.13793103448275862,0.8620689655172413,384,0.3103448275862069,0.027586206896551724,0.6620689655172414
4762,3550114,876,60,160,48,816,876,1.0,0.0684931506849315,0.9315068493150684,668,0.182648401826484,0.0547945205479452,0.7625570776255708
4763,3550115,2640,172,397,622,2468,2640,1.0,0.06515151515151515,0.9348484848484848,1621,0.1503787878787879,0.2356060606060606,0.6140151515151515
4764,3550116,5114,351,913,968,4763,5114,1.0,0.06863511928040672,0.9313648807195932,3233,0.1785295267892061,0.1892843175596402,0.6321861556511537
4765,3550117,3398,0,413,1155,3398,3398,1.0,0.0,1.0,1830,0.12154208357857563,0.33990582695703353,0.5385520894643908
4766,3550118,3785,70,730,499,3715,3785,1.0,0.018494055482166448,0.9815059445178336,2556,0.1928665785997358,0.13183619550858652,0.6752972258916776
4767,3550119,4615,160,616,1195,4455,4615,1.0,0.03466955579631636,0.9653304442036836,2804,0.13347778981581798,0.2589382448537378,0.6075839653304442
4768,3550120,2564,70,430,539,2494,2564,1.0,0.027301092043681748,0.9726989079563183,1595,0.16770670826833073,0.21021840873634945,0.6220748829953198
4769,3550121,2126,114,386,398,2012,2126,1.0,0.053621825023518345,0.9463781749764817,1342,0.18156161806208843,0.187206020696143,0.6312323612417686
4770,3550122,3780,135,470,1088,3645,3780,1.0,0.03571428571428571,0.9642857142857143,2222,0.12433862433862433,0.2878306878306878,0.5878306878306878
4771,3550123,2426,51,353,750,2375,2426,1.0,0.021022258862324814,0.9789777411376752,1323,0.14550700741962078,0.3091508656224237,0.5453421269579555
4772,3550124,3839,32,680,817,3807,3839,1.0,0.008335504037509768,0.9916644959624902,2342,0.17712946079708258,0.21281583745767127,0.6100547017452461
4773,3550125,4868,234,694,1197,4634,4868,1.0,0.04806902218570255,0.9519309778142975,2977,0.14256368118323748,0.24589153656532456,0.6115447822514379
4774,3550126,2395,67,289,497,2328,2395,1.0,0.027974947807933193,0.9720250521920668,1609,0.12066805845511483,0.20751565762004176,0.6718162839248434
4775,3550127,1176,14,130,537,1162,1176,1.0,0.011904761904761904,0.9880952380952381,509,0.11054421768707483,0.45663265306122447,0.4328231292517007
4776,3570001,1270,4,49,376,1266,1270,1.0,0.0031496062992125984,0.9968503937007874,845,0.03858267716535433,0.29606299212598425,0.6653543307086615
4777,3570002,1277,0,91,594,1277,1277,1.0,0.0,1.0,592,0.07126076742364917,0.46515270164447925,0.4635865309318716
4778,3570003,1552,0,48,1052,1552,1552,1.0,0.0,1.0,452,0.030927835051546393,0.6778350515463918,0.2912371134020619
4779,3570004,1507,14,65,697,1493,1507,1.0,0.0092899800928998,0.9907100199071002,745,0.043132050431320505,0.46250829462508297,0.49435965494359657
4780,3590101,178,11,7,138,167,178,1.0,0.06179775280898876,0.9382022471910112,33,0.03932584269662921,0.7752808988764045,0.1853932584269663
4781,3590103,153,1,4,91,152,153,1.0,0.006535947712418301,0.9934640522875817,58,0.026143790849673203,0.5947712418300654,0.3790849673202614
4782,3590202,145,9,11,110,136,145,1.0,0.06206896551724138,0.9379310344827586,24,0.07586206896551724,0.7586206896551724,0.16551724137931034
4783,3590203,156,2,9,110,154,156,1.0,0.01282051282051282,0.9871794871794872,37,0.057692307692307696,0.7051282051282052,0.23717948717948717
4784,3590303,363,1,19,145,362,363,1.0,0.0027548209366391185,0.9972451790633609,199,0.05234159779614325,0.39944903581267216,0.5482093663911846
4785,3590403,159,1,10,89,158,159,1.0,0.006289308176100629,0.9937106918238994,60,0.06289308176100629,0.559748427672956,0.37735849056603776
4786,3590404,164,10,11,103,154,164,1.0,0.06097560975609756,0.9390243902439024,50,0.06707317073170732,0.6280487804878049,0.3048780487804878
4787,3610001,675,135,40,130,540,675,1.0,0.2,0.8,505,0.05925925925925926,0.1925925925925926,0.7481481481481481
4788,3610002,2090,939,555,209,1151,2090,1.0,0.4492822966507177,0.5507177033492823,1326,0.26555023923444976,0.1,0.6344497607655503
4789,3610003,1755,1020,604,99,735,1755,1.0,0.5811965811965812,0.4188034188034188,1052,0.34415954415954414,0.05641025641025641,0.5994301994301995
4790,3610004,697,640,265,6,57,697,1.0,0.9182209469153515,0.08177905308464849,426,0.3802008608321377,0.00860832137733142,0.6111908177905309
4791,3610005,1680,668,466,474,1012,1680,1.0,0.3976190476190476,0.6023809523809524,740,0.2773809523809524,0.28214285714285714,0.44047619047619047
4792,3610006,1892,31,216,848,1861,1892,1.0,0.01638477801268499,0.983615221987315,828,0.11416490486257928,0.44820295983086683,0.4376321353065539
4793,3610007,1852,204,278,806,1648,1852,1.0,0.1101511879049676,0.8898488120950324,768,0.15010799136069114,0.4352051835853132,0.4146868250539957
4794,3610008,2204,103,233,1156,2101,2204,1.0,0.04673321234119782,0.9532667876588021,815,0.10571687840290381,0.5245009074410163,0.36978221415607987
4795,3610009,2106,20,189,930,2086,2106,1.0,0.00949667616334283,0.9905033238366572,987,0.08974358974358974,0.4415954415954416,0.4686609686609687
4796,3610010,928,25,75,325,903,928,1.0,0.02693965517241379,0.9730603448275862,528,0.08081896551724138,0.35021551724137934,0.5689655172413793
4797,3610011,1024,219,93,194,805,1024,1.0,0.2138671875,0.7861328125,737,0.0908203125,0.189453125,0.7197265625
4798,3610012,1579,191,198,490,1388,1579,1.0,0.12096263457884737,0.8790373654211526,891,0.12539582013932868,0.3103229892336922,0.5642811906269791
4799,3610013,1729,352,316,483,1377,1729,1.0,0.20358588779641412,0.7964141122035859,930,0.1827646038172354,0.2793522267206478,0.5378831694621168
4800,3610014,2296,367,405,695,1929,2296,1.0,0.15984320557491288,0.8401567944250871,1196,0.1763937282229965,0.30270034843205573,0.5209059233449478
4801,3610015,1516,90,214,869,1426,1516,1.0,0.059366754617414245,0.9406332453825857,433,0.14116094986807387,0.5732189973614775,0.28562005277044855
4802,3610016,2442,3,154,1148,2439,2442,1.0,0.0012285012285012285,0.9987714987714987,1140,0.06306306306306306,0.4701064701064701,0.4668304668304668
4803,3610017,2067,10,140,907,2057,2067,1.0,0.004837929366231253,0.9951620706337687,1020,0.06773101112723755,0.43880019351717464,0.4934687953555878
4804,3610018,2222,7,181,962,2215,2222,1.0,0.0031503150315031502,0.9968496849684968,1079,0.08145814581458145,0.43294329432943296,0.4855985598559856
4805,3610019,2474,7,142,783,2467,2474,1.0,0.0028294260307194824,0.9971705739692805,1549,0.05739692805173808,0.3164915117219078,0.6261115602263541
4806,3610020,1978,1,105,670,1977,1978,1.0,0.0005055611729019212,0.9994944388270981,1203,0.05308392315470172,0.33872598584428715,0.6081900910010111
4807,3610021,442,0,22,149,442,442,1.0,0.0,1.0,271,0.049773755656108594,0.33710407239819007,0.6131221719457014
4808,3610022,1747,0,107,591,1747,1747,1.0,0.0,1.0,1049,0.061247853463079566,0.338294218660561,0.6004579278763594
4809,3610023,2670,0,190,1181,2670,2670,1.0,0.0,1.0,1299,0.07116104868913857,0.44232209737827716,0.48651685393258426
4810,3610024,1809,45,121,674,1764,1809,1.0,0.024875621890547265,0.9751243781094527,1014,0.06688778330569375,0.37258153676064126,0.560530679933665
4811,3610025,1835,0,161,735,1835,1835,1.0,0.0,1.0,939,0.08773841961852862,0.40054495912806537,0.511716621253406
4812,3610026,1923,0,202,1004,1923,1923,1.0,0.0,1.0,717,0.10504420176807072,0.5221008840353614,0.37285491419656785
4813,3610027,2117,0,151,990,2117,2117,1.0,0.0,1.0,976,0.07132735002361833,0.46764289088332545,0.4610297590930562
4814,3610028,2657,0,213,1366,2657,2657,1.0,0.0,1.0,1078,0.08016560030109146,0.51411366202484,0.4057207376740685
4815,3610029,1422,0,94,541,1422,1422,1.0,0.0,1.0,787,0.06610407876230662,0.38045007032348804,0.5534458509142054
4816,3610030,1216,17,90,501,1199,1216,1.0,0.013980263157894737,0.9860197368421053,625,0.07401315789473684,0.4120065789473684,0.5139802631578947
4817,3610031,2758,45,191,1052,2713,2758,1.0,0.016316171138506162,0.9836838288614939,1515,0.06925308194343727,0.38143582306018853,0.5493110949963742
4818,3610032,2054,2,154,916,2052,2054,1.0,0.0009737098344693282,0.9990262901655307,984,0.07497565725413827,0.4459591041869523,0.4790652385589094
4819,3610033,1684,2,122,710,1682,1684,1.0,0.0011876484560570072,0.998812351543943,852,0.07244655581947744,0.42161520190023755,0.505938242280285
4820,3610034,1964,2,113,772,1962,1964,1.0,0.0010183299389002036,0.9989816700610998,1079,0.057535641547861505,0.39307535641547864,0.5493890020366599
4821,3630001,684,27,45,295,657,684,1.0,0.039473684210526314,0.9605263157894737,344,0.06578947368421052,0.43128654970760233,0.5029239766081871
4822,3630002,20,0,2,9,20,20,1.0,0.0,1.0,9,0.1,0.45,0.45
4823,3630003,1135,0,73,436,1135,1135,1.0,0.0,1.0,626,0.06431718061674009,0.3841409691629956,0.5515418502202644
4824,3630004,474,0,30,180,474,474,1.0,0.0,1.0,264,0.06329113924050633,0.379746835443038,0.5569620253164557
4825,3630005,554,0,47,215,554,554,1.0,0.0,1.0,292,0.08483754512635379,0.388086642599278,0.5270758122743683
4826,3630006,811,1,101,436,810,811,1.0,0.0012330456226880395,0.998766954377312,274,0.12453760789149199,0.5376078914919852,0.33785450061652283
4827,3630007,662,0,46,269,662,662,1.0,0.0,1.0,347,0.06948640483383686,0.40634441087613293,0.5241691842900302
4828,3630008,1699,5,96,790,1694,1699,1.0,0.002942907592701589,0.9970570924072985,813,0.05650382577987051,0.4649793996468511,0.4785167745732784
4829,3630009,336,1,24,191,335,336,1.0,0.002976190476190476,0.9970238095238095,121,0.07142857142857142,0.5684523809523809,0.3601190476190476
4830,3630011,310,0,10,126,310,310,1.0,0.0,1.0,174,0.03225806451612903,0.4064516129032258,0.5612903225806452
4831,3630012,445,0,42,201,445,445,1.0,0.0,1.0,202,0.09438202247191012,0.451685393258427,0.45393258426966293
4832,3630013,629,0,84,323,629,629,1.0,0.0,1.0,222,0.13354531001589826,0.5135135135135135,0.35294117647058826
4833,3630014,199,0,19,78,199,199,1.0,0.0,1.0,102,0.09547738693467336,0.39195979899497485,0.5125628140703518
4834,3630015,834,0,77,391,834,834,1.0,0.0,1.0,366,0.09232613908872901,0.46882494004796166,0.43884892086330934
4835,3630016,446,7,28,229,439,446,1.0,0.01569506726457399,0.984304932735426,189,0.06278026905829596,0.5134529147982063,0.42376681614349776
4836,3630017,920,60,93,137,860,920,1.0,0.06521739130434782,0.9347826086956522,690,0.10108695652173913,0.14891304347826087,0.75
4837,3630018,182,0,21,82,182,182,1.0,0.0,1.0,79,0.11538461538461539,0.45054945054945056,0.4340659340659341
4838,3630020,189,0,12,101,189,189,1.0,0.0,1.0,76,0.06349206349206349,0.5343915343915344,0.4021164021164021
4839,3630021,951,73,102,392,878,951,1.0,0.07676130389064142,0.9232386961093586,457,0.10725552050473186,0.41219768664563616,0.480546792849632
4840,3630022,974,2,85,431,972,974,1.0,0.002053388090349076,0.997946611909651,458,0.08726899383983573,0.44250513347022585,0.4702258726899384
4841,3630023,2236,29,167,513,2207,2236,1.0,0.0129695885509839,0.9870304114490162,1556,0.07468694096601074,0.22942754919499106,0.6958855098389982
4842,3630024,191,0,23,64,191,191,1.0,0.0,1.0,104,0.12041884816753927,0.33507853403141363,0.5445026178010471
4843,3630025,283,2,14,43,281,283,1.0,0.007067137809187279,0.9929328621908127,226,0.04946996466431095,0.1519434628975265,0.7985865724381626
4844,3630026,98,0,15,31,98,98,1.0,0.0,1.0,52,0.15306122448979592,0.3163265306122449,0.5306122448979592
4845,3630027,1858,13,198,705,1845,1858,1.0,0.006996770721205597,0.9930032292787944,955,0.10656620021528525,0.37944025834230355,0.5139935414424112
4846,3630028,1315,33,101,243,1282,1315,1.0,0.025095057034220533,0.9749049429657795,971,0.07680608365019011,0.18479087452471482,0.7384030418250951
4847,3630029,1335,64,137,326,1271,1335,1.0,0.04794007490636704,0.9520599250936329,872,0.10262172284644194,0.2441947565543071,0.6531835205992509
4848,3630030,754,118,119,156,636,754,1.0,0.15649867374005305,0.843501326259947,479,0.15782493368700265,0.20689655172413793,0.6352785145888594
4849,3650001,2009,349,258,996,1660,2009,1.0,0.17371826779492286,0.8262817322050772,755,0.12842210054753608,0.4957690393230463,0.3758088601294176
4850,3650002,2509,504,286,1153,2005,2509,1.0,0.20087684336389,0.79912315663611,1070,0.11398963730569948,0.4595456357114388,0.4264647269828617
4851,3650003,1471,134,189,632,1337,1471,1.0,0.09109449354180829,0.9089055064581917,650,0.12848402447314752,0.42963970088375253,0.4418762746430999
4852,3650005,628,41,41,245,587,628,1.0,0.06528662420382166,0.9347133757961783,342,0.06528662420382166,0.39012738853503187,0.5445859872611465
4853,3650007,940,266,107,372,674,940,1.0,0.28297872340425534,0.7170212765957447,461,0.11382978723404255,0.39574468085106385,0.49042553191489363
4854,3650008,325,93,32,120,232,325,1.0,0.28615384615384615,0.7138461538461538,173,0.09846153846153846,0.36923076923076925,0.5323076923076923
4855,3650009,457,157,87,369,300,457,1.0133333333333334,0.3435448577680525,0.6564551422319475,1,0.19037199124726478,0.8074398249452954,0.002188183807439825
4856,3650010,410,121,72,164,289,410,1.0,0.2951219512195122,0.7048780487804878,174,0.17560975609756097,0.4,0.424390243902439
4857,3650012,491,140,15,266,351,491,1.0,0.285132382892057,0.714867617107943,210,0.03054989816700611,0.5417515274949084,0.42769857433808556
4858,3650013,411,14,73,136,397,411,1.0,0.0340632603406326,0.9659367396593674,202,0.17761557177615572,0.3309002433090024,0.49148418491484186
4859,3650014,490,20,27,234,470,490,1.0,0.04081632653061224,0.9591836734693877,229,0.05510204081632653,0.4775510204081633,0.4673469387755102
4860,3650018,2026,131,211,1019,1895,2026,1.0,0.06465942744323791,0.9353405725567621,796,0.10414610069101678,0.5029615004935835,0.3928923988153998
4861,3650019,361,10,24,181,351,361,1.0,0.027700831024930747,0.9722991689750693,156,0.0664819944598338,0.5013850415512465,0.43213296398891965
4862,3650020,311,13,3,169,298,311,1.0,0.04180064308681672,0.9581993569131833,139,0.00964630225080386,0.5434083601286174,0.44694533762057875
4863,3650022,490,112,132,109,378,490,1.0,0.22857142857142856,0.7714285714285715,249,0.2693877551020408,0.22244897959183674,0.5081632653061224
4864,3650026,225,64,47,84,161,225,1.0,0.28444444444444444,0.7155555555555555,94,0.2088888888888889,0.37333333333333335,0.4177777777777778
4865,3650027,988,414,378,376,574,988,1.0,0.4190283400809717,0.5809716599190283,234,0.3825910931174089,0.3805668016194332,0.23684210526315788
4866,3650028,2231,293,227,1138,1938,2231,1.0,0.131331241595697,0.868668758404303,866,0.10174809502465262,0.5100851636037651,0.38816674137158225
4867,3650029,412,118,2,187,294,412,1.0,0.28640776699029125,0.7135922330097088,223,0.0048543689320388345,0.4538834951456311,0.5412621359223301
4868,3670100,3436,22,396,1591,3414,3436,1.0,0.006402793946449359,0.9935972060535506,1449,0.11525029103608847,0.4630384167636787,0.42171129220023285
4869,3670105,2232,4,156,788,2228,2232,1.0,0.0017921146953405018,0.9982078853046595,1288,0.06989247311827956,0.35304659498207885,0.5770609318996416
4870,3670110,2812,0,185,603,2812,2812,1.0,0.0,1.0,2024,0.06578947368421052,0.21443812233285917,0.7197724039829303
4871,3670111,1225,5,91,384,1220,1225,1.0,0.004081632653061225,0.9959183673469387,750,0.07428571428571429,0.313469387755102,0.6122448979591837
4872,3670115,2706,14,238,783,2692,2706,1.0,0.005173688100517369,0.9948263118994827,1685,0.08795269770879527,0.2893569844789357,0.622690317812269
4873,3670120,2294,5,161,836,2289,2294,1.0,0.002179598953792502,0.9978204010462075,1297,0.07018308631211857,0.3644289450741064,0.565387968613775
4874,3670125,2609,13,159,958,2596,2609,1.0,0.004982752012265236,0.9950172479877347,1492,0.060942889996167114,0.36719049444231505,0.5718666155615179
4875,3670130,3391,35,268,1121,3356,3391,1.0,0.01032143910350929,0.9896785608964908,2002,0.07903273370687112,0.33058094957239753,0.5903863167207314
4876,3670135,1748,38,101,645,1710,1748,1.0,0.021739130434782608,0.9782608695652174,1002,0.057780320366132724,0.36899313501144165,0.5732265446224256
4877,3670140,1363,3,71,477,1360,1363,1.0,0.0022010271460014674,0.9977989728539985,815,0.052090975788701394,0.3499633162142333,0.5979457079970653
4878,3670200,2674,136,164,610,2538,2674,1.0,0.050860134629768135,0.9491398653702319,1900,0.061331338818249814,0.2281226626776365,0.7105459985041137
4879,3670205,2514,16,250,679,2498,2514,1.0,0.006364359586316627,0.9936356404136834,1585,0.09944311853619729,0.27008750994431185,0.6304693715194909
4880,3670210,2075,0,107,794,2075,2075,1.0,0.0,1.0,1174,0.051566265060240965,0.38265060240963855,0.5657831325301205
4881,3670215,3007,4,266,1461,3003,3007,1.0,0.0013302294645826404,0.9986697705354174,1280,0.0884602593947456,0.48586631193880947,0.425673428666445
4882,3670220,523,0,61,351,523,523,1.0,0.0,1.0,111,0.11663479923518165,0.6711281070745698,0.21223709369024857
4883,3670225,1537,44,94,615,1493,1537,1.0,0.028627195836044242,0.9713728041639558,828,0.06115810019518542,0.40013012361743655,0.538711776187378
4884,3670230,1101,0,113,565,1101,1101,1.0,0.0,1.0,423,0.10263396911898275,0.5131698455949137,0.38419618528610355
4885,3670235,1065,6,76,471,1059,1065,1.0,0.005633802816901409,0.9943661971830986,518,0.07136150234741784,0.4422535211267606,0.4863849765258216
4886,3670240,2237,3,107,555,2234,2237,1.0,0.0013410818059901655,0.9986589181940099,1575,0.04783191774698257,0.2481001341081806,0.7040679481448369
4887,3670245,1446,57,97,600,1389,1446,1.0,0.03941908713692946,0.9605809128630706,749,0.06708160442600276,0.4149377593360996,0.5179806362378977
4888,3670250,1459,26,128,713,1433,1459,1.0,0.01782042494859493,0.9821795750514051,618,0.08773132282385196,0.4886908841672378,0.4235777930089102
4889,3670255,2735,194,184,843,2541,2735,1.0,0.07093235831809871,0.9290676416819013,1708,0.06727605118829982,0.30822669104204753,0.6244972577696527
4890,3670300,1758,29,212,732,1729,1758,1.0,0.016496018202502846,0.9835039817974972,814,0.12059158134243458,0.41638225255972694,0.4630261660978385
4891,3670305,2146,12,238,772,2134,2146,1.0,0.005591798695246971,0.994408201304753,1136,0.11090400745573159,0.3597390493942218,0.5293569431500466
4892,3670310,2182,28,195,538,2154,2182,1.0,0.012832263978001834,0.9871677360219981,1449,0.08936755270394134,0.2465627864344638,0.6640696608615949
4893,3670315,4314,122,383,1791,4192,4314,1.0,0.028280018544274456,0.9717199814557256,2140,0.08878071395456653,0.4151599443671766,0.4960593416782568
4894,3670320,1938,3,179,879,1935,1938,1.0,0.0015479876160990713,0.9984520123839009,880,0.09236326109391124,0.4535603715170279,0.4540763673890609
4895,3670325,2002,49,135,874,1953,2002,1.0,0.024475524475524476,0.9755244755244755,993,0.06743256743256744,0.43656343656343655,0.49600399600399603
4896,3670330,1671,20,139,516,1651,1671,1.0,0.011968880909634948,0.988031119090365,1016,0.0831837223219629,0.3087971274685817,0.6080191502094554
4897,3670335,2313,28,185,1509,2285,2313,1.0,0.012105490704712495,0.9878945092952875,619,0.0799827064418504,0.6523994811932555,0.26761781236489407
4898,3670340,578,0,62,362,578,578,1.0,0.0,1.0,154,0.10726643598615918,0.6262975778546713,0.2664359861591695
4899,3670345,1535,4,147,850,1531,1535,1.0,0.0026058631921824105,0.9973941368078176,538,0.09576547231270359,0.5537459283387622,0.3504885993485342
4900,3670350,2319,21,194,1186,2298,2319,1.0,0.009055627425614488,0.9909443725743855,939,0.08365674859853385,0.5114273393704183,0.4049159120310479
4901,3670400,2729,30,330,1528,2699,2729,1.0,0.010993037742762916,0.989006962257237,871,0.12092341517039208,0.5599120556980579,0.31916452913155
4902,3670410,1727,0,195,929,1727,1727,1.0,0.0,1.0,603,0.1129125651418645,0.5379270411117545,0.349160393746381
4903,3670415,2493,1,208,1001,2492,2493,1.0,0.00040112314480545525,0.9995988768551946,1284,0.08343361411953469,0.40152426795026075,0.5150421179302046
4904,3670420,1909,28,143,1053,1881,1909,1.0,0.014667365112624411,0.9853326348873755,713,0.0749083289680461,0.5515976951283394,0.37349397590361444
4905,3670425,1503,6,138,638,1497,1503,1.0,0.003992015968063872,0.9960079840319361,727,0.09181636726546906,0.4244843646041251,0.48369926813040587
4906,3670430,2308,8,161,945,2300,2308,1.0,0.0034662045060658577,0.9965337954939342,1202,0.06975736568457538,0.40944540727902945,0.5207972270363952
4907,3670435,2697,8,234,1323,2689,2697,1.0,0.0029662588060808304,0.9970337411939192,1140,0.0867630700778643,0.4905450500556173,0.42269187986651835
4908,3670440,3218,26,255,1736,3192,3218,1.0,0.008079552517091361,0.9919204474829086,1227,0.07924176507147296,0.5394655065257924,0.3812927284027346
4909,3670445,1759,25,145,857,1734,1759,1.0,0.014212620807276862,0.9857873791927232,757,0.0824332006822058,0.4872086412734508,0.43035815804434335
4910,3670450,2457,7,242,1334,2450,2457,1.0,0.002849002849002849,0.9971509971509972,881,0.0984940984940985,0.5429385429385429,0.35856735856735855
4911,3690101,1510,26,144,623,1484,1510,1.0,0.017218543046357615,0.9827814569536424,743,0.09536423841059603,0.41258278145695365,0.49205298013245036
4912,3690201,774,3,155,213,771,774,1.0,0.003875968992248062,0.9961240310077519,406,0.20025839793281655,0.2751937984496124,0.524547803617571
4913,3690202,261,5,10,134,256,261,1.0,0.019157088122605363,0.9808429118773946,117,0.038314176245210725,0.5134099616858238,0.4482758620689655
4914,3690203,71,0,2,51,71,71,1.0,0.0,1.0,18,0.028169014084507043,0.7183098591549296,0.2535211267605634
4915,3690301,1279,15,111,520,1264,1279,1.0,0.011727912431587178,0.9882720875684128,648,0.08678655199374512,0.4065676309616888,0.506645817044566
4916,3690302,244,0,2,139,244,244,1.0,0.0,1.0,103,0.00819672131147541,0.569672131147541,0.42213114754098363
4917,3690303,129,0,5,44,129,129,1.0,0.0,1.0,80,0.03875968992248062,0.34108527131782945,0.6201550387596899
4918,3690401,518,24,25,175,494,518,1.0,0.04633204633204633,0.9536679536679536,318,0.04826254826254826,0.33783783783783783,0.6138996138996139
4919,3690402,907,13,74,106,894,907,1.0,0.014332965821389196,0.9856670341786108,727,0.08158765159867695,0.11686879823594266,0.8015435501653804
4920,3710001,3976,337,379,691,3639,3976,1.0,0.08475855130784708,0.915241448692153,2906,0.09532193158953722,0.1737927565392354,0.7308853118712274
4921,3710002,2149,48,494,546,2101,2149,1.0,0.022335970218706376,0.9776640297812936,1109,0.22987436016751978,0.254071661237785,0.5160539785946953
4922,3710003,157,2,25,131,155,157,1.0833333333333333,0.012738853503184714,0.9872611464968153,1,0.1592356687898089,0.8343949044585988,0.006369426751592357
4923,3710004,832,2,69,389,830,832,1.0,0.002403846153846154,0.9975961538461539,374,0.0829326923076923,0.4675480769230769,0.4495192307692308
4924,3710005,51,1,2,39,50,51,1.0,0.0196078431372549,0.9803921568627451,10,0.0392156862745098,0.7647058823529411,0.19607843137254902
4925,3710006,176,0,30,37,176,176,1.0,0.0,1.0,109,0.17045454545454544,0.21022727272727273,0.6193181818181818
4926,3710007,1717,116,379,395,1601,1717,1.0,0.0675596971461852,0.9324403028538147,943,0.22073383808969133,0.23005241700640652,0.5492137449039022
4927,3710009,203,0,31,115,203,203,1.0,0.0,1.0,57,0.15270935960591134,0.5665024630541872,0.28078817733990147
4928,3710010,1375,55,182,169,1320,1375,1.0,0.04,0.96,1024,0.13236363636363635,0.12290909090909091,0.7447272727272727
4929,3730001,483,27,35,155,456,483,1.0,0.055900621118012424,0.9440993788819876,293,0.07246376811594203,0.32091097308488614,0.6066252587991718
4930,3730002,657,0,44,199,657,657,1.0,0.0,1.0,414,0.0669710806697108,0.3028919330289193,0.6301369863013698
4931,3730003,2348,253,225,625,2095,2348,1.0,0.10775127768313458,0.8922487223168655,1498,0.09582623509369677,0.2661839863713799,0.6379897785349233
4932,3730004,1950,102,163,591,1848,1950,1.0,0.052307692307692305,0.9476923076923077,1196,0.0835897435897436,0.3030769230769231,0.6133333333333333
4933,3730005,5560,1310,278,1039,4250,5560,1.0,0.2356115107913669,0.7643884892086331,4243,0.05,0.1868705035971223,0.7631294964028777
4934,3730006,5177,129,473,1852,5048,5177,1.0,0.024917906123237396,0.9750820938767626,2852,0.09136565578520378,0.35773614062198184,0.5508982035928144
4935,3730007,1092,236,111,272,856,1092,1.0,0.21611721611721613,0.7838827838827839,709,0.10164835164835165,0.2490842490842491,0.6492673992673993
4936,3730008,1209,127,220,322,1082,1209,1.0,0.10504549214226634,0.8949545078577337,667,0.18196856906534326,0.2663358147229115,0.5516956162117452
4937,3730009,903,170,115,317,733,903,1.0,0.18826135105204872,0.8117386489479512,471,0.1273532668881506,0.35105204872646734,0.521594684385382
4938,3730010,2952,605,489,792,2347,2952,1.0,0.20494579945799457,0.7950542005420054,1671,0.16565040650406504,0.2682926829268293,0.5660569105691057
4939,3730011,467,64,84,133,403,467,1.0,0.13704496788008566,0.8629550321199143,250,0.17987152034261242,0.284796573875803,0.5353319057815846
4940,3730012,406,44,94,34,362,406,1.0,0.10837438423645321,0.8916256157635468,278,0.2315270935960591,0.08374384236453201,0.6847290640394089
4941,3730013,356,20,24,206,336,356,1.0,0.056179775280898875,0.9438202247191011,126,0.06741573033707865,0.5786516853932584,0.3539325842696629
4942,3730014,934,26,111,352,908,934,1.0,0.027837259100642397,0.9721627408993576,471,0.11884368308351177,0.37687366167023556,0.5042826552462527
4943,3730015,1353,21,69,453,1332,1353,1.0,0.015521064301552107,0.9844789356984479,831,0.050997782705099776,0.3348115299334812,0.614190687361419
4944,3730016,5296,170,392,1796,5126,5296,1.0,0.03209969788519638,0.9679003021148036,3108,0.07401812688821752,0.3391238670694864,0.5868580060422961
4945,3730017,1286,91,103,446,1195,1286,1.0,0.07076205287713841,0.9292379471228616,737,0.08009331259720062,0.3468118195956454,0.573094867807154
4946,3730018,814,299,223,91,515,814,1.0,0.36732186732186733,0.6326781326781327,500,0.273955773955774,0.11179361179361179,0.6142506142506142
4947,3730019,2696,0,735,1961,2696,2696,6.2407407407407405,0.0,1.0,0,0.27262611275964393,0.7273738872403561,0.0
4948,3730020,2712,0,743,1969,2712,2712,4.877697841726619,0.0,1.0,0,0.27396755162241887,0.7260324483775811,0.0
4949,3730021,1551,193,128,466,1358,1551,1.0,0.12443584784010316,0.8755641521598968,957,0.08252740167633785,0.3004513217279175,0.6170212765957447
4950,3750121,2303,130,197,986,2173,2303,1.0,0.05644811115935736,0.9435518888406427,1120,0.08554059921841077,0.42813721233174123,0.48632218844984804
4951,3750122,4027,178,292,1055,3849,4027,1.0,0.044201638937174076,0.9557983610628259,2680,0.07251055376210579,0.2619816240377452,0.665507822200149
4952,3750123,4630,430,455,1463,4200,4630,1.0,0.09287257019438445,0.9071274298056156,2712,0.09827213822894168,0.31598272138228944,0.5857451403887689
4953,3750124,2367,3,226,1229,2364,2367,1.0,0.0012674271229404308,0.9987325728770595,912,0.09547950992817913,0.5192226446979299,0.385297845373891
4954,3750125,4570,208,433,1386,4362,4570,1.0,0.045514223194748356,0.9544857768052516,2751,0.09474835886214442,0.30328227571115973,0.6019693654266959
4955,3750126,3430,208,357,989,3222,3430,1.0,0.060641399416909623,0.9393586005830904,2084,0.10408163265306122,0.28833819241982506,0.6075801749271137
4956,3750221,2725,199,236,364,2526,2725,1.0,0.07302752293577981,0.9269724770642201,2125,0.08660550458715596,0.13357798165137616,0.7798165137614679
4957,3750222,2880,195,203,354,2685,2880,1.0,0.06770833333333333,0.9322916666666666,2323,0.07048611111111111,0.12291666666666666,0.8065972222222222
4958,3750223,3092,180,301,309,2912,3092,1.0,0.05821474773609314,0.9417852522639069,2482,0.09734799482535576,0.0999353169469599,0.8027166882276844
4959,3750224,4430,151,410,717,4279,4430,1.0,0.03408577878103838,0.9659142212189616,3303,0.09255079006772009,0.16185101580135441,0.7455981941309255
4960,3750225,2297,35,266,331,2262,2297,1.0,0.015237265999129298,0.9847627340008707,1700,0.11580322159338267,0.14410100130605139,0.740095777100566
4961,3750321,1809,0,141,1065,1809,1809,1.0,0.0,1.0,603,0.0779436152570481,0.5887230514096186,0.3333333333333333
4962,3750322,258,0,27,103,258,258,1.0,0.0,1.0,128,0.10465116279069768,0.3992248062015504,0.49612403100775193
4963,3750323,4409,0,334,1982,4409,4409,1.0,0.0,1.0,2093,0.07575413926060331,0.449535041959628,0.4747108187797687
4964,3750324,3989,47,427,2165,3942,3989,1.0,0.011782401604412133,0.9882175983955879,1397,0.10704437202306342,0.5427425419904738,0.3502130859864628
4965,3750325,3201,166,328,1228,3035,3201,1.0,0.05185879412683536,0.9481412058731646,1645,0.10246797875663854,0.3836301155888785,0.513901905654483
4966,3750326,2988,55,267,1167,2933,2988,1.0,0.018406961178045515,0.9815930388219545,1554,0.0893574297188755,0.39056224899598396,0.5200803212851406
4967,3750327,7365,2064,112,519,5301,7365,1.0,0.28024439918533606,0.7197556008146639,6734,0.015207060420909708,0.07046843177189409,0.9143245078071962
4968,3750421,2366,267,272,206,2099,2366,1.0,0.1128486897717667,0.8871513102282333,1888,0.11496196111580727,0.08706677937447169,0.797971259509721
4969,3750422,5756,1710,868,467,4046,5756,1.0,0.2970813064628214,0.7029186935371786,4421,0.1507991660875608,0.08113273106323836,0.7680681028492008
4970,3750424,1763,776,408,247,987,1763,1.0,0.4401588201928531,0.5598411798071469,1108,0.23142370958593306,0.14010209869540555,0.6284741917186614
4971,3750425,2398,442,343,292,1956,2398,1.0,0.18432026688907424,0.8156797331109258,1763,0.14303586321934947,0.12176814011676397,0.7351959966638866
4972,3750426,1022,205,130,172,817,1022,1.0,0.20058708414872797,0.799412915851272,720,0.12720156555772993,0.16829745596868884,0.7045009784735812
4973,3750427,1288,61,93,122,1227,1288,1.0,0.04736024844720497,0.952639751552795,1073,0.07220496894409938,0.09472049689440994,0.8330745341614907
4974,3770001,237,0,81,47,237,237,1.0,0.0,1.0,109,0.34177215189873417,0.19831223628691982,0.459915611814346
4975,3770002,506,0,165,65,506,506,1.0,0.0,1.0,276,0.32608695652173914,0.12845849802371542,0.5454545454545454
4976,3770003,45,0,13,5,45,45,1.0,0.0,1.0,27,0.28888888888888886,0.1111111111111111,0.6
4977,3770004,683,0,294,107,683,683,1.0,0.0,1.0,282,0.43045387994143486,0.15666178623718888,0.4128843338213763
4978,3770005,675,0,255,89,675,675,1.0,0.0,1.0,331,0.37777777777777777,0.13185185185185186,0.49037037037037035
4979,3770006,34,0,11,3,34,34,1.0,0.0,1.0,20,0.3235294117647059,0.08823529411764706,0.5882352941176471
4980,3770007,996,0,454,188,996,996,1.0,0.0,1.0,354,0.45582329317269077,0.18875502008032127,0.35542168674698793
4981,3790101,1323,33,99,494,1290,1323,1.0,0.024943310657596373,0.9750566893424036,730,0.07482993197278912,0.37339380196523053,0.5517762660619804
4982,3790102,936,30,104,315,906,936,1.0,0.03205128205128205,0.967948717948718,517,0.1111111111111111,0.33653846153846156,0.5523504273504274
4983,3790203,1522,18,83,607,1504,1522,1.0,0.011826544021024968,0.988173455978975,832,0.054533508541392904,0.3988173455978975,0.5466491458607096
4984,3790204,696,34,57,286,662,696,1.0,0.04885057471264368,0.9511494252873564,353,0.08189655172413793,0.4109195402298851,0.507183908045977
4985,3790305,759,12,91,374,747,759,1.0,0.015810276679841896,0.9841897233201581,294,0.11989459815546773,0.4927536231884058,0.38735177865612647
4986,3790306,1312,66,168,427,1246,1312,1.0,0.05030487804878049,0.9496951219512195,717,0.12804878048780488,0.3254573170731707,0.5464939024390244
4987,3790407,1302,57,68,367,1245,1302,1.0,0.04377880184331797,0.956221198156682,867,0.05222734254992319,0.2818740399385561,0.6658986175115207
4988,3790408,1078,56,81,378,1022,1078,1.0,0.05194805194805195,0.948051948051948,619,0.075139146567718,0.35064935064935066,0.5742115027829313
4989,3810110,5652,4,343,2405,5648,5652,1.0,0.0007077140835102619,0.9992922859164898,2904,0.06068648266100495,0.42551309271054494,0.5138004246284501
4990,3810111,6201,349,524,1668,5852,6201,1.0,0.056281244960490244,0.9437187550395097,4009,0.08450249959683923,0.26898887276245764,0.6465086276407032
4991,3810112,4939,176,421,1271,4763,4939,1.0,0.035634743875278395,0.9643652561247216,3247,0.08523992711075117,0.2573395424174934,0.6574205304717554
4992,3810114,3789,43,361,1275,3746,3789,1.0,0.011348640802322512,0.9886513591976774,2153,0.09527579836368436,0.33650039588281866,0.568223805753497
4993,3810123,2766,143,126,561,2623,2766,1.0,0.05169920462762111,0.9483007953723789,2079,0.0455531453362256,0.20281995661605207,0.7516268980477223
4994,3810208,5044,52,298,2175,4992,5044,1.0,0.010309278350515464,0.9896907216494846,2571,0.05908009516256939,0.43120539254559875,0.5097145122918318
4995,3810220,2513,44,232,1139,2469,2513,1.0,0.017508953442101075,0.9824910465578989,1142,0.09231993633107839,0.4532431356943892,0.45443692797453245
4996,3810222,4184,105,423,2606,4079,4184,1.0,0.025095602294455066,0.9749043977055449,1155,0.10109942638623327,0.622848948374761,0.2760516252390057
4997,3810227,5564,259,410,2797,5305,5564,1.0,0.04654924514737599,0.953450754852624,2357,0.07368799424874191,0.5026959022286125,0.42361610352264556
4998,3810228,4808,144,486,2959,4664,4808,1.0,0.029950083194675542,0.9700499168053245,1363,0.10108153078202994,0.615432612312812,0.2834858569051581
4999,3810230,3320,11,279,1865,3309,3320,1.0,0.0033132530120481927,0.9966867469879518,1176,0.08403614457831325,0.5617469879518072,0.3542168674698795
5000,3810305,3062,10,222,1239,3052,3062,1.0,0.0032658393207054214,0.9967341606792945,1601,0.07250163291966036,0.4046374918354017,0.522860875244938
5001,3810306,4629,117,354,1801,4512,4629,1.0,0.025275437459494492,0.9747245625405055,2474,0.07647440051847051,0.3890689133722186,0.5344566861093109
5002,3810307,4125,1,258,1849,4124,4125,1.0,0.00024242424242424242,0.9997575757575757,2018,0.06254545454545454,0.4482424242424242,0.4892121212121212
5003,3810309,4249,59,269,1679,4190,4249,1.0,0.013885620145916686,0.9861143798540833,2301,0.06330901388562014,0.3951518004236291,0.5415391856907508
5004,3810324,5855,32,465,2916,5823,5855,1.0,0.005465414175918019,0.9945345858240819,2474,0.07941929974380871,0.49803586678052947,0.42254483347566185
5005,3810325,2962,6,194,1674,2956,2962,1.0,0.002025658338960162,0.9979743416610398,1094,0.06549628629304524,0.5651586765698852,0.36934503713706957
5006,3810415,4718,70,283,1511,4648,4718,1.0,0.01483679525222552,0.9851632047477745,2924,0.05998304366256889,0.3202628232301823,0.6197541331072488
5007,3810418,5620,145,550,2669,5475,5620,1.0,0.025800711743772242,0.9741992882562278,2401,0.09786476868327403,0.47491103202846974,0.4272241992882562
5008,3810421,5234,464,357,1653,4770,5234,1.0,0.08865112724493696,0.911348872755063,3224,0.06820787160871226,0.3158196408100879,0.6159724875811998
5009,3810426,2743,0,222,1612,2743,2743,1.0,0.0,1.0,909,0.08093328472475392,0.5876777251184834,0.33138899015676265
5010,3810429,4823,100,497,2123,4723,4823,1.0,0.02073398299813394,0.9792660170018661,2203,0.10304789550072568,0.44018245905038356,0.4567696454488907
5011,3830001,503,20,40,63,483,503,1.0,0.039761431411530816,0.9602385685884692,400,0.07952286282306163,0.12524850894632206,0.7952286282306164
5012,3830002,558,3,34,246,555,558,1.0,0.005376344086021506,0.9946236559139785,278,0.06093189964157706,0.44086021505376344,0.4982078853046595
5013,3830003A,521,1,50,187,520,521,1.0,0.0019193857965451055,0.9980806142034548,284,0.09596928982725528,0.35892514395393477,0.54510556621881
5014,3830003B,89,0,1,22,89,89,1.0,0.0,1.0,66,0.011235955056179775,0.24719101123595505,0.7415730337078652
5015,3830004,514,4,33,158,510,514,1.0,0.007782101167315175,0.9922178988326849,323,0.06420233463035019,0.30739299610894943,0.6284046692607004
5016,3850001,603,1,80,329,602,603,1.0,0.001658374792703151,0.9983416252072969,194,0.13266998341625208,0.5456053067993366,0.32172470978441126
5017,3850002,626,2,72,384,624,626,1.0,0.003194888178913738,0.9968051118210862,170,0.11501597444089456,0.6134185303514377,0.2715654952076677
5018,3850003,801,0,77,199,801,801,1.0,0.0,1.0,525,0.09612983770287141,0.2484394506866417,0.6554307116104869
5019,3850004,223,0,22,104,223,223,1.0,0.0,1.0,97,0.09865470852017937,0.4663677130044843,0.4349775784753363
5020,3850006,288,0,20,173,288,288,1.0,0.0,1.0,95,0.06944444444444445,0.6006944444444444,0.3298611111111111
5021,3850007,84,0,6,47,84,84,1.0,0.0,1.0,31,0.07142857142857142,0.5595238095238095,0.36904761904761907
5022,3870001,152,37,36,28,115,152,1.0,0.24342105263157895,0.756578947368421,88,0.23684210526315788,0.18421052631578946,0.5789473684210527
5023,3870002,875,221,172,277,654,875,1.0,0.25257142857142856,0.7474285714285714,426,0.19657142857142856,0.31657142857142856,0.4868571428571429
5024,3870003,1498,656,397,336,842,1498,1.0,0.4379172229639519,0.562082777036048,765,0.2650200267022697,0.22429906542056074,0.5106809078771696
5025,3870004,1057,334,236,354,723,1057,1.0,0.31598864711447494,0.6840113528855251,467,0.22327341532639547,0.33491012298959316,0.44181646168401134
5026,3870005,1243,7,106,456,1236,1243,1.0,0.0056315366049879325,0.9943684633950121,681,0.08527755430410297,0.3668543845534996,0.5478680611423974
5027,3870007,305,1,37,116,304,305,1.0,0.003278688524590164,0.9967213114754099,152,0.12131147540983607,0.380327868852459,0.49836065573770494
5028,3870009,277,0,6,174,277,277,1.0,0.0,1.0,97,0.021660649819494584,0.628158844765343,0.35018050541516244
5029,3870010,239,0,18,113,239,239,1.0,0.0,1.0,108,0.07531380753138076,0.47280334728033474,0.45188284518828453
5030,3870011,191,26,11,112,165,191,1.0,0.13612565445026178,0.8638743455497382,68,0.05759162303664921,0.5863874345549738,0.35602094240837695
5031,3870013,979,109,82,287,870,979,1.0,0.11133810010214505,0.8886618998978549,610,0.08375893769152196,0.2931562819203269,0.6230847803881512
5032,3870014,244,2,33,111,242,244,1.0,0.00819672131147541,0.9918032786885246,100,0.13524590163934427,0.45491803278688525,0.4098360655737705
5033,3870017,183,15,39,108,168,183,1.0,0.08196721311475409,0.9180327868852459,36,0.21311475409836064,0.5901639344262295,0.19672131147540983
5034,3870018,170,14,26,79,156,170,1.0,0.08235294117647059,0.9176470588235294,65,0.15294117647058825,0.4647058823529412,0.38235294117647056
5035,3870019,445,71,36,196,374,445,1.0,0.15955056179775282,0.8404494382022472,213,0.08089887640449438,0.4404494382022472,0.4786516853932584
5036,3870020,215,34,54,51,181,215,1.0,0.15813953488372093,0.8418604651162791,110,0.25116279069767444,0.2372093023255814,0.5116279069767442
5037,3870021,179,28,30,74,151,179,1.0,0.1564245810055866,0.8435754189944135,75,0.16759776536312848,0.4134078212290503,0.41899441340782123
5038,3870024,175,18,24,103,157,175,1.0,0.10285714285714286,0.8971428571428571,48,0.13714285714285715,0.5885714285714285,0.2742857142857143
5039,3870027,448,38,35,302,410,448,1.0,0.08482142857142858,0.9151785714285714,111,0.078125,0.6741071428571429,0.24776785714285715
5040,3870028,329,34,60,98,295,329,1.0,0.1033434650455927,0.8966565349544073,171,0.182370820668693,0.2978723404255319,0.5197568389057751
5041,3870029,148,0,32,82,148,148,1.0,0.0,1.0,34,0.21621621621621623,0.5540540540540541,0.22972972972972974
5042,3870030,168,0,0,0,168,168,1.0,0.0,1.0,168,0.0,0.0,1.0
5043,3870031,152,0,12,92,152,152,1.0,0.0,1.0,48,0.07894736842105263,0.6052631578947368,0.3157894736842105
5044,3890001,524,7,169,54,517,524,1.0,0.013358778625954198,0.9866412213740458,301,0.32251908396946566,0.10305343511450382,0.5744274809160306
5045,3890002,988,7,217,134,981,988,1.0,0.00708502024291498,0.992914979757085,637,0.21963562753036436,0.13562753036437247,0.6447368421052632
5046,3890003,831,29,208,179,802,831,1.0,0.03489771359807461,0.9651022864019254,444,0.2503008423586041,0.21540312876052947,0.5342960288808665
5047,3890004,1345,114,11,26,1231,1345,1.0,0.08475836431226766,0.9152416356877323,1308,0.008178438661710037,0.019330855018587362,0.9724907063197026
5048,3890005,528,2,134,84,526,528,1.0,0.003787878787878788,0.9962121212121212,310,0.2537878787878788,0.1590909090909091,0.5871212121212122
5049,3890006,285,1,43,31,284,285,1.0,0.0035087719298245615,0.9964912280701754,211,0.15087719298245614,0.10877192982456141,0.7403508771929824
5050,3890007,941,3,172,202,938,941,1.0,0.003188097768331562,0.9968119022316685,567,0.18278427205100956,0.2146652497343252,0.6025504782146652
5051,3890008,804,5,101,75,799,804,1.0,0.006218905472636816,0.9937810945273632,628,0.1256218905472637,0.09328358208955224,0.7810945273631841
5052,3890010,1196,13,195,147,1183,1196,1.0,0.010869565217391304,0.9891304347826086,854,0.16304347826086957,0.12290969899665552,0.7140468227424749
5053,3890011,662,20,255,65,642,662,1.0,0.030211480362537766,0.9697885196374623,342,0.3851963746223565,0.09818731117824774,0.5166163141993958
5054,3890012,1047,55,150,191,992,1047,1.0,0.05253104106972302,0.9474689589302769,706,0.14326647564469913,0.18242597898758356,0.6743075453677173
5055,3910001,635,97,112,107,538,635,1.0,0.15275590551181104,0.8472440944881889,416,0.1763779527559055,0.16850393700787403,0.6551181102362205
5056,3910002,897,33,114,404,864,897,1.0,0.03678929765886288,0.9632107023411371,379,0.12709030100334448,0.4503901895206243,0.42251950947603123
5057,3910003,758,43,109,322,715,758,1.0,0.05672823218997362,0.9432717678100264,327,0.1437994722955145,0.42480211081794195,0.4313984168865435
5058,3910004,708,83,166,55,625,708,1.0,0.1172316384180791,0.882768361581921,487,0.2344632768361582,0.07768361581920905,0.6878531073446328
5059,391001A,688,26,164,105,662,688,1.0,0.0377906976744186,0.9622093023255814,419,0.23837209302325582,0.15261627906976744,0.6090116279069767
5060,391002A,181,7,19,95,174,181,1.0,0.03867403314917127,0.9613259668508287,67,0.10497237569060773,0.5248618784530387,0.3701657458563536
5061,391002B,274,11,58,129,263,274,1.0,0.040145985401459854,0.9598540145985401,87,0.2116788321167883,0.4708029197080292,0.3175182481751825
5062,391003A,712,31,111,298,681,712,1.0,0.04353932584269663,0.9564606741573034,303,0.15589887640449437,0.41853932584269665,0.425561797752809
5063,391004A,451,2,101,93,449,451,1.0,0.004434589800443459,0.9955654101995566,257,0.22394678492239467,0.20620842572062084,0.5698447893569845
5064,391004B,168,0,44,55,168,168,1.0,0.0,1.0,69,0.2619047619047619,0.3273809523809524,0.4107142857142857
5065,3930001,142,0,9,114,142,142,1.0,0.0,1.0,19,0.06338028169014084,0.8028169014084507,0.13380281690140844
5066,3930002,144,0,3,113,144,144,1.0,0.0,1.0,28,0.020833333333333332,0.7847222222222222,0.19444444444444445
5067,3930003,148,0,8,99,148,148,1.0,0.0,1.0,41,0.05405405405405406,0.668918918918919,0.27702702702702703
5068,39304-1,102,0,5,74,102,102,1.0,0.0,1.0,23,0.049019607843137254,0.7254901960784313,0.22549019607843138
5069,39304-2,77,0,8,68,77,77,1.0,0.0,1.0,1,0.1038961038961039,0.8831168831168831,0.012987012987012988
5070,3950001,1329,437,490,386,892,1329,1.0,0.3288186606471031,0.6711813393528969,453,0.3686982693754703,0.290443942814146,0.34085778781038373
5071,3950002,1402,322,449,478,1080,1402,1.0,0.2296718972895863,0.7703281027104137,475,0.3202567760342368,0.340941512125535,0.3388017118402282
5072,3950003,499,42,73,322,457,499,1.0,0.0841683366733467,0.9158316633266533,104,0.1462925851703407,0.6452905811623246,0.20841683366733466
5073,3950004,419,0,41,287,419,419,1.0,0.0,1.0,91,0.09785202863961814,0.684964200477327,0.2171837708830549
5074,3950005,1519,307,289,731,1212,1519,1.0,0.20210664911125742,0.7978933508887426,499,0.1902567478604345,0.48123765635286375,0.3285055957867018
5075,3950006,1784,274,225,733,1510,1784,1.0,0.15358744394618834,0.8464125560538116,826,0.12612107623318386,0.4108744394618834,0.46300448430493274
5076,3950007,148,6,29,31,142,148,1.0,0.04054054054054054,0.9594594594594594,88,0.19594594594594594,0.20945945945945946,0.5945945945945946
5077,3950008,186,0,26,141,186,186,1.0,0.0,1.0,19,0.13978494623655913,0.7580645161290323,0.10215053763440861
5078,3950011,1265,66,145,496,1199,1265,1.0,0.05217391304347826,0.9478260869565217,624,0.11462450592885376,0.39209486166007906,0.4932806324110672
5079,3950013,161,3,14,92,158,161,1.0,0.018633540372670808,0.9813664596273292,55,0.08695652173913043,0.5714285714285714,0.3416149068322981
5080,3950016,239,4,15,96,235,239,1.0,0.016736401673640166,0.9832635983263598,128,0.06276150627615062,0.401673640167364,0.5355648535564853
5081,3950018,90,0,13,43,90,90,1.0,0.0,1.0,34,0.14444444444444443,0.4777777777777778,0.37777777777777777
5082,3950019,887,21,48,332,866,887,1.0,0.02367531003382187,0.9763246899661782,507,0.05411499436302142,0.3742953776775648,0.5715896279594137
5083,3950022,1329,761,663,94,568,1329,1.0,0.5726109857035365,0.42738901429646353,572,0.49887133182844245,0.07072987208427389,0.43039879608728365
5084,3950023,825,116,278,157,709,825,1.0,0.1406060606060606,0.8593939393939394,390,0.336969696969697,0.1903030303030303,0.4727272727272727
5085,3970002,4203,25,660,2262,4178,4203,1.0,0.005948132286462051,0.9940518677135379,1281,0.15703069236259815,0.5381870092790864,0.3047822983583155
5086,3970003,1525,165,165,162,1360,1525,1.0,0.10819672131147541,0.8918032786885246,1198,0.10819672131147541,0.1062295081967213,0.7855737704918033
5087,3970004,3160,146,325,1266,3014,3160,1.0,0.046202531645569624,0.9537974683544304,1569,0.10284810126582279,0.4006329113924051,0.49651898734177213
5088,397001B,4371,106,498,2187,4265,4371,1.0,0.024250743536948068,0.9757492564630519,1686,0.11393273850377487,0.5003431708991077,0.3857240905971174
5089,397001C,3397,91,442,1979,3306,3397,1.0,0.026788342655284073,0.9732116573447159,976,0.13011480718280835,0.5825728584044746,0.2873123344127171
5090,397002A,4458,164,763,2359,4294,4458,1.0,0.036787797218483624,0.9632122027815164,1336,0.1711529834006281,0.5291610587707493,0.2996859578286227
5091,397002B,2228,216,327,844,2012,2228,1.0,0.09694793536804308,0.9030520646319569,1057,0.14676840215439857,0.37881508078994613,0.4744165170556553
5092,397002C,5036,36,507,2496,5000,5036,1.0,0.007148530579825258,0.9928514694201748,2033,0.10067513899920572,0.49563145353455124,0.40369340746624305
5093,397003A,1700,200,347,486,1500,1700,1.0,0.11764705882352941,0.8823529411764706,867,0.20411764705882354,0.2858823529411765,0.51
5094,397003B,3435,945,710,1304,2490,3435,1.0,0.27510917030567683,0.7248908296943232,1421,0.2066957787481805,0.37962154294032024,0.4136826783114993
5095,397003C,2264,11,208,1425,2253,2264,1.0,0.004858657243816254,0.9951413427561837,631,0.09187279151943463,0.6294169611307421,0.2787102473498233
5096,397003D,5004,119,485,2270,4885,5004,1.0,0.02378097521982414,0.9762190247801759,2249,0.0969224620303757,0.4536370903277378,0.4494404476418865
5097,397004A,6282,187,696,2126,6095,6282,1.0,0.02976758993950971,0.9702324100604903,3460,0.11079274116523401,0.3384272524673671,0.5507800063673989
5098,397004B,2720,545,228,638,2175,2720,1.0,0.20036764705882354,0.7996323529411765,1854,0.0838235294117647,0.23455882352941176,0.6816176470588236
5099,397004C,4994,332,442,1224,4662,4994,1.0,0.06647977573087706,0.933520224269123,3328,0.08850620744893872,0.24509411293552263,0.6663996796155387
5100,3990001,1851,62,122,588,1789,1851,1.0,0.03349540788762831,0.9665045921123717,1141,0.06591031874662345,0.31766612641815234,0.6164235548352242
5101,3990002,167,6,10,50,161,167,1.0,0.03592814371257485,0.9640718562874252,107,0.059880239520958084,0.2994011976047904,0.6407185628742516
5102,3990003,1816,31,129,682,1785,1816,1.0,0.017070484581497798,0.9829295154185022,1005,0.0710352422907489,0.3755506607929515,0.5534140969162996
5103,3990004A,532,8,47,224,524,532,1.0,0.015037593984962405,0.9849624060150376,261,0.08834586466165413,0.42105263157894735,0.4906015037593985
5104,3990004B,49,0,3,16,49,49,1.0,0.0,1.0,30,0.061224489795918366,0.32653061224489793,0.6122448979591837
5105,3990005,186,0,11,83,186,186,1.0,0.0,1.0,92,0.05913978494623656,0.44623655913978494,0.4946236559139785
5106,3990006,153,0,12,62,153,153,1.0,0.0,1.0,79,0.0784313725490196,0.40522875816993464,0.5163398692810458
5107,3990007,933,25,67,450,908,933,1.0,0.02679528403001072,0.9732047159699893,416,0.07181136120042872,0.48231511254019294,0.44587352625937837
5108,3990008,683,31,52,344,652,683,1.0,0.04538799414348463,0.9546120058565154,287,0.07613469985358712,0.5036603221083455,0.42020497803806733
5109,3990009,883,0,45,362,883,883,1.0,0.0,1.0,476,0.05096262740656852,0.4099660249150623,0.5390713476783692
5110,3990010,364,0,21,243,364,364,1.0,0.0,1.0,100,0.057692307692307696,0.6675824175824175,0.27472527472527475
5111,4010111,2749,798,118,423,1951,2749,1.0,0.29028737722808295,0.709712622771917,2208,0.04292469989086941,0.15387413604947253,0.803201164059658
5112,4010112,3369,430,214,943,2939,3369,1.0,0.12763431285247848,0.8723656871475215,2212,0.06352033244286139,0.2799050163253191,0.6565746512318196
5113,4010113,3639,474,346,1416,3165,3639,1.0,0.1302555647155812,0.8697444352844188,1877,0.09508106622698544,0.3891178895300907,0.5158010442429238
5114,4010114,1611,274,164,725,1337,1611,1.0,0.17008069522036,0.8299193047796399,722,0.10180012414649287,0.4500310366232154,0.44816883923029177
5115,4010201,3213,696,123,517,2517,3213,1.0,0.2166199813258637,0.7833800186741363,2573,0.03828197945845005,0.1609088079676315,0.8008092125739185
5116,4010212,987,223,100,449,764,987,1.0,0.2259371833839919,0.7740628166160081,438,0.10131712259371833,0.45491388044579534,0.44376899696048633
5117,4010213,2542,383,244,931,2159,2542,1.0,0.15066876475216365,0.8493312352478364,1367,0.0959874114870181,0.3662470495672699,0.537765538945712
5118,4010214,2170,278,410,1123,1892,2170,1.0,0.12811059907834102,0.871889400921659,637,0.1889400921658986,0.5175115207373272,0.29354838709677417
5119,4010215,2224,354,352,925,1870,2224,1.0,0.1591726618705036,0.8408273381294964,947,0.15827338129496402,0.4159172661870504,0.42580935251798563
5120,4010302,1139,526,329,324,613,1139,1.0,0.4618086040386304,0.5381913959613697,486,0.28884986830553117,0.2844600526777875,0.4266900790166813
5121,4010303,2476,657,474,441,1819,2476,1.0,0.26534733441033925,0.7346526655896607,1561,0.19143780290791598,0.1781098546042003,0.6304523424878837
5122,4010314A,1042,217,77,513,825,1042,1.0,0.20825335892514396,0.791746641074856,452,0.07389635316698656,0.4923224568138196,0.43378119001919385
5123,4010314B,165,8,7,43,157,165,1.0,0.048484848484848485,0.9515151515151515,115,0.04242424242424243,0.2606060606060606,0.696969696969697
5124,4010315,892,33,51,459,859,892,1.0,0.03699551569506727,0.9630044843049327,382,0.05717488789237668,0.5145739910313901,0.4282511210762332
5125,4010316,530,21,34,238,509,530,1.0,0.03962264150943396,0.960377358490566,258,0.06415094339622641,0.4490566037735849,0.4867924528301887
5126,4010317,804,328,199,188,476,804,1.0,0.4079601990049751,0.5920398009950248,417,0.24751243781094528,0.23383084577114427,0.5186567164179104
5127,4010318,1086,166,164,539,920,1086,1.0,0.15285451197053407,0.8471454880294659,383,0.15101289134438306,0.496316758747698,0.35267034990791896
5128,4010319,414,172,144,115,242,414,1.0,0.41545893719806765,0.5845410628019324,155,0.34782608695652173,0.2777777777777778,0.3743961352657005
5129,4010404,1594,229,176,966,1365,1594,1.0,0.14366373902132998,0.85633626097867,452,0.11041405269761606,0.6060225846925973,0.2835633626097867
5130,4010405,1008,88,149,662,920,1008,1.0,0.0873015873015873,0.9126984126984127,197,0.14781746031746032,0.6567460317460317,0.19543650793650794
5131,4010416,1149,199,92,457,950,1149,1.0,0.1731940818102698,0.8268059181897301,600,0.08006962576153177,0.3977371627502176,0.5221932114882507
5132,4010417,1658,319,206,571,1339,1658,1.0,0.19240048250904704,0.8075995174909529,881,0.12424607961399277,0.34439083232810613,0.5313630880579011
5133,4010418,2285,532,278,956,1753,2285,1.0,0.23282275711159736,0.7671772428884026,1051,0.12166301969365427,0.41838074398249453,0.4599562363238512
5134,4030001,2281,175,182,1029,2106,2281,1.0,0.07672073651907059,0.9232792634809294,1070,0.0797895659798334,0.451117930732135,0.4690925032880316
5135,4030002,1401,42,144,760,1359,1401,1.0,0.029978586723768737,0.9700214132762313,497,0.10278372591006424,0.5424696645253391,0.3547466095645967
5136,4030003,608,91,100,196,517,608,1.0,0.14967105263157895,0.850328947368421,312,0.16447368421052633,0.3223684210526316,0.5131578947368421
5137,4030004,302,52,18,103,250,302,1.0,0.17218543046357615,0.8278145695364238,181,0.059602649006622516,0.34105960264900664,0.5993377483443708
5138,4030005,1444,34,68,579,1410,1444,1.0,0.023545706371191136,0.9764542936288089,797,0.04709141274238227,0.4009695290858726,0.5519390581717452
5139,4030006,1869,198,190,847,1671,1869,1.0,0.10593900481540931,0.8940609951845907,832,0.10165864098448368,0.45318352059925093,0.4451578384162654
5140,4030007,157,20,75,35,137,157,1.0,0.12738853503184713,0.8726114649681529,47,0.47770700636942676,0.2229299363057325,0.29936305732484075
5141,4030008,375,3,30,178,372,375,1.0,0.008,0.992,167,0.08,0.4746666666666667,0.44533333333333336
5142,4050001,1343,413,328,494,930,1343,1.0,0.3075204765450484,0.6924795234549516,521,0.24422933730454208,0.3678332092330603,0.3879374534623976
5143,4050002,308,112,123,113,196,308,1.0,0.36363636363636365,0.6363636363636364,72,0.39935064935064934,0.36688311688311687,0.23376623376623376
5144,4050003,405,122,49,95,283,405,1.0,0.3012345679012346,0.6987654320987654,261,0.12098765432098765,0.2345679012345679,0.6444444444444445
5145,4050004,412,148,74,189,264,412,1.0,0.3592233009708738,0.6407766990291263,149,0.1796116504854369,0.4587378640776699,0.3616504854368932
5146,4050005,426,63,54,217,363,426,1.0,0.14788732394366197,0.852112676056338,155,0.1267605633802817,0.5093896713615024,0.36384976525821594
5147,4050006,349,39,24,161,310,349,1.0,0.11174785100286533,0.8882521489971347,164,0.06876790830945559,0.46131805157593125,0.4699140401146132
5148,4050007,362,31,50,186,331,362,1.0,0.0856353591160221,0.914364640883978,126,0.13812154696132597,0.5138121546961326,0.34806629834254144
5149,4050008,958,7,63,380,951,958,1.0,0.007306889352818371,0.9926931106471816,515,0.06576200417536535,0.3966597077244259,0.5375782881002088
5150,4050009,979,19,79,432,960,979,1.0,0.01940755873340143,0.9805924412665986,468,0.08069458631256383,0.44126659856996936,0.4780388151174668
5151,4050010,497,40,42,197,457,497,1.0,0.08048289738430583,0.9195171026156942,258,0.08450704225352113,0.3963782696177062,0.5191146881287726
5152,4050011,400,385,307,5,15,400,1.0,0.9625,0.0375,88,0.7675,0.0125,0.22
5153,4070001,3059,379,443,1107,2680,3059,1.0,0.12389669826740765,0.8761033017325923,1509,0.14481856815952926,0.36188296829029093,0.4932984635501798
5154,4070002,5252,481,467,1298,4771,5252,1.0,0.09158415841584158,0.9084158415841584,3487,0.08891850723533892,0.24714394516374713,0.663937547600914
5155,4070003,1533,397,201,459,1136,1533,1.0,0.25896934116112197,0.741030658838878,873,0.13111545988258316,0.299412915851272,0.5694716242661448
5156,4070004,703,45,32,392,658,703,1.0,0.06401137980085349,0.9359886201991465,279,0.04551920341394026,0.5576102418207681,0.3968705547652916
5157,4070005,3073,517,172,845,2556,3073,1.0,0.16823950536934593,0.831760494630654,2056,0.05597136348844777,0.27497559388219983,0.6690530426293524
5158,4070006,2293,241,250,931,2052,2293,1.0,0.10510248582642825,0.8948975141735718,1112,0.10902747492368077,0.4060183166157872,0.48495420846053205
5159,4070007,1832,121,396,833,1711,1832,1.0,0.06604803493449782,0.9339519650655022,603,0.21615720524017468,0.4546943231441048,0.32914847161572053
5160,4070008,1050,53,167,430,997,1050,1.0,0.05047619047619047,0.9495238095238095,453,0.15904761904761905,0.4095238095238095,0.43142857142857144
5161,4070010,597,21,79,299,576,597,1.0,0.035175879396984924,0.964824120603015,219,0.1323283082077052,0.5008375209380235,0.36683417085427134
5162,4070013,702,0,55,271,702,702,1.0,0.0,1.0,376,0.07834757834757834,0.38603988603988604,0.5356125356125356
5163,4070014,689,99,148,242,590,689,1.0,0.14368650217706821,0.8563134978229318,299,0.21480406386066764,0.35123367198838895,0.4339622641509434
5164,4090101,406,0,114,139,406,406,1.0,0.0,1.0,153,0.28078817733990147,0.34236453201970446,0.3768472906403941
5165,4090102,2713,9,597,578,2704,2713,1.0,0.003317360855141909,0.9966826391448581,1538,0.22005160339108,0.21304828603022485,0.5669001105786952
5166,4090103,399,0,43,177,399,399,1.0,0.0,1.0,179,0.10776942355889724,0.44360902255639095,0.44862155388471175
5167,4090104,1620,8,275,356,1612,1620,1.0,0.0049382716049382715,0.9950617283950617,989,0.1697530864197531,0.21975308641975308,0.6104938271604938
5168,4090105,2190,6,683,204,2184,2190,1.0,0.0027397260273972603,0.9972602739726028,1303,0.31187214611872144,0.09315068493150686,0.5949771689497717
5169,4090106,2027,65,279,375,1962,2027,1.0,0.03206709422792304,0.9679329057720769,1373,0.13764183522446966,0.185002466699556,0.6773556980759744
5170,4090107,268,0,41,80,268,268,1.0,0.0,1.0,147,0.15298507462686567,0.29850746268656714,0.5485074626865671
5171,4090108,4764,54,541,1497,4710,4764,1.0,0.011335012594458438,0.9886649874055415,2726,0.1135600335852225,0.3142317380352645,0.572208228379513
5172,4090109,3741,177,425,919,3564,3741,1.0,0.04731355252606255,0.9526864474739375,2397,0.1136059877038225,0.24565624164661856,0.640737770649559
5173,4090110,2193,42,369,492,2151,2193,1.0,0.019151846785225718,0.9808481532147743,1332,0.16826265389876882,0.2243502051983584,0.6073871409028728
5174,4090111,37,0,7,25,37,37,1.0,0.0,1.0,5,0.1891891891891892,0.6756756756756757,0.13513513513513514
5175,4090112,1266,4,436,92,1262,1266,1.0,0.00315955766192733,0.9968404423380727,738,0.344391785150079,0.07266982622432859,0.5829383886255924
5176,4090113,1407,3,404,131,1404,1407,1.0,0.0021321961620469083,0.997867803837953,872,0.287135749822317,0.09310589907604833,0.6197583511016347
5177,4090114,2219,34,253,663,2185,2219,1.0,0.015322217214961695,0.9846777827850383,1303,0.11401532221721496,0.298783235691753,0.587201442091032
5178,4090115,5255,88,483,1293,5167,5255,1.0,0.016745956232159846,0.9832540437678402,3479,0.09191246431969553,0.2460513796384396,0.6620361560418649
5179,4090116,3053,36,442,1910,3017,3053,1.0,0.011791680314444808,0.9882083196855552,701,0.14477563052735015,0.6256141500163773,0.22961021945627252
5180,4090117,825,0,99,182,825,825,1.0,0.0,1.0,544,0.12,0.2206060606060606,0.6593939393939394
5181,4090118,2421,22,725,297,2399,2421,1.0,0.009087154068566708,0.9909128459314333,1399,0.29946303180503925,0.12267657992565056,0.5778603882693102
5182,4090119,1335,0,193,569,1335,1335,1.0,0.0,1.0,573,0.1445692883895131,0.42621722846441945,0.42921348314606744
5183,4090120,844,3,89,293,841,844,1.0,0.0035545023696682463,0.9964454976303317,462,0.10545023696682465,0.3471563981042654,0.54739336492891
5184,4090121,2529,52,329,767,2477,2529,1.0,0.02056148675365757,0.9794385132463425,1433,0.13009094503756424,0.3032819296164492,0.5666271253459866
5185,4090122,944,0,134,272,944,944,1.0,0.0,1.0,538,0.1419491525423729,0.288135593220339,0.5699152542372882
5186,4090123,131,0,17,38,131,131,1.0,0.0,1.0,76,0.1297709923664122,0.2900763358778626,0.5801526717557252
5187,4090124,3705,96,866,644,3609,3705,1.0,0.025910931174089068,0.974089068825911,2195,0.23373819163292847,0.1738191632928475,0.5924426450742241
5188,4090125,42,0,12,12,42,42,1.0,0.0,1.0,18,0.2857142857142857,0.2857142857142857,0.42857142857142855
5189,4110001,937,3,76,500,934,937,1.0,0.0032017075773745998,0.9967982924226254,361,0.08110992529348986,0.5336179295624333,0.3852721451440768
5190,411002A,705,0,51,322,705,705,1.0,0.0,1.0,332,0.07234042553191489,0.45673758865248226,0.47092198581560285
5191,411002B,448,8,27,164,440,448,1.0,0.017857142857142856,0.9821428571428571,257,0.060267857142857144,0.36607142857142855,0.5736607142857143
5192,411003A,494,31,53,215,463,494,1.0,0.06275303643724696,0.937246963562753,226,0.10728744939271255,0.4352226720647773,0.4574898785425101
5193,411003B,296,6,54,194,290,296,1.0,0.02027027027027027,0.9797297297297297,48,0.18243243243243243,0.6554054054054054,0.16216216216216217
5194,411004A,1207,72,53,441,1135,1207,1.0,0.05965202982601491,0.9403479701739851,713,0.043910521955260975,0.36536868268434136,0.5907207953603977
5195,411004B,159,11,9,69,148,159,1.0,0.06918238993710692,0.9308176100628931,81,0.05660377358490566,0.4339622641509434,0.5094339622641509
5196,4130001,561,2,64,249,559,561,1.0,0.0035650623885918,0.9964349376114082,248,0.1140819964349376,0.44385026737967914,0.44206773618538325
5197,4130002,547,1,63,182,546,547,1.0,0.0018281535648994515,0.9981718464351006,302,0.11517367458866545,0.3327239488117002,0.5521023765996343
5198,4130003,350,0,40,60,350,350,1.0,0.0,1.0,250,0.11428571428571428,0.17142857142857143,0.7142857142857143
5199,4130004,552,2,54,296,550,552,1.0,0.0036231884057971015,0.9963768115942029,202,0.09782608695652174,0.5362318840579711,0.36594202898550726
5200,4150005,107,0,16,56,107,107,1.0,0.0,1.0,35,0.14953271028037382,0.5233644859813084,0.32710280373831774
5201,4150006,289,1,18,148,288,289,1.0,0.0034602076124567475,0.9965397923875432,123,0.06228373702422145,0.5121107266435986,0.42560553633217996
5202,4150007,2360,28,178,1121,2332,2360,1.0,0.011864406779661017,0.988135593220339,1061,0.07542372881355933,0.475,0.44957627118644067
5203,4150008,1344,0,62,476,1344,1344,1.0,0.0,1.0,806,0.046130952380952384,0.3541666666666667,0.5997023809523809
5204,4150009,469,14,22,275,455,469,1.0,0.029850746268656716,0.9701492537313433,172,0.046908315565031986,0.5863539445628998,0.36673773987206826
5205,4150010,1353,89,76,635,1264,1353,1.0,0.06577974870657798,0.934220251293422,642,0.05617147080561715,0.4693274205469327,0.4745011086474501
5206,4150011,134,18,16,89,116,134,1.0,0.13432835820895522,0.8656716417910447,29,0.11940298507462686,0.664179104477612,0.21641791044776118
5207,4150012,1928,113,162,551,1815,1928,1.0,0.058609958506224066,0.9413900414937759,1215,0.08402489626556017,0.2857883817427386,0.6301867219917012
5208,4150013,570,0,54,226,570,570,1.0,0.0,1.0,290,0.09473684210526316,0.39649122807017545,0.5087719298245614
5209,4150014,1315,187,20,62,1128,1315,1.0,0.14220532319391635,0.8577946768060837,1233,0.015209125475285171,0.04714828897338403,0.9376425855513308
5210,4150015,2510,234,214,485,2276,2510,1.0,0.09322709163346614,0.9067729083665339,1811,0.08525896414342629,0.19322709163346613,0.7215139442231076
5211,4170101,610,2,45,283,608,610,1.0,0.003278688524590164,0.9967213114754099,282,0.07377049180327869,0.4639344262295082,0.46229508196721314
5212,4170202,567,0,22,316,567,567,1.0,0.0,1.0,229,0.03880070546737213,0.5573192239858906,0.4038800705467372
5213,4170303,406,0,19,137,406,406,1.0,0.0,1.0,250,0.046798029556650245,0.3374384236453202,0.6157635467980296
5214,4170307,299,1,8,178,298,299,1.0,0.0033444816053511705,0.9966555183946488,113,0.026755852842809364,0.5953177257525084,0.3779264214046823
5215,4170404,51,0,0,21,51,51,1.0,0.0,1.0,30,0.0,0.4117647058823529,0.5882352941176471
5216,4170405,327,0,19,138,327,327,1.0,0.0,1.0,170,0.0581039755351682,0.42201834862385323,0.5198776758409785
5217,4170406A,218,0,18,143,218,218,1.0,0.0,1.0,57,0.08256880733944955,0.6559633027522935,0.26146788990825687
5218,4170406B,3,0,0,2,3,3,1.0,0.0,1.0,1,0.0,0.6666666666666666,0.3333333333333333
5219,4190002,1162,27,64,438,1135,1162,1.0,0.02323580034423408,0.9767641996557659,660,0.055077452667814115,0.3769363166953528,0.5679862306368331
5220,4190003,330,34,15,174,296,330,1.0,0.10303030303030303,0.896969696969697,141,0.045454545454545456,0.5272727272727272,0.42727272727272725
5221,4190004,1272,302,122,357,970,1272,1.0,0.23742138364779874,0.7625786163522013,793,0.0959119496855346,0.2806603773584906,0.6234276729559748
5222,4190005,1979,179,161,1077,1800,1979,1.0,0.09044972208185953,0.9095502779181405,741,0.08135421930267812,0.5442142496210207,0.37443153107630117
5223,4190006,547,133,67,271,414,547,1.0,0.24314442413162707,0.7568555758683729,209,0.12248628884826325,0.4954296160877514,0.3820840950639854
5224,4190007,623,153,180,343,470,623,1.0,0.24558587479935795,0.7544141252006421,100,0.28892455858747995,0.550561797752809,0.16051364365971107
5225,4190008,1529,428,234,441,1101,1529,1.0,0.27992151733158926,0.7200784826684107,854,0.15304120340091562,0.2884238064094179,0.5585349901896665
5226,419001N,1510,214,172,696,1296,1510,1.0,0.14172185430463577,0.8582781456953642,642,0.11390728476821192,0.4609271523178808,0.4251655629139073
5227,419001S,2023,477,267,829,1546,2023,1.0,0.23578843302026692,0.764211566979733,927,0.13198220464656452,0.4097874443895205,0.45823035096391496
5228,419001W,508,0,40,201,508,508,1.0,0.0,1.0,267,0.07874015748031496,0.3956692913385827,0.5255905511811023
5229,419009N,1264,237,183,511,1027,1264,1.0,0.1875,0.8125,570,0.14477848101265822,0.40427215189873417,0.4509493670886076
5230,419009S,1059,315,123,488,744,1059,1.0,0.29745042492917845,0.7025495750708215,448,0.11614730878186968,0.46081208687440983,0.4230406043437205
5231,41901SE,1514,711,576,351,803,1514,1.0,0.46961690885072654,0.5303830911492734,587,0.380449141347424,0.23183619550858653,0.38771466314398945
5232,41901SW,1474,117,118,702,1357,1474,1.0,0.07937584803256445,0.9206241519674355,654,0.08005427408412483,0.4762550881953867,0.44369063772048845
5233,4210101,123,0,5,47,123,123,1.0,0.0,1.0,71,0.04065040650406504,0.3821138211382114,0.5772357723577236
5234,4210102,364,3,25,143,361,364,1.0,0.008241758241758242,0.9917582417582418,196,0.06868131868131869,0.39285714285714285,0.5384615384615384
5235,4210201,326,3,26,102,323,326,1.0,0.009202453987730062,0.99079754601227,198,0.07975460122699386,0.3128834355828221,0.6073619631901841
5236,4210202,158,0,3,74,158,158,1.0,0.0,1.0,81,0.0189873417721519,0.46835443037974683,0.5126582278481012
5237,4210301,182,1,12,86,181,182,1.0,0.005494505494505495,0.9945054945054945,84,0.06593406593406594,0.4725274725274725,0.46153846153846156
5238,4210302,368,0,15,146,368,368,1.0,0.0,1.0,207,0.04076086956521739,0.3967391304347826,0.5625
5239,4210401,508,2,35,310,506,508,1.0,0.003937007874015748,0.9960629921259843,163,0.0688976377952756,0.610236220472441,0.32086614173228345
5240,4230001,703,179,115,89,524,703,1.0,0.2546230440967283,0.7453769559032717,499,0.16358463726884778,0.12660028449502134,0.7098150782361309
5241,4230002,911,293,236,63,618,911,1.0,0.3216245883644347,0.6783754116355654,612,0.25905598243688255,0.06915477497255763,0.6717892425905598
5242,4230003,2848,166,295,1347,2682,2848,1.0,0.05828651685393258,0.9417134831460674,1206,0.1035814606741573,0.4729634831460674,0.4234550561797753
5243,4230004,2650,428,387,469,2222,2650,1.0,0.16150943396226414,0.8384905660377359,1794,0.1460377358490566,0.1769811320754717,0.6769811320754717
5244,4230005,4285,275,346,1948,4010,4285,1.0,0.06417736289381563,0.9358226371061844,1991,0.0807467911318553,0.45460910151691947,0.4646441073512252
5245,4230006,1100,180,111,473,920,1100,1.0,0.16363636363636364,0.8363636363636363,516,0.1009090909090909,0.43,0.4690909090909091
5246,4230007,1671,292,237,738,1379,1671,1.0,0.17474566128067026,0.8252543387193297,696,0.14183123877917414,0.44165170556552963,0.41651705565529623
5247,4230008,1712,125,204,589,1587,1712,1.0,0.07301401869158879,0.9269859813084113,919,0.1191588785046729,0.34404205607476634,0.5367990654205608
5248,4230009,469,190,82,53,279,469,1.0,0.4051172707889126,0.5948827292110874,334,0.17484008528784648,0.11300639658848614,0.7121535181236673
5249,4230010,4595,1581,999,715,3014,4595,1.0,0.344069640914037,0.655930359085963,2881,0.21741022850924918,0.15560391730141457,0.6269858541893363
5250,4230011,3335,1900,737,93,1435,3335,1.0,0.5697151424287856,0.4302848575712144,2505,0.22098950524737632,0.027886056971514243,0.7511244377811095
5251,4230012,1889,857,770,102,1032,1889,1.0,0.4536791953414505,0.5463208046585495,1017,0.4076230809952356,0.05399682371625199,0.5383800952885125
5252,4230013,1888,1656,885,22,232,1888,1.0,0.8771186440677966,0.1228813559322034,981,0.46875,0.011652542372881356,0.5195974576271186
5253,4230014,1818,575,294,466,1243,1818,1.0,0.3162816281628163,0.6837183718371838,1058,0.1617161716171617,0.2563256325632563,0.581958195819582
5254,4230015,4419,126,271,2585,4293,4419,1.0,0.028513238289205704,0.9714867617107943,1563,0.061326091875990044,0.5849739760126725,0.35369993211133743
5255,4230016,2225,1168,643,76,1057,2225,1.0,0.5249438202247191,0.4750561797752809,1506,0.28898876404494384,0.03415730337078652,0.6768539325842696
5256,4230017,946,46,85,482,900,946,1.0,0.048625792811839326,0.9513742071881607,379,0.08985200845665962,0.5095137420718816,0.40063424947145876
5257,4230018,1550,1188,717,24,362,1550,1.0,0.7664516129032258,0.2335483870967742,809,0.4625806451612903,0.015483870967741935,0.5219354838709678
5258,4230019,5681,376,381,2263,5305,5681,1.0,0.06618553071642316,0.9338144692835768,3037,0.06706565745467347,0.3983453617320894,0.5345889808132371
5259,4230020,1019,305,119,82,714,1019,1.0,0.29931305201177627,0.7006869479882237,818,0.11678115799803729,0.08047105004906771,0.802747791952895
5260,4230021,1575,71,196,924,1504,1575,1.0,0.04507936507936508,0.954920634920635,455,0.12444444444444444,0.5866666666666667,0.28888888888888886
5261,4230022,1423,478,71,70,945,1423,1.0,0.3359100491918482,0.6640899508081518,1282,0.049894588896697116,0.049191848208011243,0.9009135628952917
5262,4230023,2527,255,348,1284,2272,2527,1.0,0.10091017016224772,0.8990898298377523,895,0.13771270280965572,0.5081123862287297,0.3541749109616146
5263,4230025,2336,161,230,1273,2175,2336,1.0,0.06892123287671233,0.9310787671232876,833,0.09845890410958905,0.5449486301369864,0.3565924657534247
5264,4230026,3140,461,231,1294,2679,3140,1.0,0.14681528662420382,0.8531847133757962,1615,0.07356687898089172,0.4121019108280255,0.5143312101910829
5265,4230027,2351,219,253,777,2132,2351,1.0,0.0931518502764781,0.9068481497235219,1321,0.10761378136962994,0.3304976605699702,0.5618885580603998
5266,4230028,3778,179,343,1893,3599,3778,1.0,0.04737956590788777,0.9526204340921123,1542,0.09078877713075702,0.5010587612493382,0.4081524616199047
5267,4230029,2115,508,304,844,1607,2115,1.0,0.2401891252955083,0.7598108747044917,967,0.14373522458628843,0.39905437352245865,0.45721040189125295
5268,4230030,5262,92,328,2512,5170,5262,1.0,0.017483846446218167,0.9825161535537819,2422,0.06233371341695173,0.4773850247054352,0.4602812618776131
5269,4230031,3639,201,214,1795,3438,3639,1.0,0.055234954657873044,0.9447650453421269,1630,0.05880736466062105,0.4932673811486672,0.4479252541907117
5270,4230032,2998,360,310,1409,2638,2998,1.0,0.12008005336891261,0.8799199466310874,1279,0.10340226817878585,0.46997998665777185,0.4266177451634423
5271,4230034,1053,439,535,150,614,1053,1.0,0.41690408357075026,0.5830959164292497,368,0.5080721747388414,0.14245014245014245,0.34947768281101615
5272,4230035,2861,1121,774,486,1740,2861,1.0,0.3918210415938483,0.6081789584061517,1601,0.270534778049633,0.16987067458930444,0.5595945473610625
5273,4230036,4095,2025,1157,302,2070,4095,1.0,0.4945054945054945,0.5054945054945055,2636,0.28253968253968254,0.07374847374847375,0.6437118437118438
5274,4230037,1437,52,65,377,1385,1437,1.0,0.03618649965205289,0.9638135003479471,995,0.04523312456506611,0.26235212247738343,0.6924147529575505
5275,4230038,3776,760,330,1077,3016,3776,1.0,0.20127118644067796,0.798728813559322,2369,0.08739406779661017,0.2852224576271186,0.6273834745762712
5276,4230039,357,75,103,52,282,357,1.0,0.21008403361344538,0.7899159663865546,202,0.28851540616246496,0.14565826330532214,0.5658263305322129
5277,4230040,4269,278,419,2599,3991,4269,1.0,0.06512063715155775,0.9348793628484423,1251,0.09814944951979386,0.6088076832981963,0.29304286718200984
5278,4230041,3598,479,266,1565,3119,3598,1.0,0.1331295163979989,0.8668704836020011,1767,0.07392996108949416,0.4349638688160089,0.4911061700944969
5279,4230042,3908,389,396,1998,3519,3908,1.0,0.09953940634595701,0.900460593654043,1514,0.10133060388945753,0.5112589559877175,0.387410440122825
5280,4230043,818,75,151,432,743,818,1.0,0.09168704156479218,0.9083129584352079,235,0.1845965770171149,0.5281173594132029,0.28728606356968217
5281,4230044,4213,872,729,1316,3341,4213,1.0,0.20697840018988845,0.7930215998101116,2168,0.17303584144315215,0.3123664846902445,0.5145976738666034
5282,4230045,1196,18,77,723,1178,1196,1.0,0.015050167224080268,0.9849498327759197,396,0.06438127090301003,0.6045150501672241,0.3311036789297659
5283,4230046,1097,186,183,387,911,1097,1.0,0.16955332725615316,0.8304466727438469,527,0.16681859617137648,0.3527803099361896,0.4804010938924339
5284,4230047,476,79,99,161,397,476,1.0,0.16596638655462184,0.8340336134453782,216,0.20798319327731093,0.3382352941176471,0.453781512605042
5285,4230048,1133,315,58,118,818,1133,1.0,0.2780229479258605,0.7219770520741394,957,0.05119152691968226,0.10414827890556046,0.8446601941747572
5286,4230049,333,65,73,49,268,333,1.0,0.19519519519519518,0.8048048048048048,211,0.21921921921921922,0.14714714714714713,0.6336336336336337
5287,4230050,2543,205,283,1319,2338,2543,1.0,0.08061344868265828,0.9193865513173417,941,0.11128588281557215,0.5186787259142744,0.37003539127015334
5288,4230052,1685,283,193,930,1402,1685,1.0,0.1679525222551929,0.8320474777448071,562,0.114540059347181,0.5519287833827893,0.3335311572700297
5289,4230054,3624,145,401,1543,3479,3624,1.0,0.04001103752759382,0.9599889624724062,1680,0.11065121412803532,0.4257726269315673,0.46357615894039733
5290,4230055,6319,1266,772,1747,5053,6319,1.0,0.20034815635385345,0.7996518436461465,3800,0.12217122962494066,0.2764677955372686,0.6013609748377908
5291,4230056,4038,478,409,1855,3560,4038,1.0,0.1183754333828628,0.8816245666171372,1774,0.10128776622090144,0.45938583457157006,0.4393263992075285
5292,4230058,3783,813,349,1509,2970,3783,1.0,0.21490880253766853,0.7850911974623315,1925,0.0922548242135871,0.39888977002379067,0.5088554057626222
5293,4230059,3427,572,359,1919,2855,3427,1.0,0.16690983367376713,0.8330901663262329,1149,0.10475634665888532,0.5599649839509775,0.3352786693901371
5294,4230060,1520,203,133,132,1317,1520,1.0,0.13355263157894737,0.8664473684210526,1255,0.0875,0.0868421052631579,0.8256578947368421
5295,4230061,2794,634,453,716,2160,2794,1.0,0.22691481746599856,0.7730851825340014,1625,0.1621331424481031,0.25626342161775234,0.5816034359341445
5296,4230063,214,46,25,8,168,214,1.0,0.21495327102803738,0.7850467289719626,181,0.11682242990654206,0.037383177570093455,0.8457943925233645
5297,4230064,171,18,29,64,153,171,1.0,0.10526315789473684,0.8947368421052632,78,0.1695906432748538,0.3742690058479532,0.45614035087719296
5298,4230065,132,25,53,22,107,132,1.0,0.1893939393939394,0.8106060606060606,57,0.4015151515151515,0.16666666666666666,0.4318181818181818
5299,4230066,1089,315,168,200,774,1089,1.0,0.2892561983471074,0.7107438016528925,721,0.15426997245179064,0.18365472910927455,0.6620752984389348
5300,4230070,659,62,72,183,597,659,1.0,0.09408194233687406,0.9059180576631259,404,0.10925644916540213,0.27769347496206376,0.6130500758725341
5301,4230071,3436,209,342,2005,3227,3436,1.0,0.06082654249126892,0.939173457508731,1089,0.09953434225844005,0.5835273573923166,0.3169383003492433
5302,4230072,744,297,37,24,447,744,1.0,0.39919354838709675,0.6008064516129032,683,0.04973118279569892,0.03225806451612903,0.918010752688172
5303,4230073,742,315,141,195,427,742,1.0,0.42452830188679247,0.5754716981132075,406,0.19002695417789758,0.2628032345013477,0.5471698113207547
5304,4230074,58,14,14,43,44,58,1.7272727272727273,0.2413793103448276,0.7586206896551724,1,0.2413793103448276,0.7413793103448276,0.017241379310344827
5305,4230075,3333,18,288,2223,3315,3333,1.0,0.0054005400540054005,0.9945994599459946,822,0.08640864086408641,0.666966696669667,0.24662466246624662
5306,4230076,1587,412,209,94,1175,1587,1.0,0.25960932577189666,0.7403906742281033,1284,0.13169502205419029,0.05923125393824827,0.8090737240075614
5307,4230077,485,152,77,153,333,485,1.0,0.3134020618556701,0.6865979381443299,255,0.15876288659793814,0.3154639175257732,0.5257731958762887
5308,4230078,146,53,13,84,93,146,1.0,0.363013698630137,0.636986301369863,49,0.08904109589041095,0.5753424657534246,0.3356164383561644
5309,4230079,3855,511,389,1756,3344,3855,1.0,0.13255512321660182,0.8674448767833982,1710,0.10090791180285344,0.4555123216601816,0.44357976653696496
5310,4230080,24,0,6,9,24,24,1.0,0.0,1.0,9,0.25,0.375,0.375
5311,4230081,275,68,75,42,207,275,1.0,0.24727272727272728,0.7527272727272727,158,0.2727272727272727,0.15272727272727274,0.5745454545454546
5312,4230082,79,9,9,10,70,79,1.0,0.11392405063291139,0.8860759493670886,60,0.11392405063291139,0.12658227848101267,0.759493670886076
5313,4250001,1510,9,143,646,1501,1510,1.0,0.005960264900662252,0.9940397350993377,721,0.09470198675496688,0.4278145695364238,0.4774834437086093
5314,4250002,1642,0,151,815,1642,1642,1.0,0.0,1.0,676,0.09196102314250913,0.49634591961023145,0.41169305724725946
5315,4250003,1686,30,161,708,1656,1686,1.0,0.017793594306049824,0.9822064056939501,817,0.09549228944246738,0.4199288256227758,0.4845788849347568
5316,4250004,1754,0,158,702,1754,1754,1.0,0.0,1.0,894,0.09007981755986318,0.40022805017103763,0.5096921322690992
5317,4270001,3173,5,1207,219,3168,3173,1.0,0.001575795776867318,0.9984242042231327,1747,0.3803971005357706,0.06901985502678853,0.5505830444374409
5318,4270002,4692,9,1413,253,4683,4692,1.0,0.0019181585677749361,0.9980818414322251,3026,0.30115089514066495,0.05392156862745098,0.644927536231884
5319,4270003,1361,0,519,53,1361,1361,1.0,0.0,1.0,789,0.3813372520205731,0.038941954445260836,0.5797207935341661
5320,4270004,673,0,221,168,673,673,1.0,0.0,1.0,284,0.32838038632986627,0.24962852897473997,0.42199108469539376
5321,4270005,137,0,48,11,137,137,1.0,0.0,1.0,78,0.35036496350364965,0.08029197080291971,0.5693430656934306
5322,4270006,6448,0,2345,236,6448,6448,1.0,0.0,1.0,3867,0.3636786600496278,0.03660049627791563,0.5997208436724566
5323,4270007,636,0,310,40,636,636,1.0,0.0,1.0,286,0.48742138364779874,0.06289308176100629,0.449685534591195
5324,4270008,2336,0,1185,145,2336,2336,1.0,0.0,1.0,1006,0.507277397260274,0.062071917808219176,0.4306506849315068
5325,4270009,3585,0,1295,144,3585,3585,1.0,0.0,1.0,2146,0.3612273361227336,0.0401673640167364,0.59860529986053
5326,4270010,7009,9,1717,278,7000,7009,1.0,0.0012840633471251249,0.9987159366528748,5014,0.2449707518904266,0.039663290055642744,0.7153659580539307
5327,4291-11,1404,43,99,633,1361,1404,1.0,0.030626780626780627,0.9693732193732194,672,0.07051282051282051,0.45085470085470086,0.47863247863247865
5328,4292-11,1591,38,118,671,1553,1591,1.0,0.023884349465744813,0.9761156505342552,802,0.07416719044626022,0.4217473287240729,0.5040854808296669
5329,4292-19A,61,0,5,35,61,61,1.0,0.0,1.0,21,0.08196721311475409,0.5737704918032787,0.3442622950819672
5330,4292-19B,132,0,14,81,132,132,1.0,0.0,1.0,37,0.10606060606060606,0.6136363636363636,0.2803030303030303
5332,4293-11,1017,12,70,429,1005,1017,1.0,0.011799410029498525,0.9882005899705014,518,0.0688298918387414,0.4218289085545723,0.5093411996066863
5333,4293-19,754,98,23,185,656,754,1.0,0.129973474801061,0.870026525198939,546,0.03050397877984085,0.2453580901856764,0.7241379310344828
5334,4294-11,845,1,66,375,844,845,1.0,0.001183431952662722,0.9988165680473373,404,0.07810650887573964,0.4437869822485207,0.47810650887573963
5335,4294-19,1081,7,71,419,1074,1081,1.0,0.0064754856614246065,0.9935245143385754,591,0.06567992599444958,0.3876040703052729,0.5467160037002775
5336,4295-11,124,0,9,64,124,124,1.0,0.0,1.0,51,0.07258064516129033,0.5161290322580645,0.4112903225806452
5337,4310001A,152,0,7,105,152,152,1.0,0.0,1.0,40,0.046052631578947366,0.6907894736842105,0.2631578947368421
5338,4310001B,46,0,4,33,46,46,1.0,0.0,1.0,9,0.08695652173913043,0.717391304347826,0.1956521739130435
5339,4310002A,143,0,4,60,143,143,1.0,0.0,1.0,79,0.027972027972027972,0.4195804195804196,0.5524475524475524
5340,4310002B,15,0,0,6,15,15,1.0,0.0,1.0,9,0.0,0.4,0.6
5341,4310002C,23,0,1,10,23,23,1.0,0.0,1.0,12,0.043478260869565216,0.43478260869565216,0.5217391304347826
5342,4310002D,7,0,0,4,7,7,1.0,0.0,1.0,3,0.0,0.5714285714285714,0.42857142857142855
5343,4310003,191,0,6,126,191,191,1.0,0.0,1.0,59,0.031413612565445025,0.6596858638743456,0.3089005235602094
5344,4310004,193,1,8,87,192,193,1.0,0.0051813471502590676,0.9948186528497409,98,0.04145077720207254,0.45077720207253885,0.5077720207253886
5345,4330001,243,8,25,126,235,243,1.0,0.03292181069958848,0.9670781893004116,92,0.102880658436214,0.5185185185185185,0.3786008230452675
5346,4330002,250,11,40,128,239,250,1.0,0.044,0.956,82,0.16,0.512,0.328
5347,4330003,265,16,37,125,249,265,1.0,0.06037735849056604,0.939622641509434,103,0.13962264150943396,0.4716981132075472,0.3886792452830189
5348,4330004,314,12,58,128,302,314,1.0,0.03821656050955414,0.9617834394904459,128,0.18471337579617833,0.40764331210191085,0.40764331210191085
5349,4350101,509,0,122,177,509,509,1.0,0.0,1.0,210,0.23968565815324164,0.3477406679764244,0.412573673870334
5350,4350201,695,2,60,329,693,695,1.0,0.0028776978417266188,0.9971223021582734,306,0.08633093525179857,0.47338129496402875,0.44028776978417267
5351,4350301,808,1,79,431,807,808,1.0,0.0012376237623762376,0.9987623762376238,298,0.09777227722772278,0.5334158415841584,0.3688118811881188
5352,4350401,612,2,108,173,610,612,1.0,0.0032679738562091504,0.9967320261437909,331,0.17647058823529413,0.2826797385620915,0.5408496732026143
5353,4370001,1104,72,95,222,1032,1104,1.0,0.06521739130434782,0.9347826086956522,787,0.08605072463768115,0.20108695652173914,0.7128623188405797
5354,4370002,1026,32,130,406,994,1026,1.0,0.031189083820662766,0.9688109161793372,490,0.1267056530214425,0.39571150097465885,0.4775828460038986
5355,4370003,896,41,114,337,855,896,1.0,0.04575892857142857,0.9542410714285714,445,0.12723214285714285,0.37611607142857145,0.4966517857142857
5356,4370004,611,77,85,104,534,611,1.0,0.1260229132569558,0.8739770867430442,422,0.13911620294599017,0.1702127659574468,0.690671031096563
5357,4370006,501,10,58,141,491,501,1.0,0.01996007984031936,0.9800399201596807,302,0.1157684630738523,0.281437125748503,0.6027944111776448
5358,4370007,487,3,41,265,484,487,1.0,0.006160164271047228,0.9938398357289527,181,0.08418891170431211,0.5441478439425051,0.37166324435318276
5359,4370009,34,1,12,22,33,34,1.0,0.029411764705882353,0.9705882352941176,0,0.35294117647058826,0.6470588235294118,0.0
5360,4370011,429,8,44,158,421,429,1.0,0.018648018648018648,0.9813519813519813,227,0.10256410256410256,0.3682983682983683,0.5291375291375291
5361,4391001,1841,358,298,470,1483,1841,1.0,0.1944595328625747,0.8055404671374253,1073,0.1618685497012493,0.2552960347637154,0.5828354155350353
5362,4391004,2358,418,589,796,1940,2358,1.0,0.17726887192536048,0.8227311280746396,973,0.24978795589482614,0.3375742154368109,0.412637828668363
5363,4391005,778,567,364,9,211,778,1.0,0.7287917737789203,0.2712082262210797,405,0.46786632390745503,0.011568123393316195,0.5205655526992288
5364,4391008,267,98,166,2,169,267,1.0,0.36704119850187267,0.6329588014981273,99,0.6217228464419475,0.00749063670411985,0.3707865168539326
5365,4391009,1296,40,255,510,1256,1296,1.0,0.030864197530864196,0.9691358024691358,531,0.19675925925925927,0.39351851851851855,0.4097222222222222
5366,4391010,720,274,161,24,446,720,1.0,0.38055555555555554,0.6194444444444445,535,0.22361111111111112,0.03333333333333333,0.7430555555555556
5367,4391011,1297,384,321,42,913,1297,1.0,0.29606784888203547,0.7039321511179646,934,0.24749421742482652,0.03238242097147263,0.7201233616037008
5368,4391012,2580,700,781,501,1880,2580,1.0,0.2713178294573643,0.7286821705426356,1298,0.30271317829457367,0.1941860465116279,0.5031007751937985
5369,4391013,2256,1220,1268,169,1036,2256,1.0,0.5407801418439716,0.4592198581560284,819,0.5620567375886525,0.0749113475177305,0.363031914893617
5370,4391014,975,20,150,180,955,975,1.0,0.020512820512820513,0.9794871794871794,645,0.15384615384615385,0.18461538461538463,0.6615384615384615
5371,4391015,1477,64,310,263,1413,1477,1.0,0.043331076506431955,0.956668923493568,904,0.2098849018280298,0.1780636425186188,0.6120514556533514
5372,4391019,941,171,223,62,770,941,1.0,0.18172157279489903,0.8182784272051009,656,0.23698193411264612,0.06588735387885228,0.6971307120085016
5373,4391021,3233,47,551,1297,3186,3233,1.0,0.01453758119393752,0.9854624188060624,1385,0.17042994123105476,0.40117537890504174,0.4283946798639035
5374,4391022,1252,185,261,495,1067,1252,1.0,0.1477635782747604,0.8522364217252396,496,0.2084664536741214,0.3953674121405751,0.3961661341853035
5375,4391023,6239,1389,853,1365,4850,6239,1.0,0.22263183202436287,0.7773681679756371,4021,0.13672062830581824,0.21878506170860715,0.6444943099855747
5376,4391024,3485,349,467,995,3136,3485,1.0,0.10014347202295552,0.8998565279770445,2023,0.1340028694404591,0.2855093256814921,0.5804878048780487
5377,4391025,2382,805,747,397,1577,2382,1.0,0.33795130142737195,0.662048698572628,1238,0.3136020151133501,0.16666666666666666,0.5197313182199832
5378,4391034,3174,334,372,1371,2840,3174,1.0,0.10522999369880277,0.8947700063011972,1431,0.11720226843100189,0.43194706994328924,0.45085066162570886
5379,4391056,1317,695,293,26,622,1317,1.0,0.527714502657555,0.47228549734244496,998,0.22247532270311313,0.019741837509491267,0.7577828397873956
5380,4391059,594,332,285,16,262,594,1.0,0.5589225589225589,0.44107744107744107,293,0.4797979797979798,0.026936026936026935,0.49326599326599324
5381,4391061,532,62,130,11,470,532,1.0,0.11654135338345864,0.8834586466165414,391,0.24436090225563908,0.020676691729323307,0.7349624060150376
5382,4391062,24,2,12,11,22,24,1.0,0.08333333333333333,0.9166666666666666,1,0.5,0.4583333333333333,0.041666666666666664
5383,4391066,1306,276,252,151,1030,1306,1.0,0.2113323124042879,0.7886676875957122,903,0.19295558958652373,0.11562021439509954,0.6914241960183767
5384,4391071,4348,1425,720,435,2923,4348,1.0,0.32773689052437904,0.672263109475621,3193,0.1655933762649494,0.10004599816007359,0.734360625574977
5385,4391074,1219,465,272,26,754,1219,1.0,0.38146021328958163,0.6185397867104184,921,0.22313371616078753,0.02132895816242822,0.7555373256767842
5386,4391075,1255,268,283,62,987,1255,1.0,0.21354581673306772,0.7864541832669323,910,0.2254980079681275,0.04940239043824701,0.7250996015936255
5387,4391076,1099,3,342,339,1096,1099,1.0,0.00272975432211101,0.997270245677889,418,0.3111919927206551,0.30846223839854414,0.38034576888080074
5388,4391078,916,499,437,16,417,916,1.0,0.5447598253275109,0.45524017467248906,463,0.47707423580786024,0.017467248908296942,0.5054585152838428
5389,4391079,1124,830,626,23,294,1124,1.0,0.7384341637010676,0.2615658362989324,475,0.5569395017793595,0.020462633451957295,0.4225978647686833
5390,4391080,1565,1121,676,24,444,1565,1.0,0.7162939297124601,0.2837060702875399,865,0.4319488817891374,0.015335463258785943,0.5527156549520766
5391,4391081,3492,292,278,525,3200,3492,1.0,0.0836197021764032,0.9163802978235968,2689,0.07961053837342497,0.15034364261168384,0.7700458190148912
5392,4391082,651,0,129,121,651,651,1.0,0.0,1.0,401,0.19815668202764977,0.1858678955453149,0.6159754224270353
5393,4391083,1242,568,354,57,674,1242,1.0,0.4573268921095008,0.5426731078904992,831,0.28502415458937197,0.04589371980676329,0.6690821256038647
5395,4391085,1313,134,178,218,1179,1313,1.0,0.10205635948210205,0.897943640517898,917,0.13556740289413557,0.16603198781416603,0.6984006092916984
5396,4391088,1364,257,417,110,1107,1364,1.0,0.18841642228739003,0.8115835777126099,837,0.3057184750733138,0.08064516129032258,0.6136363636363636
5397,4391089,1586,1257,812,8,329,1586,1.0,0.7925598991172762,0.20744010088272383,766,0.5119798234552333,0.005044136191677175,0.48297604035308955
5398,4391090,1704,1055,841,11,649,1704,1.0,0.619131455399061,0.38086854460093894,852,0.4935446009389671,0.006455399061032864,0.5
5399,4391094,1952,162,431,280,1790,1952,1.0,0.08299180327868852,0.9170081967213115,1241,0.22079918032786885,0.14344262295081966,0.6357581967213115
5400,4391095,722,0,181,400,722,722,1.0,0.0,1.0,141,0.25069252077562326,0.554016620498615,0.19529085872576177
5401,4391098,1856,1109,785,37,747,1856,1.0,0.5975215517241379,0.40247844827586204,1034,0.4229525862068966,0.01993534482758621,0.5571120689655172
5402,4391099,1112,443,295,119,669,1112,1.0,0.3983812949640288,0.6016187050359713,698,0.2652877697841727,0.10701438848920863,0.6276978417266187
5403,4391103,1710,292,269,667,1418,1710,1.0,0.17076023391812867,0.8292397660818713,774,0.15730994152046784,0.3900584795321637,0.45263157894736844
5404,4391104,3164,2280,1417,94,884,3164,1.0,0.7206068268015171,0.27939317319848295,1653,0.44785082174462704,0.02970922882427307,0.5224399494310998
5405,4391105,1794,206,444,699,1588,1794,1.0,0.11482720178372352,0.8851727982162765,651,0.24749163879598662,0.3896321070234114,0.362876254180602
5406,4391106,1985,1632,1372,8,353,1985,1.0,0.8221662468513854,0.1778337531486146,605,0.691183879093199,0.004030226700251889,0.3047858942065491
5407,4391108,1978,42,429,595,1936,1978,1.0,0.021233569261880688,0.9787664307381193,954,0.21688574317492418,0.30080889787664306,0.48230535894843274
5408,4391109,1417,0,228,89,1417,1417,1.0,0.0,1.0,1100,0.16090331686661963,0.06280875088214538,0.776287932251235
5409,4391111,2301,151,213,901,2150,2301,1.0,0.06562364189482833,0.9343763581051716,1187,0.09256844850065189,0.3915688830943068,0.5158626684050412
5410,4391117,2225,120,505,700,2105,2225,1.0,0.05393258426966292,0.946067415730337,1020,0.22696629213483147,0.3146067415730337,0.4584269662921348
5411,4391119,5135,1686,1578,1121,3449,5135,1.0,0.32833495618305747,0.6716650438169426,2436,0.30730282375851997,0.21830574488802337,0.4743914313534567
5412,4391120,2091,1513,1564,29,578,2091,1.0,0.7235772357723578,0.2764227642276423,498,0.7479674796747967,0.013868962219033954,0.2381635581061693
5413,4391126,1688,726,763,374,962,1688,1.0,0.43009478672985785,0.5699052132701422,551,0.45201421800947866,0.22156398104265404,0.3264218009478673
5414,4391127,1449,1119,907,24,330,1449,1.0,0.772256728778468,0.2277432712215321,518,0.6259489302967564,0.016563146997929608,0.357487922705314
5415,4391132,1973,1134,886,30,839,1973,1.0,0.5747592498732894,0.4252407501267106,1057,0.44906234161175873,0.015205271160669031,0.5357323872275722
5416,4391133,2322,146,493,584,2176,2322,1.0,0.06287683031869079,0.9371231696813093,1245,0.21231696813092163,0.25150732127476316,0.5361757105943152
5417,4391142,1668,155,353,414,1513,1668,1.0,0.09292565947242207,0.907074340527578,901,0.21163069544364507,0.24820143884892087,0.540167865707434
5418,4391146,2743,1136,830,562,1607,2743,1.0,0.41414509660955157,0.5858549033904484,1351,0.3025884068538097,0.2048851622311338,0.4925264309150565
5419,4391149,2823,1557,1118,252,1266,2823,1.0,0.5515409139213603,0.44845908607863977,1453,0.39603258944385406,0.08926673751328375,0.5147006730428622
5420,4391150,1931,889,705,257,1042,1931,1.0,0.46038322112894875,0.5396167788710513,969,0.3650958052822372,0.13309166235111342,0.5018125323666494
5421,4391151,1328,489,382,324,839,1328,1.0,0.3682228915662651,0.6317771084337349,622,0.2876506024096386,0.24397590361445784,0.4683734939759036
5422,4391153,1534,1115,980,59,419,1534,1.0,0.7268578878748371,0.273142112125163,495,0.6388526727509778,0.038461538461538464,0.3226857887874837
5423,4391154,2382,853,342,30,1529,2382,1.0,0.3581024349286314,0.6418975650713686,2010,0.14357682619647355,0.012594458438287154,0.8438287153652393
5424,4391165,237,1,69,73,236,237,1.0,0.004219409282700422,0.9957805907172996,95,0.2911392405063291,0.3080168776371308,0.4008438818565401
5425,4391167,1825,160,374,521,1665,1825,1.0,0.08767123287671233,0.9123287671232877,930,0.20493150684931508,0.2854794520547945,0.5095890410958904
5426,4391170,3566,1377,962,599,2189,3566,1.0,0.38614694335389793,0.6138530566461021,2005,0.26977005047672464,0.16797532249018507,0.5622546270330903
5427,4391175,2006,402,310,286,1604,2006,1.0,0.20039880358923232,0.7996011964107677,1410,0.15453639082751744,0.14257228315054835,0.7028913260219342
5428,4391184,1172,242,157,139,930,1172,1.0,0.20648464163822525,0.7935153583617748,876,0.13395904436860068,0.11860068259385666,0.7474402730375427
5429,4391186,643,0,123,287,643,643,1.0,0.0,1.0,233,0.19129082426127528,0.4463452566096423,0.36236391912908245
5430,4391188,685,605,350,8,80,685,1.0,0.8832116788321168,0.11678832116788321,327,0.5109489051094891,0.01167883211678832,0.47737226277372263
5431,4391189,2067,205,621,790,1862,2067,1.0,0.09917755200774069,0.9008224479922593,656,0.30043541364296084,0.382196419932269,0.3173681664247702
5432,4391197,4442,710,1004,1271,3732,4442,1.0,0.15983791085096805,0.840162089149032,2167,0.2260243133723548,0.2861323728050428,0.48784331382260243
5433,4391198,676,47,98,98,629,676,1.0,0.0695266272189349,0.9304733727810651,480,0.14497041420118342,0.14497041420118342,0.7100591715976331
5434,4391199,362,66,94,187,296,362,1.0,0.18232044198895028,0.8176795580110497,81,0.2596685082872928,0.5165745856353591,0.22375690607734808
5435,4391206,3184,63,508,1185,3121,3184,1.0,0.01978643216080402,0.980213567839196,1491,0.15954773869346733,0.37217336683417085,0.4682788944723618
5436,4391207,3310,591,690,794,2719,3310,1.0,0.17854984894259818,0.8214501510574018,1826,0.2084592145015106,0.23987915407854984,0.5516616314199396
5437,4391208,4376,135,748,1955,4241,4376,1.0,0.030850091407678245,0.9691499085923218,1673,0.17093235831809872,0.4467550274223035,0.3823126142595978
5438,4391211,2431,1877,1231,37,554,2431,1.0,0.7721102426984779,0.227889757301522,1163,0.5063759769642122,0.015220074043603456,0.4784039489921843
5439,4391236,780,100,185,163,680,780,1.0,0.1282051282051282,0.8717948717948718,432,0.23717948717948717,0.20897435897435898,0.5538461538461539
5440,4391237,964,25,190,126,939,964,1.0,0.025933609958506226,0.9740663900414938,648,0.1970954356846473,0.13070539419087138,0.6721991701244814
5441,4391238,3651,1408,1077,721,2243,3651,1.0,0.38564776773486714,0.6143522322651328,1853,0.294987674609696,0.1974801424267324,0.5075321829635716
5442,4391241,515,212,88,44,303,515,1.0,0.4116504854368932,0.5883495145631068,383,0.170873786407767,0.0854368932038835,0.7436893203883496
5443,4391244,138,64,25,88,74,138,1.0,0.463768115942029,0.5362318840579711,25,0.18115942028985507,0.6376811594202898,0.18115942028985507
5444,4391251,4620,2546,1440,382,2074,4620,1.0,0.5510822510822511,0.44891774891774894,2798,0.3116883116883117,0.08268398268398268,0.6056277056277056
5445,4391255,3983,1735,1188,677,2248,3983,1.0,0.43560130554858145,0.5643986944514185,2118,0.2982676374592016,0.16997238262616118,0.5317599799146372
5446,4391257,1933,690,547,393,1243,1933,1.0,0.3569580962234868,0.6430419037765132,993,0.28297982410760475,0.2033109156751164,0.5137092602172788
5447,4391264,1851,47,381,782,1804,1851,1.0,0.025391680172879523,0.9746083198271205,688,0.20583468395461912,0.42247433819556995,0.3716909778498109
5448,4391265,2119,609,750,602,1510,2119,1.0,0.2873997168475696,0.7126002831524304,767,0.3539405379896177,0.2840962718263332,0.3619631901840491
5449,4391270,813,172,170,171,641,813,1.0,0.2115621156211562,0.7884378843788438,472,0.2091020910209102,0.21033210332103322,0.5805658056580566
5450,4391271,3331,267,431,1263,3064,3331,1.0,0.08015610927649354,0.9198438907235065,1637,0.12939057340138096,0.37916541579105373,0.4914440108075653
5451,4391273,3052,130,538,452,2922,3052,1.0,0.04259501965923984,0.9574049803407602,2062,0.17627785058977719,0.14809960681520315,0.6756225425950196
5452,4391277A,1749,250,385,498,1499,1749,1.0,0.1429388221841052,0.8570611778158947,866,0.22012578616352202,0.2847341337907376,0.49514008004574045
5454,4391278,3017,1692,1000,229,1325,3017,1.0,0.5608220086178323,0.43917799138216773,1788,0.3314550878355983,0.07590321511435201,0.5926416970500498
5455,4391279,2289,1165,920,395,1124,2289,1.0,0.508955875928353,0.491044124071647,974,0.40192223678462213,0.17256443861948448,0.4255133245958934
5456,4391291,1948,1429,1328,32,519,1948,1.0,0.7335728952772074,0.26642710472279263,588,0.6817248459958932,0.01642710472279261,0.30184804928131415
5457,4391292,2457,1042,645,206,1415,2457,1.0,0.4240944240944241,0.5759055759055759,1606,0.2625152625152625,0.08384208384208384,0.6536426536426536
5458,4391293,1627,784,619,127,843,1627,1.0,0.48186846957590657,0.5181315304240934,881,0.38045482483097726,0.07805777504609711,0.5414874001229256
5459,4391294,4062,403,714,1528,3659,4062,1.0,0.09921221073362875,0.9007877892663713,1820,0.1757754800590842,0.3761693746922698,0.448055145248646
5460,4391295,1010,379,314,139,631,1010,1.0,0.37524752475247525,0.6247524752475248,557,0.3108910891089109,0.13762376237623763,0.5514851485148515
5461,4391296,3128,214,572,1254,2914,3128,1.0,0.06841432225063938,0.9315856777493606,1302,0.18286445012787725,0.4008951406649616,0.4162404092071611
5462,4391297,3249,2662,1658,23,587,3249,1.0,0.8193290243151738,0.1806709756848261,1568,0.510310864881502,0.007079101261926747,0.48261003385657125
5463,4391298,4258,143,501,630,4115,4258,1.0,0.03358384217942696,0.966416157820573,3127,0.11766087364960075,0.14795678722404884,0.7343823391263504
5464,4391300,2715,1035,809,471,1680,2715,1.0,0.3812154696132597,0.6187845303867403,1435,0.2979742173112339,0.1734806629834254,0.5285451197053407
5465,4391301,1505,972,1042,105,533,1505,1.0,0.6458471760797342,0.35415282392026576,358,0.692358803986711,0.06976744186046512,0.2378737541528239
5466,4391311,2369,1505,953,256,864,2369,1.0,0.6352891515407345,0.3647108484592655,1160,0.4022794428028704,0.10806247361756015,0.4896580835795694
5467,4391337,2236,0,364,1141,2236,2236,1.0,0.0,1.0,731,0.16279069767441862,0.5102862254025045,0.3269230769230769
5468,4391339,3163,496,604,1117,2667,3163,1.0,0.15681315207081883,0.8431868479291812,1442,0.19095795131204552,0.35314574770787227,0.4558963009800822
5469,4391345,566,60,67,73,506,566,1.0,0.10600706713780919,0.8939929328621908,426,0.11837455830388692,0.12897526501766785,0.7526501766784452
5470,4391346,1502,1150,627,11,352,1502,1.0,0.7656458055925432,0.23435419440745672,864,0.4174434087882823,0.007323568575233023,0.5752330226364847
5471,4391347,4574,1460,1294,1631,3114,4574,1.0,0.3191954525579362,0.6808045474420639,1649,0.2829033668561434,0.3565806733712287,0.3605159597726279
5472,4391348,864,8,87,319,856,864,1.0,0.009259259259259259,0.9907407407407407,458,0.10069444444444445,0.36921296296296297,0.5300925925925926
5474,4391352,958,44,112,279,914,958,1.0,0.04592901878914405,0.954070981210856,567,0.11691022964509394,0.29123173277661796,0.5918580375782881
5476,4391376,1649,321,3,6,1328,1649,1.0,0.19466343238326259,0.8053365676167374,1640,0.0018192844147968466,0.0036385688295936932,0.9945421467556095
5477,4391377,5184,1030,1095,1299,4154,5184,1.0,0.19868827160493827,0.8013117283950617,2790,0.21122685185185186,0.2505787037037037,0.5381944444444444
5478,4391378,4395,1801,1425,600,2594,4395,1.0,0.4097838452787258,0.5902161547212742,2370,0.3242320819112628,0.13651877133105803,0.5392491467576792
5479,4391380,1904,505,483,455,1399,1904,1.0,0.2652310924369748,0.7347689075630253,966,0.2536764705882353,0.23897058823529413,0.5073529411764706
5480,4391382,3458,1752,819,341,1706,3458,1.0,0.5066512434933488,0.4933487565066512,2298,0.23684210526315788,0.09861191440138808,0.664545980335454
5481,4391388,4655,1259,848,561,3396,4655,1.0,0.2704618689581096,0.7295381310418905,3246,0.18216970998925885,0.12051557465091299,0.6973147153598281
5483,4391404,17,5,9,8,12,17,1.0,0.29411764705882354,0.7058823529411765,0,0.5294117647058824,0.47058823529411764,0.0
5484,4391407,71,30,26,15,41,71,1.0,0.4225352112676056,0.5774647887323944,30,0.36619718309859156,0.2112676056338028,0.4225352112676056
5485,4391408,399,72,50,22,327,399,1.0,0.18045112781954886,0.8195488721804511,327,0.12531328320802004,0.05513784461152882,0.8195488721804511
5487,4391414,42,18,19,4,24,42,1.0,0.42857142857142855,0.5714285714285714,19,0.4523809523809524,0.09523809523809523,0.4523809523809524
5488,4391415,2535,974,577,145,1561,2535,1.0,0.38422090729783037,0.6157790927021696,1813,0.22761341222879686,0.05719921104536489,0.7151873767258383
5489,4391416,109,0,37,50,109,109,1.0,0.0,1.0,22,0.3394495412844037,0.45871559633027525,0.2018348623853211
5492,4391423,2011,5,377,1430,2006,2011,1.0,0.002486325211337643,0.9975136747886624,204,0.18746892093485829,0.7110890104425659,0.10144206862257583
5493,4391424,28,13,6,10,15,28,1.0,0.4642857142857143,0.5357142857142857,12,0.21428571428571427,0.35714285714285715,0.42857142857142855
5494,4391427,18,11,3,7,7,18,1.0,0.6111111111111112,0.3888888888888889,8,0.16666666666666666,0.3888888888888889,0.4444444444444444
5495,4391430,14,2,1,3,12,14,1.0,0.14285714285714285,0.8571428571428571,10,0.07142857142857142,0.21428571428571427,0.7142857142857143
5496,4391431,2480,85,237,805,2395,2480,1.0,0.034274193548387094,0.9657258064516129,1438,0.09556451612903226,0.3245967741935484,0.5798387096774194
5498,4391436,1169,408,178,177,761,1169,1.0,0.34901625320787,0.65098374679213,814,0.15226689478186484,0.1514114627887083,0.6963216424294268
5499,4391437,750,331,182,281,419,750,1.0,0.44133333333333336,0.5586666666666666,287,0.24266666666666667,0.37466666666666665,0.38266666666666665
5500,4391439,83,39,32,10,44,83,1.0,0.46987951807228917,0.5301204819277109,41,0.3855421686746988,0.12048192771084337,0.4939759036144578
5501,4391440,2321,1122,928,271,1199,2321,1.0,0.4834123222748815,0.5165876777251185,1122,0.3998276604911676,0.11676001723395088,0.4834123222748815
5502,4391441,1334,393,364,65,941,1334,1.0,0.2946026986506747,0.7053973013493253,905,0.272863568215892,0.04872563718140929,0.6784107946026986
5503,4391444,44,29,33,10,15,44,1.0238095238095237,0.6590909090909091,0.3409090909090909,1,0.75,0.22727272727272727,0.022727272727272728
5504,4391445,53,6,17,6,47,53,1.0,0.11320754716981132,0.8867924528301887,30,0.32075471698113206,0.11320754716981132,0.5660377358490566
5507,4391459,2225,625,855,368,1600,2225,1.0,0.2808988764044944,0.7191011235955056,1002,0.3842696629213483,0.16539325842696628,0.4503370786516854
5508,4391460,4336,2795,1079,270,1541,4336,1.0,0.6446033210332104,0.35539667896678967,2987,0.2488468634686347,0.06226937269372694,0.6888837638376384
5509,4391463,3254,1545,533,175,1709,3254,1.0,0.47480024585125996,0.52519975414874,2546,0.1637984019668101,0.053779963122311,0.7824216349108789
5511,4391473,168,0,21,24,168,168,1.0,0.0,1.0,123,0.125,0.14285714285714285,0.7321428571428571
5512,4391476,191,61,30,26,130,191,1.0,0.3193717277486911,0.680628272251309,135,0.15706806282722513,0.13612565445026178,0.7068062827225131
5513,4391477,1629,583,484,69,1046,1629,1.0,0.3578882750153468,0.6421117249846532,1076,0.29711479435236343,0.0423572744014733,0.6605279312461633
5514,4391479,345,184,64,26,161,345,1.0,0.5333333333333333,0.4666666666666667,255,0.1855072463768116,0.07536231884057971,0.7391304347826086
5515,4391481,837,20,138,38,817,837,1.0,0.023894862604540025,0.97610513739546,661,0.16487455197132617,0.04540023894862605,0.7897252090800478
5516,4391482,987,279,248,38,708,987,1.0,0.2826747720364742,0.7173252279635258,701,0.2512664640324215,0.03850050658561297,0.7102330293819655
5517,4391489,2514,1395,647,308,1119,2514,1.0,0.5548926014319809,0.4451073985680191,1559,0.2573587907716786,0.12251392203659507,0.6201272871917264
5518,4391490,924,450,253,102,474,924,1.0,0.487012987012987,0.512987012987013,569,0.27380952380952384,0.11038961038961038,0.6158008658008658
5519,4391491,3,0,0,0,3,3,1.0,0.0,1.0,3,0.0,0.0,1.0
5520,4391501,692,241,139,145,451,692,1.0,0.34826589595375723,0.6517341040462428,408,0.20086705202312138,0.20953757225433525,0.5895953757225434
5521,4391504,2481,99,229,949,2382,2481,1.0,0.03990326481257558,0.9600967351874244,1303,0.09230149133413947,0.3825070536074164,0.5251914550584442
5523,4391515,71,45,8,12,26,71,1.0,0.6338028169014085,0.36619718309859156,51,0.11267605633802817,0.16901408450704225,0.7183098591549296
5524,4391518,1510,1050,361,102,460,1510,1.0,0.695364238410596,0.304635761589404,1047,0.2390728476821192,0.06754966887417219,0.6933774834437086
5526,4391544,6,2,4,0,4,6,1.0,0.3333333333333333,0.6666666666666666,2,0.6666666666666666,0.0,0.3333333333333333
5529,4391550,51,19,27,3,32,51,1.0,0.37254901960784315,0.6274509803921569,21,0.5294117647058824,0.058823529411764705,0.4117647058823529
5530,4391555,10,2,2,0,8,10,1.0,0.2,0.8,8,0.2,0.0,0.8
5531,4391559,238,100,75,36,138,238,1.0,0.42016806722689076,0.5798319327731093,127,0.31512605042016806,0.15126050420168066,0.5336134453781513
5533,4391576,342,191,87,6,151,342,1.0,0.5584795321637427,0.4415204678362573,249,0.2543859649122807,0.017543859649122806,0.7280701754385965
5534,4391577,1477,726,476,64,751,1477,1.0,0.4915368991198375,0.5084631008801624,937,0.3222748815165877,0.043331076506431955,0.6343940419769803
5535,4391578,1924,705,512,162,1219,1924,1.0,0.36642411642411643,0.6335758835758836,1250,0.2661122661122661,0.0841995841995842,0.6496881496881497
5536,4391586,10,2,8,1,8,10,1.125,0.2,0.8,1,0.8,0.1,0.1
5537,4391589,2,1,0,0,1,2,1.0,0.5,0.5,2,0.0,0.0,1.0
5539,4391597,765,203,151,42,562,765,1.0,0.265359477124183,0.734640522875817,572,0.19738562091503267,0.054901960784313725,0.7477124183006536
5540,4391603,4305,1317,663,310,2988,4305,1.0,0.3059233449477352,0.6940766550522648,3332,0.154006968641115,0.07200929152148665,0.7739837398373983
5543,4391608,958,34,288,256,924,958,1.0,0.03549060542797495,0.964509394572025,414,0.30062630480167013,0.267223382045929,0.4321503131524008
5545,4391611,42,5,9,5,37,42,1.0,0.11904761904761904,0.8809523809523809,28,0.21428571428571427,0.11904761904761904,0.6666666666666666
5546,4391617,42,8,14,5,34,42,1.0,0.19047619047619047,0.8095238095238095,23,0.3333333333333333,0.11904761904761904,0.5476190476190477
5547,4391619,51,32,9,2,19,51,1.0,0.6274509803921569,0.37254901960784315,40,0.17647058823529413,0.0392156862745098,0.7843137254901961
5548,4391621,87,30,20,5,57,87,1.0,0.3448275862068966,0.6551724137931034,62,0.22988505747126436,0.05747126436781609,0.7126436781609196
5549,4391622,29,5,15,10,24,29,1.0,0.1724137931034483,0.8275862068965517,4,0.5172413793103449,0.3448275862068966,0.13793103448275862
5552,4391627,321,26,42,137,295,321,1.0,0.08099688473520249,0.9190031152647975,142,0.1308411214953271,0.42679127725856697,0.4423676012461059
5554,4391631,367,104,86,67,263,367,1.0,0.28337874659400547,0.7166212534059946,214,0.23433242506811988,0.18256130790190736,0.5831062670299727
5555,4391633,44,0,12,7,44,44,1.0,0.0,1.0,25,0.2727272727272727,0.1590909090909091,0.5681818181818182
5556,4391639,3666,1790,1374,379,1876,3666,1.0,0.48827059465357336,0.5117294053464266,1913,0.37479541734860883,0.1033824331696672,0.5218221494817239
5557,4391641,3272,1527,873,767,1745,3272,1.0,0.4666870415647922,0.5333129584352079,1632,0.2668092909535452,0.23441320293398532,0.49877750611246946
5558,4391642,2785,1085,759,361,1700,2785,1.0,0.3895870736086176,0.6104129263913824,1665,0.2725314183123878,0.1296229802513465,0.5978456014362658
5560,4391652,102,27,100,1,75,102,2.9705882352941178,0.2647058823529412,0.7352941176470589,1,0.9803921568627451,0.00980392156862745,0.00980392156862745
5563,4391676,450,145,84,54,305,450,1.0,0.32222222222222224,0.6777777777777778,312,0.18666666666666668,0.12,0.6933333333333334
5564,4391677,10,7,5,1,3,10,1.0,0.7,0.3,4,0.5,0.1,0.4
5565,4391678,48,5,8,0,43,48,1.0,0.10416666666666667,0.8958333333333334,40,0.16666666666666666,0.0,0.8333333333333334
5567,4391684,489,9,105,93,480,489,1.0,0.018404907975460124,0.9815950920245399,291,0.2147239263803681,0.1901840490797546,0.5950920245398773
5568,4391701,1827,214,309,389,1613,1827,1.0,0.11713191023535852,0.8828680897646415,1129,0.16912972085385877,0.21291735084838534,0.6179529282977558
5569,4391704,2577,270,194,568,2307,2577,1.0,0.10477299185098952,0.8952270081490105,1815,0.07528133488552581,0.22041133100504462,0.7043073341094296
5570,4392002,2,0,0,0,2,2,1.0,0.0,1.0,2,0.0,0.0,1.0
5571,4392003,1044,0,227,436,1044,1044,1.0,0.0,1.0,381,0.21743295019157088,0.41762452107279696,0.3649425287356322
5572,4392007,2404,199,454,1082,2205,2404,1.0,0.08277870216306156,0.9172212978369384,868,0.18885191347753744,0.45008319467554075,0.3610648918469218
5573,4392026,2180,123,464,754,2057,2180,1.0,0.056422018348623856,0.9435779816513762,962,0.21284403669724772,0.3458715596330275,0.44128440366972477
5574,4392027,1377,169,428,261,1208,1377,1.0,0.12273057371096587,0.8772694262890341,688,0.31082062454611475,0.1895424836601307,0.49963689179375453
5575,4392028,985,140,253,591,845,985,1.0,0.14213197969543148,0.8578680203045685,141,0.2568527918781726,0.6,0.1431472081218274
5576,4392029,4482,331,686,1615,4151,4482,1.0,0.07385095939312807,0.926149040606872,2181,0.1530566711289603,0.3603302097278001,0.4866131191432396
5577,4392030,3969,1885,1337,520,2084,3969,1.0,0.47493071302595113,0.5250692869740489,2112,0.3368606701940035,0.1310153691106072,0.5321239606953893
5578,4392031,5205,2207,1595,726,2998,5205,1.0,0.42401536983669547,0.5759846301633045,2884,0.30643611911623436,0.13948126801152738,0.5540826128722383
5579,4392033,3600,337,387,700,3263,3600,1.0,0.09361111111111112,0.9063888888888889,2513,0.1075,0.19444444444444445,0.6980555555555555
5580,4392052,3312,547,719,570,2765,3312,1.0,0.1651570048309179,0.8348429951690821,2023,0.21708937198067632,0.1721014492753623,0.6108091787439613
5581,4392055,1747,145,498,843,1602,1747,1.0,0.08299942759015455,0.9170005724098454,406,0.28506010303377216,0.48254149971379506,0.23239839725243275
5582,4392058,11,4,0,1,7,11,1.0,0.36363636363636365,0.6363636363636364,10,0.0,0.09090909090909091,0.9090909090909091
5583,4392100,808,77,139,167,731,808,1.0,0.0952970297029703,0.9047029702970297,502,0.17202970297029702,0.20668316831683167,0.6212871287128713
5584,4392112,2082,39,311,1041,2043,2082,1.0,0.018731988472622477,0.9812680115273775,730,0.1493756003842459,0.5,0.3506243996157541
5585,4392134,1775,735,285,103,1040,1775,1.0,0.4140845070422535,0.5859154929577465,1387,0.16056338028169015,0.05802816901408451,0.7814084507042254
5586,4392143,1109,78,196,213,1031,1109,1.0,0.0703336339044184,0.9296663660955816,700,0.17673579801623085,0.1920649233543733,0.6311992786293958
5587,4392145,2707,540,473,270,2167,2707,1.0,0.1994828223125231,0.8005171776874769,1964,0.17473217584041376,0.09974141115626155,0.7255264130033248
5588,4392147,1394,97,261,470,1297,1394,1.0,0.06958393113342898,0.930416068866571,663,0.1872309899569584,0.33715925394548063,0.47560975609756095
5589,4392148,4735,1224,708,352,3511,4735,1.0,0.2585005279831045,0.7414994720168955,3675,0.1495248152059134,0.07434002111932418,0.7761351636747624
5590,4392161,2778,536,619,351,2242,2778,1.0,0.1929445644348452,0.8070554355651548,1808,0.2228221742260619,0.1263498920086393,0.6508279337652988
5591,4392168,3482,531,650,658,2951,3482,1.0,0.15249856404365308,0.847501435956347,2174,0.18667432510051696,0.18897185525560023,0.6243538196438828
5592,4392169,2135,560,400,184,1575,2135,1.0,0.26229508196721313,0.7377049180327869,1551,0.1873536299765808,0.08618266978922717,0.726463700234192
5593,4392171,3542,419,573,1228,3123,3542,1.0,0.11829474872953134,0.8817052512704686,1741,0.16177300959909655,0.34669678147939015,0.4915302089215133
5594,4392173,1063,32,179,559,1031,1063,1.0,0.030103480714957668,0.9698965192850423,325,0.16839134524929444,0.5258701787394168,0.3057384760112888
5595,4392174,2967,357,625,990,2610,2967,1.0,0.12032355915065723,0.8796764408493428,1352,0.2106504887091338,0.33367037411526795,0.45567913717559827
5596,4392180,2841,1241,605,129,1600,2841,1.0,0.43681802182330165,0.5631819781766984,2107,0.21295318549806405,0.0454065469904963,0.7416402675114396
5597,4392181,3200,399,635,1090,2801,3200,1.0,0.1246875,0.8753125,1475,0.1984375,0.340625,0.4609375
5598,4392190,285,75,89,83,210,285,1.0,0.2631578947368421,0.7368421052631579,113,0.312280701754386,0.2912280701754386,0.39649122807017545
5599,4392205,2549,219,473,1119,2330,2549,1.0,0.08591604550804237,0.9140839544919577,957,0.18556296586896823,0.43899568458218907,0.3754413495488427
5600,4392210,1020,44,169,159,976,1020,1.0,0.043137254901960784,0.9568627450980393,692,0.16568627450980392,0.15588235294117647,0.6784313725490196
5601,4392217,4345,1179,918,693,3166,4345,1.0,0.2713463751438435,0.7286536248561565,2734,0.21127733026467205,0.15949367088607594,0.629228998849252
5602,4392219,2446,257,633,1047,2189,2446,1.0,0.10506950122649224,0.8949304987735077,766,0.258789860997547,0.42804578904333607,0.3131643499591169
5603,4392220,2477,189,561,1183,2288,2477,1.0,0.0763019781994348,0.9236980218005651,733,0.22648364957610012,0.4775938635446104,0.29592248687928946
5604,4392221,4884,1154,1188,1570,3730,4884,1.0,0.2362817362817363,0.7637182637182637,2126,0.24324324324324326,0.3214578214578215,0.4352989352989353
5605,4392223,1795,100,305,1028,1695,1795,1.0,0.055710306406685235,0.9442896935933147,462,0.16991643454038996,0.5727019498607242,0.2573816155988858
5606,4392224,2951,1036,634,480,1915,2951,1.0,0.3510674347678753,0.6489325652321247,1837,0.21484242629617079,0.1626567265333785,0.6225008471704507
5607,4392225,3282,733,538,156,2549,3282,1.0,0.22333942717854965,0.7766605728214503,2588,0.1639244363193175,0.04753199268738574,0.7885435709932967
5608,4392226,2716,635,585,356,2081,2716,1.0,0.23379970544919,0.7662002945508101,1775,0.21539027982326953,0.13107511045655376,0.6535346097201767
5609,4392228,2218,42,486,1182,2176,2218,1.0,0.018935978358881875,0.9810640216411182,550,0.21911632100991885,0.5329125338142471,0.24797114517583407
5610,4392229,2407,301,560,819,2106,2407,1.0,0.1250519318653926,0.8749480681346073,1028,0.23265475695886997,0.3402575820523473,0.4270876609887827
5611,4392235,4293,646,848,538,3647,4293,1.0,0.15047752154670394,0.8495224784532961,2907,0.19753086419753085,0.12532028884230142,0.6771488469601677
5612,4392246,1110,39,239,604,1071,1110,1.0,0.03513513513513514,0.9648648648648649,267,0.2153153153153153,0.5441441441441441,0.24054054054054055
5613,4392258,729,66,88,266,663,729,1.0,0.09053497942386832,0.9094650205761317,375,0.12071330589849108,0.36488340192043894,0.51440329218107
5614,4392262,1026,59,121,421,967,1026,1.0,0.057504873294346975,0.942495126705653,484,0.11793372319688109,0.41033138401559455,0.47173489278752434
5615,4392263,2670,274,545,383,2396,2670,1.0,0.10262172284644194,0.897378277153558,1742,0.20411985018726592,0.14344569288389514,0.652434456928839
5616,4392266,3399,304,641,1342,3095,3399,1.0,0.0894380700205943,0.9105619299794057,1416,0.18858487790526626,0.3948220064724919,0.4165931156222418
5617,4392267,3312,704,707,414,2608,3312,1.0,0.21256038647342995,0.7874396135265701,2191,0.21346618357487923,0.125,0.6615338164251208
5618,4392268,1780,485,422,293,1295,1780,1.0,0.27247191011235955,0.7275280898876404,1065,0.23707865168539327,0.1646067415730337,0.598314606741573
5619,4392269,595,136,125,139,459,595,1.0,0.22857142857142856,0.7714285714285715,331,0.21008403361344538,0.23361344537815126,0.5563025210084034
5620,4392275,823,164,294,248,659,823,1.0,0.19927095990279464,0.8007290400972054,281,0.3572296476306197,0.30133657351154314,0.34143377885783716
5621,4392280,1737,132,397,692,1605,1737,1.0,0.07599309153713299,0.924006908462867,648,0.22855497985031664,0.3983880253310305,0.37305699481865284
5622,4392281,1728,345,350,551,1383,1728,1.0,0.1996527777777778,0.8003472222222222,827,0.2025462962962963,0.31886574074074076,0.47858796296296297
5623,4392299,1778,581,553,261,1197,1778,1.0,0.32677165354330706,0.6732283464566929,964,0.3110236220472441,0.14679415073115862,0.5421822272215973
5624,4392302,2875,1679,707,182,1196,2875,1.0,0.584,0.416,1986,0.24591304347826087,0.06330434782608696,0.6907826086956522
5625,4392303,2453,342,447,976,2111,2453,1.0,0.13942111699959234,0.8605788830004076,1030,0.18222584590297594,0.3978801467590705,0.4198940073379535
5626,4392304,2207,335,456,1097,1872,2207,1.0,0.15178975985500678,0.8482102401449932,654,0.20661531490711374,0.4970548255550521,0.29632985953783414
5627,4392305,2045,250,468,690,1795,2045,1.0,0.12224938875305623,0.8777506112469438,887,0.22885085574572128,0.3374083129584352,0.4337408312958435
5628,4392306,2130,144,377,980,1986,2130,1.0,0.0676056338028169,0.9323943661971831,773,0.17699530516431924,0.460093896713615,0.3629107981220657
5629,4392307,4325,523,925,1728,3802,4325,1.0,0.12092485549132947,0.8790751445086705,1672,0.2138728323699422,0.3995375722543353,0.3865895953757225
5630,4392308,3570,370,509,890,3200,3570,1.0,0.10364145658263306,0.896358543417367,2171,0.14257703081232492,0.24929971988795518,0.6081232492997198
5631,4392309,2463,72,372,313,2391,2463,1.0,0.029232643118148598,0.9707673568818515,1778,0.1510353227771011,0.1270807957775071,0.7218838814453918
5632,4392310,2511,502,441,689,2009,2511,1.0,0.19992035045798487,0.8000796495420152,1381,0.17562724014336917,0.2743926722421346,0.5499800876144962
5633,4392313,2315,220,501,1088,2095,2315,1.0,0.09503239740820735,0.9049676025917927,726,0.216414686825054,0.46997840172786176,0.31360691144708425
5634,4392314,3580,85,654,1522,3495,3580,1.0,0.023743016759776536,0.9762569832402235,1404,0.18268156424581006,0.4251396648044693,0.39217877094972065
5635,4392315,2940,774,542,410,2166,2940,1.0,0.26326530612244897,0.736734693877551,1988,0.18435374149659864,0.13945578231292516,0.6761904761904762
5636,4392316,2625,768,507,563,1857,2625,1.0,0.2925714285714286,0.7074285714285714,1555,0.19314285714285714,0.2144761904761905,0.5923809523809523
5637,4392317,1205,67,280,577,1138,1205,1.0,0.05560165975103734,0.9443983402489626,348,0.23236514522821577,0.47883817427385894,0.2887966804979253
5638,4392318,2149,262,356,798,1887,2149,1.0,0.12191717077710564,0.8780828292228944,995,0.16565844578873895,0.3713355048859935,0.46300604932526757
5639,4392319,2782,222,498,1082,2560,2782,1.0,0.07979870596693027,0.9202012940330697,1202,0.1790079079798706,0.38892882818116464,0.43206326383896476
5640,4392320,2979,890,707,339,2089,2979,1.0,0.29875797247398456,0.7012420275260154,1933,0.2373279624034911,0.11379657603222558,0.6488754615642833
5641,4392341,499,169,147,78,330,499,1.0,0.33867735470941884,0.6613226452905812,274,0.29458917835671344,0.156312625250501,0.5490981963927856
5642,4392349,1558,482,563,407,1076,1558,1.0,0.30937098844672656,0.6906290115532734,588,0.3613607188703466,0.2612323491655969,0.3774069319640565
5643,4392353,1867,492,405,290,1375,1867,1.0,0.2635243706480985,0.7364756293519015,1172,0.21692554900910552,0.15532940546331012,0.6277450455275844
5644,4392354,3150,845,788,536,2305,3150,1.0,0.26825396825396824,0.7317460317460317,1826,0.25015873015873014,0.17015873015873015,0.5796825396825397
5645,4392355,1695,242,313,579,1453,1695,1.0,0.14277286135693215,0.8572271386430679,803,0.18466076696165193,0.3415929203539823,0.4737463126843658
5646,4392356,4034,771,807,1027,3263,4034,1.0,0.19112543381259295,0.808874566187407,2200,0.20004957858205255,0.2545860188398612,0.5453644025780863
5647,4392357,3140,520,516,1258,2620,3140,1.0,0.16560509554140126,0.8343949044585988,1366,0.1643312101910828,0.40063694267515926,0.435031847133758
5648,4392358,2589,610,486,1151,1979,2589,1.0,0.23561220548474315,0.7643877945152568,952,0.18771726535341832,0.44457319428350717,0.36770954036307457
5649,4392360,3449,495,491,1511,2954,3449,1.0,0.14351986082922585,0.8564801391707741,1447,0.1423601043780806,0.4380979994201218,0.4195418962017976
5650,4392379,4110,1758,1169,617,2352,4110,1.0,0.42773722627737226,0.5722627737226277,2324,0.28442822384428224,0.15012165450121653,0.5654501216545013
5651,4392381,1100,588,365,163,512,1100,1.0,0.5345454545454545,0.46545454545454545,572,0.33181818181818185,0.1481818181818182,0.52
5652,4392383,2892,745,755,541,2147,2892,1.0,0.25760719225449513,0.7423928077455049,1596,0.26106500691562934,0.18706777316735823,0.5518672199170125
5653,4392393,276,26,119,111,250,276,1.0,0.09420289855072464,0.9057971014492754,46,0.4311594202898551,0.40217391304347827,0.16666666666666666
5654,4392401,550,67,84,131,483,550,1.0,0.12181818181818181,0.8781818181818182,335,0.15272727272727274,0.2381818181818182,0.6090909090909091
5655,4392402,41,18,0,10,23,41,1.0,0.43902439024390244,0.5609756097560976,31,0.0,0.24390243902439024,0.7560975609756098
5656,4392403,77,16,17,5,61,77,1.0,0.2077922077922078,0.7922077922077922,55,0.22077922077922077,0.06493506493506493,0.7142857142857143
5657,4392405,5255,2119,1539,818,3136,5255,1.0,0.4032350142721218,0.5967649857278782,2898,0.2928639391056137,0.15566127497621313,0.5514747859181731
5658,4392411,888,399,156,42,489,888,1.0,0.44932432432432434,0.5506756756756757,690,0.17567567567567569,0.0472972972972973,0.777027027027027
5659,4392413,993,361,183,92,632,993,1.0,0.3635448136958711,0.6364551863041289,718,0.18429003021148035,0.09264853977844914,0.7230614300100705
5661,4392425,4280,1169,823,927,3111,4280,1.0,0.2731308411214953,0.7268691588785047,2530,0.19228971962616823,0.21658878504672896,0.5911214953271028
5662,4392426,2517,219,466,1113,2298,2517,1.0,0.08700834326579261,0.9129916567342073,938,0.18514104092173223,0.44219308700834326,0.3726658720699245
5663,4392428,843,154,144,98,689,843,1.0,0.1826809015421115,0.8173190984578885,601,0.1708185053380783,0.1162514827995255,0.7129300118623962
5664,4392435,2334,293,456,788,2041,2334,1.0,0.12553556126820908,0.8744644387317909,1090,0.1953727506426735,0.337617823479006,0.4670094258783205
5665,4392438,3530,1379,908,522,2151,3530,1.0,0.39065155807365437,0.6093484419263456,2100,0.2572237960339943,0.14787535410764874,0.5949008498583569
5666,4392442,2,0,1,0,2,2,1.0,0.0,1.0,1,0.5,0.0,0.5
5667,4392448,3487,947,1088,609,2540,3487,1.0,0.27158015486091197,0.7284198451390881,1790,0.3120160596501291,0.174648695153427,0.5133352451964439
5668,4392449,2416,620,743,486,1796,2416,1.0,0.25662251655629137,0.7433774834437086,1187,0.30753311258278143,0.201158940397351,0.4913079470198676
5669,4392450,4223,1550,883,459,2673,4223,1.0,0.36703765095903385,0.6329623490409662,2881,0.20909306180440446,0.10869050438077196,0.6822164338148236
5670,4392451,316,19,76,19,297,316,1.0,0.060126582278481014,0.939873417721519,221,0.24050632911392406,0.060126582278481014,0.6993670886075949
5671,4392453,1062,409,465,294,653,1062,1.0,0.3851224105461394,0.6148775894538606,303,0.4378531073446328,0.2768361581920904,0.2853107344632768
5672,4392461,2910,1010,928,248,1900,2910,1.0,0.3470790378006873,0.6529209621993127,1734,0.31890034364261166,0.0852233676975945,0.5958762886597938
5673,4392462,2216,775,593,353,1441,2216,1.0,0.3497292418772563,0.6502707581227437,1270,0.2675992779783393,0.1592960288808664,0.5731046931407943
5674,4392464,480,25,101,197,455,480,1.0,0.052083333333333336,0.9479166666666666,182,0.21041666666666667,0.41041666666666665,0.37916666666666665
5675,4392466,1106,145,460,240,961,1106,1.0,0.13110307414104883,0.8688969258589512,406,0.4159132007233273,0.21699819168173598,0.3670886075949367
5676,4392467,3249,974,853,605,2275,3249,1.0,0.29978454909202834,0.7002154509079717,1791,0.26254232071406586,0.18621114188981225,0.5512465373961218
5677,4392468,2777,211,565,965,2566,2777,1.0,0.07598127475693194,0.924018725243068,1247,0.20345696795102627,0.34749729924378825,0.44904573280518545
5678,4392474,675,32,53,167,643,675,1.0,0.047407407407407405,0.9525925925925925,455,0.07851851851851852,0.2474074074074074,0.674074074074074
5679,4392484,4560,1760,1327,573,2800,4560,1.0,0.38596491228070173,0.6140350877192983,2660,0.29100877192982455,0.1256578947368421,0.5833333333333334
5680,4392488,3037,1203,790,485,1834,3037,1.0,0.39611458676325323,0.6038854132367468,1762,0.2601251234771156,0.15969706947645704,0.5801778070464274
5681,4392505,1800,119,301,731,1681,1800,1.0,0.0661111111111111,0.9338888888888889,768,0.16722222222222222,0.4061111111111111,0.4266666666666667
5682,4392506,5324,351,976,1804,4973,5324,1.0,0.06592787377911345,0.9340721262208865,2544,0.18332081141998496,0.33884297520661155,0.47783621337340343
5684,4392519,1612,465,353,286,1147,1612,1.0,0.28846153846153844,0.7115384615384616,973,0.21898263027295287,0.1774193548387097,0.6035980148883374
5685,4392520,1756,197,493,708,1559,1756,1.0,0.1121867881548975,0.8878132118451025,555,0.28075170842824604,0.4031890660592255,0.31605922551252846
5686,4392521,1629,304,279,516,1325,1629,1.0,0.18661755678330263,0.8133824432166974,834,0.1712707182320442,0.31675874769797424,0.5119705340699816
5687,4392522,4177,783,722,1393,3394,4177,1.0,0.18745511132391668,0.8125448886760833,2062,0.17285132870481207,0.3334929375149629,0.49365573378022504
5688,4392523,1848,543,580,298,1305,1848,1.0,0.29383116883116883,0.7061688311688312,970,0.31385281385281383,0.16125541125541126,0.5248917748917749
5689,4392524,2332,61,269,1422,2271,2332,1.0,0.026157804459691254,0.9738421955403087,641,0.1153516295025729,0.6097770154373928,0.2748713550600343
5690,4392525,3249,1665,1177,562,1584,3249,1.0,0.5124653739612188,0.48753462603878117,1510,0.36226531240381654,0.17297630040012313,0.46475838719606033
5691,4392535,1750,170,334,823,1580,1750,1.0,0.09714285714285714,0.9028571428571428,593,0.19085714285714286,0.4702857142857143,0.33885714285714286
5692,4392536,2073,545,566,630,1528,2073,1.0,0.26290400385914137,0.7370959961408586,877,0.27303424987940184,0.30390738060781475,0.4230583695127834
5693,4392537,2429,1155,583,269,1274,2429,1.0,0.4755043227665706,0.5244956772334294,1577,0.24001646768217375,0.11074516261836147,0.6492383696994648
5694,4392541,2657,900,833,494,1757,2657,1.0,0.3387278885961611,0.6612721114038389,1330,0.3135114791117802,0.1859239744072262,0.5005645464809936
5695,4392546,190,84,6,0,106,190,1.0,0.4421052631578947,0.5578947368421052,184,0.031578947368421054,0.0,0.968421052631579
5696,4392548,1647,65,246,805,1582,1647,1.0,0.03946569520340012,0.9605343047965998,596,0.1493624772313297,0.48876745598057075,0.3618700667880996
5697,4392553,1878,427,456,322,1451,1878,1.0,0.2273695420660277,0.7726304579339723,1100,0.24281150159744408,0.17145899893503727,0.5857294994675186
5698,4392556,1902,230,404,840,1672,1902,1.0,0.12092534174553102,0.879074658254469,658,0.21240799158780233,0.4416403785488959,0.3459516298633018
5699,4392557,1478,374,470,229,1104,1478,1.0,0.2530446549391069,0.7469553450608931,779,0.31799729364005414,0.15493910690121787,0.527063599458728
5701,4392569,135,20,25,4,115,135,1.0,0.14814814814814814,0.8518518518518519,106,0.18518518518518517,0.02962962962962963,0.7851851851851852
5703,4392581,3142,1044,734,590,2098,3142,1.0,0.33227243793761935,0.6677275620623806,1818,0.23360916613621896,0.18777848504137493,0.5786123488224061
5706,4392606,23,0,7,4,23,23,1.0,0.0,1.0,12,0.30434782608695654,0.17391304347826086,0.5217391304347826
5709,4392613,1513,497,603,248,1016,1513,1.0,0.3284864507600793,0.6715135492399207,662,0.3985459352280238,0.16391275611368142,0.43754130865829477
5710,4392614,117,30,57,59,87,117,1.5675675675675675,0.2564102564102564,0.7435897435897436,1,0.48717948717948717,0.5042735042735043,0.008547008547008548
5711,4392616,105,30,17,13,75,105,1.0,0.2857142857142857,0.7142857142857143,75,0.1619047619047619,0.12380952380952381,0.7142857142857143
5712,4392618,6,2,2,2,4,6,1.0,0.3333333333333333,0.6666666666666666,2,0.3333333333333333,0.3333333333333333,0.3333333333333333
5713,4392635,5262,1836,1407,818,3426,5262,1.0,0.34891676168757124,0.6510832383124288,3037,0.26738882554161914,0.15545419992398327,0.5771569745343975
5714,4392636,3655,495,481,1028,3160,3655,1.0,0.1354309165526676,0.8645690834473324,2146,0.13160054719562245,0.28125854993160054,0.587140902872777
5715,4392643,5076,1636,1044,1122,3440,5076,1.0,0.322301024428684,0.677698975571316,2910,0.20567375886524822,0.22104018912529552,0.5732860520094563
5716,4392644,2175,805,417,337,1370,2175,1.0,0.3701149425287356,0.6298850574712643,1421,0.1917241379310345,0.1549425287356322,0.6533333333333333
5717,4392645,2306,224,376,988,2082,2306,1.0,0.0971379011274935,0.9028620988725065,942,0.16305290546400694,0.4284475281873374,0.4084995663486557
5718,4392655,1723,503,305,245,1220,1723,1.0,0.2919326755658735,0.7080673244341266,1173,0.17701683110853164,0.14219384793964016,0.6807893209518282
5719,4392656,137,27,26,20,110,137,1.0,0.19708029197080293,0.8029197080291971,91,0.1897810218978102,0.145985401459854,0.6642335766423357
5720,4392657,39,11,8,4,28,39,1.0,0.28205128205128205,0.717948717948718,27,0.20512820512820512,0.10256410256410256,0.6923076923076923
5721,4392658,556,282,170,69,274,556,1.0,0.5071942446043165,0.49280575539568344,317,0.3057553956834532,0.12410071942446044,0.5701438848920863
5722,4392659,29,6,5,2,23,29,1.0,0.20689655172413793,0.7931034482758621,22,0.1724137931034483,0.06896551724137931,0.7586206896551724
5723,4392660,208,8,48,73,200,208,1.0,0.038461538461538464,0.9615384615384616,87,0.23076923076923078,0.35096153846153844,0.4182692307692308
5724,4392670,175,49,45,29,126,175,1.0,0.28,0.72,101,0.2571428571428571,0.1657142857142857,0.5771428571428572
5729,4392697,3336,1268,512,545,2068,3336,1.0,0.3800959232613909,0.6199040767386091,2279,0.15347721822541965,0.16336930455635493,0.6831534772182254
5730,4392699,3719,1013,882,710,2706,3719,1.0,0.27238504974455496,0.727614950255445,2127,0.23716052702339338,0.19091153535896746,0.5719279376176392
5731,4393032,1686,26,258,589,1660,1686,1.0,0.01542111506524318,0.9845788849347569,839,0.15302491103202848,0.34934756820877816,0.49762752075919336
5732,4393035,3988,194,680,1798,3794,3988,1.0,0.04864593781344032,0.9513540621865597,1510,0.17051153460381144,0.45085255767301907,0.3786359077231695
5733,4393036,2860,85,468,649,2775,2860,1.0,0.02972027972027972,0.9702797202797203,1743,0.16363636363636364,0.22692307692307692,0.6094405594405594
5734,4393037,2761,46,518,1378,2715,2761,1.0,0.01666063020644694,0.9833393697935531,865,0.18761318362911988,0.49909453096704093,0.3132922854038392
5735,4393038,4097,389,615,1172,3708,4097,1.0,0.09494752257749572,0.9050524774225043,2310,0.1501098364657066,0.2860629729070051,0.5638271906272883
5736,4393039,3792,80,431,1712,3712,3792,1.0,0.02109704641350211,0.9789029535864979,1649,0.11366033755274262,0.45147679324894513,0.43486286919831224
5737,4393040,4073,228,431,1463,3845,4073,1.0,0.055978394303952864,0.9440216056960471,2179,0.10581880677633194,0.35919469678369753,0.5349864964399705
5738,4393041,3031,327,419,766,2704,3031,1.0,0.10788518640712635,0.8921148135928736,1846,0.13823820521280106,0.25272187396898715,0.6090399208182118
5739,4393043,3140,260,398,1220,2880,3140,1.0,0.08280254777070063,0.9171974522292994,1522,0.1267515923566879,0.3885350318471338,0.48471337579617835
5740,4393049,3057,88,403,1528,2969,3057,1.0,0.028786391887471376,0.9712136081125287,1126,0.1318285901210337,0.4998364409551848,0.3683349689237815
5741,4393054,3768,25,570,1636,3743,3768,1.0,0.006634819532908705,0.9933651804670913,1562,0.15127388535031847,0.43418259023354566,0.4145435244161359
5742,4393063,4350,375,544,1731,3975,4350,1.0,0.08620689655172414,0.9137931034482759,2075,0.1250574712643678,0.3979310344827586,0.47701149425287354
5743,4393072,2536,0,388,1397,2536,2536,1.0,0.0,1.0,751,0.1529968454258675,0.5508675078864353,0.29613564668769715
5744,4393114,3100,45,436,1006,3055,3100,1.0,0.014516129032258065,0.9854838709677419,1658,0.1406451612903226,0.32451612903225807,0.5348387096774193
5745,4393131,2090,71,311,723,2019,2090,1.0,0.03397129186602871,0.9660287081339712,1056,0.14880382775119616,0.345933014354067,0.5052631578947369
5746,4393139,1931,297,238,489,1634,1931,1.0,0.15380631796996375,0.8461936820300362,1204,0.12325220093215951,0.2532366649404454,0.6235111341273951
5747,4393140,2160,83,281,790,2077,2160,1.0,0.038425925925925926,0.961574074074074,1089,0.1300925925925926,0.36574074074074076,0.5041666666666667
5748,4393152,55,4,4,18,51,55,1.0,0.07272727272727272,0.9272727272727272,33,0.07272727272727272,0.32727272727272727,0.6
5749,4393156,1686,1,286,918,1685,1686,1.0,0.0005931198102016608,0.9994068801897983,482,0.16963226571767498,0.5444839857651246,0.2858837485172005
5750,4393157,3064,435,517,800,2629,3064,1.0,0.14197127937336815,0.8580287206266318,1747,0.168733681462141,0.26109660574412535,0.5701697127937336
5751,4393160,3149,264,572,724,2885,3149,1.0,0.0838361384566529,0.9161638615433471,1853,0.1816449666560813,0.22991425849476024,0.5884407748491585
5752,4393164,2398,65,422,712,2333,2398,1.0,0.027105921601334446,0.9728940783986656,1264,0.17597998331943285,0.2969140950792327,0.5271059216013344
5753,4393166,3279,612,554,698,2667,3279,1.0,0.18664226898444647,0.8133577310155535,2027,0.1689539493748094,0.21286977737114973,0.6181762732540409
5754,4393172,3157,490,523,1041,2667,3157,1.0,0.15521064301552107,0.844789356984479,1593,0.16566360468799493,0.3297434273044029,0.5045929680076021
5755,4393176,3797,302,649,1228,3495,3797,1.0,0.07953647616539374,0.9204635238346063,1920,0.17092441401106137,0.3234132209639189,0.5056623650250197
5756,4393177,2600,89,235,1029,2511,2600,1.0,0.03423076923076923,0.9657692307692308,1336,0.09038461538461538,0.39576923076923076,0.5138461538461538
5757,4393183,4297,476,788,1307,3821,4297,1.0,0.11077495927391204,0.889225040726088,2202,0.1833837561089132,0.3041656969979055,0.5124505468931813
5759,4393187,1894,29,292,580,1865,1894,1.0,0.015311510031678986,0.984688489968321,1022,0.15417106652587118,0.30623020063357975,0.5395987328405492
5760,4393192,984,0,86,423,984,984,1.0,0.0,1.0,475,0.08739837398373984,0.4298780487804878,0.48272357723577236
5761,4393193,3084,38,397,1478,3046,3084,1.0,0.01232166018158236,0.9876783398184177,1209,0.12872892347600517,0.4792477302204929,0.39202334630350194
5762,4393194,2855,48,389,773,2807,2855,1.0,0.01681260945709282,0.9831873905429072,1693,0.13625218914185638,0.27075306479859895,0.5929947460595446
5763,4393196,2137,59,385,1081,2078,2137,1.0,0.027608797379503978,0.972391202620496,671,0.18015910154422088,0.5058493214787084,0.31399157697707064
5764,4393200,2822,262,529,993,2560,2822,1.0,0.09284195605953224,0.9071580439404677,1300,0.18745570517363572,0.3518781006378455,0.4606661941885188
5765,4393209,3739,123,471,1945,3616,3739,1.0,0.03289649638940893,0.967103503610591,1323,0.125969510564322,0.5201925648569136,0.3538379245787644
5766,4393212,2901,238,462,715,2663,2901,1.0,0.08204067562909341,0.9179593243709065,1724,0.1592554291623578,0.2464667356084109,0.5942778352292313
5767,4393213,1953,22,328,694,1931,1953,1.0,0.011264720942140297,0.9887352790578597,931,0.1679467485919099,0.35535074244751663,0.4767025089605735
5768,4393214,3088,114,452,1059,2974,3088,1.0,0.036917098445595854,0.9630829015544041,1577,0.14637305699481865,0.342940414507772,0.5106865284974094
5769,4393215,2705,0,376,1224,2705,2705,1.0,0.0,1.0,1105,0.13900184842883548,0.45249537892791125,0.40850277264325324
5770,4393216,3710,115,716,1256,3595,3710,1.0,0.03099730458221024,0.9690026954177897,1738,0.19299191374663072,0.33854447439353097,0.46846361185983826
5771,4393240,3724,915,415,872,2809,3724,1.0,0.24570354457572502,0.7542964554242749,2437,0.11143931256713212,0.23415682062298604,0.6544038668098818
5772,4393247,2269,502,417,531,1767,2269,1.0,0.22124283825473778,0.7787571617452622,1321,0.18378140149845748,0.23402379903040987,0.5821947994711326
5773,4393248,3747,117,686,2135,3630,3747,1.0,0.03122497998398719,0.9687750200160128,926,0.1830797971710702,0.5697891646650654,0.24713103816386442
5774,4393249,4204,816,774,1238,3388,4204,1.0,0.19410085632730734,0.8058991436726927,2192,0.1841103710751665,0.2944814462416746,0.5214081826831589
5775,4393254,2942,155,495,827,2787,2942,1.0,0.05268524813052345,0.9473147518694766,1620,0.16825288919102652,0.28110129163834124,0.5506458191706323
5776,4393260,1494,24,271,762,1470,1494,1.0,0.01606425702811245,0.9839357429718876,461,0.1813922356091031,0.5100401606425703,0.30856760374832665
5777,4393282,1937,53,286,810,1884,1937,1.0,0.027361899845121322,0.9726381001548787,841,0.1476510067114094,0.41817243159525036,0.43417656169334023
5778,4393283,1893,58,333,827,1835,1893,1.0,0.0306391970417327,0.9693608029582673,733,0.17591125198098256,0.4368726888536714,0.387216059165346
5779,4393286,491,3,38,387,488,491,1.0,0.006109979633401222,0.9938900203665988,66,0.07739307535641547,0.7881873727087576,0.13441955193482688
5780,4393287,3032,171,440,951,2861,3032,1.0,0.05639841688654353,0.9436015831134564,1641,0.14511873350923482,0.3136543535620053,0.5412269129287599
5781,4393289,3548,149,468,970,3399,3548,1.0,0.04199549041713641,0.9580045095828635,2110,0.1319052987598647,0.2733934611048478,0.5947012401352875
5782,4393321,5509,128,792,1751,5381,5509,1.0,0.02323470684334725,0.9767652931566527,2966,0.14376474859321112,0.31784352877110184,0.538391722635687
5783,4393322,1825,29,440,1022,1796,1825,1.0,0.01589041095890411,0.9841095890410959,363,0.2410958904109589,0.56,0.1989041095890411
5784,4393323,3212,71,499,1908,3141,3212,1.0,0.02210460772104608,0.977895392278954,805,0.1553549190535492,0.5940224159402242,0.25062266500622665
5785,4393324,2887,189,375,972,2698,2887,1.0,0.06546588153792865,0.9345341184620714,1540,0.12989262209906477,0.3366816764807759,0.5334257014201593
5786,4393325,1269,0,185,482,1269,1269,1.0,0.0,1.0,602,0.1457840819542947,0.3798266351457841,0.4743892828999212
5787,4393326,1182,71,211,318,1111,1182,1.0,0.06006768189509306,0.939932318104907,653,0.1785109983079526,0.26903553299492383,0.5524534686971235
5788,4393327,1716,162,332,785,1554,1716,1.0,0.0944055944055944,0.9055944055944056,599,0.19347319347319347,0.4574592074592075,0.34906759906759904
5789,4393329,2750,150,594,718,2600,2750,1.0,0.05454545454545454,0.9454545454545454,1438,0.216,0.2610909090909091,0.5229090909090909
5790,4393330,1110,0,185,679,1110,1110,1.0,0.0,1.0,246,0.16666666666666666,0.6117117117117117,0.22162162162162163
5791,4393331,3697,209,420,2123,3488,3697,1.0,0.05653232350554504,0.943467676494455,1154,0.11360562618339194,0.5742493913984311,0.3121449824181769
5792,4393332,4148,188,579,981,3960,4148,1.0,0.04532304725168756,0.9546769527483124,2588,0.13958534233365477,0.23649951783992285,0.6239151398264223
5793,4393333,6224,355,853,1789,5869,6224,1.0,0.057037275064267354,0.9429627249357326,3582,0.13705012853470436,0.2874357326478149,0.5755141388174807
5794,4393334,2628,283,489,756,2345,2628,1.0,0.10768645357686453,0.8923135464231354,1383,0.1860730593607306,0.2876712328767123,0.526255707762557
5795,4393335,2725,126,452,1032,2599,2725,1.0,0.04623853211009174,0.9537614678899082,1241,0.16587155963302752,0.37871559633027524,0.45541284403669724
5796,4393336,3133,295,594,688,2838,3133,1.0,0.0941589530801149,0.9058410469198851,1851,0.1895946377274178,0.21959782955633578,0.5908075327162464
5797,4393359,1908,26,329,1212,1882,1908,1.0,0.013626834381551363,0.9863731656184487,367,0.17243186582809225,0.6352201257861635,0.19234800838574423
5798,4393361,4029,35,533,1171,3994,4029,1.0,0.008687019111442046,0.9913129808885579,2325,0.13229089103996028,0.29064283941424673,0.577066269545793
5799,4393364,1757,295,174,303,1462,1757,1.0,0.16789982925441094,0.8321001707455891,1280,0.09903244166192374,0.17245304496300512,0.7285145133750711
5800,4393365,3720,80,512,2011,3640,3720,1.0,0.021505376344086023,0.978494623655914,1197,0.13763440860215054,0.5405913978494624,0.3217741935483871
5801,4393367,1730,85,297,788,1645,1730,1.0,0.049132947976878616,0.9508670520231214,645,0.17167630057803468,0.4554913294797688,0.37283236994219654
5802,4393368,817,0,129,465,817,817,1.0,0.0,1.0,223,0.15789473684210525,0.5691554467564259,0.2729498164014688
5803,4393372,3644,207,472,1196,3437,3644,1.0,0.056805708013172335,0.9431942919868277,1976,0.12952799121844127,0.32821075740944017,0.5422612513721186
5804,4393384,1893,155,335,636,1738,1893,1.0,0.08188061278394083,0.9181193872160591,922,0.1769677760169044,0.3359746434231379,0.48705758055995774
5805,4393385,2593,125,512,1559,2468,2593,1.0,0.04820671037408407,0.9517932896259159,522,0.19745468569224836,0.6012340917855765,0.2013112225221751
5806,4393386,5061,51,501,1794,5010,5061,1.0,0.01007705986959099,0.989922940130409,2766,0.0989922940130409,0.35447540011855366,0.5465323058684054
5807,4393387,2030,5,306,1130,2025,2030,1.0,0.0024630541871921183,0.9975369458128078,594,0.15073891625615762,0.5566502463054187,0.29261083743842364
5808,4393389,4594,385,858,1238,4209,4594,1.0,0.08380496299521115,0.9161950370047889,2498,0.18676534610361342,0.2694819329560296,0.543752720940357
5809,4393390,3963,0,554,2155,3963,3963,1.0,0.0,1.0,1254,0.1397930860459248,0.5437799646732273,0.31642694928084786
5810,4393391,3596,473,676,773,3123,3596,1.0,0.13153503893214682,0.8684649610678532,2147,0.18798665183537264,0.21496106785317018,0.5970522803114572
5811,4393392,1926,0,344,1171,1926,1926,1.0,0.0,1.0,411,0.1786085150571132,0.6079958463136034,0.21339563862928349
5812,4393396,2988,105,561,1399,2883,2988,1.0,0.035140562248995984,0.964859437751004,1028,0.18775100401606426,0.4682061579651941,0.34404283801874164
5813,4393398,1714,37,281,607,1677,1714,1.0,0.021586931155192533,0.9784130688448075,826,0.16394399066511084,0.3541423570595099,0.48191365227537925
5815,4393409,250,53,5,24,197,250,1.0,0.212,0.788,221,0.02,0.096,0.884
5816,4393417,2843,464,270,615,2379,2843,1.0,0.1632078790010552,0.8367921209989447,1958,0.09497010200492438,0.21632078790010553,0.6887091100949702
5817,4393421,1410,0,195,760,1410,1410,1.0,0.0,1.0,455,0.13829787234042554,0.5390070921985816,0.32269503546099293
5818,4393422,3793,19,470,1913,3774,3793,1.0,0.005009227524387028,0.994990772475613,1410,0.12391247034010018,0.5043501186395992,0.37173741102030056
5819,4393433,660,28,116,323,632,660,1.0,0.04242424242424243,0.9575757575757575,221,0.17575757575757575,0.4893939393939394,0.33484848484848484
5820,4393443,2429,145,500,1055,2284,2429,1.0,0.05969534787978592,0.9403046521202141,874,0.20584602717167558,0.4343351173322355,0.35981885549608894
5823,4393465,4744,700,527,1180,4044,4744,1.0,0.1475548060708263,0.8524451939291737,3037,0.11108768971332209,0.2487352445193929,0.640177065767285
5824,4393470,96,0,22,44,96,96,1.0,0.0,1.0,30,0.22916666666666666,0.4583333333333333,0.3125
5825,4393471,1536,51,226,927,1485,1536,1.0,0.033203125,0.966796875,383,0.14713541666666666,0.603515625,0.24934895833333334
5826,4393486,4963,405,711,1912,4558,4963,1.0,0.08160386862784606,0.9183961313721539,2340,0.14326012492444087,0.385250856336893,0.4714890187386661
5827,4393500,300,4,44,201,296,300,1.0,0.013333333333333334,0.9866666666666667,55,0.14666666666666667,0.67,0.18333333333333332
5828,4393502,1362,6,166,911,1356,1362,1.0,0.004405286343612335,0.9955947136563876,285,0.12187958883994127,0.6688693098384728,0.2092511013215859
5829,4393507,3239,115,452,917,3124,3239,1.0,0.03550478542760111,0.9644952145723988,1870,0.13954924359370177,0.2831120716270454,0.5773386847792529
5830,4393509,2502,116,356,831,2386,2502,1.0,0.04636290967226219,0.9536370903277378,1315,0.14228617106314947,0.33213429256594723,0.5255795363709033
5831,4393510,2969,30,441,1711,2939,2969,1.0,0.010104412260020209,0.9898955877399798,817,0.14853486022229706,0.5762883125631526,0.27517682721455033
5832,4393511,3932,544,769,776,3388,3932,1.0,0.13835198372329605,0.861648016276704,2387,0.19557477110885046,0.19735503560528994,0.6070701932858596
5833,4393516,1790,0,365,1051,1790,1790,1.0,0.0,1.0,374,0.20391061452513967,0.5871508379888268,0.20893854748603352
5834,4393517,3706,600,489,770,3106,3706,1.0,0.16189962223421478,0.8381003777657852,2447,0.13194819212088504,0.2077711818672423,0.6602806260118727
5835,4393526,1159,0,192,632,1159,1159,1.0,0.0,1.0,335,0.16566005176876616,0.545297670405522,0.28904227782571185
5836,4393527,2582,155,384,1031,2427,2582,1.0,0.06003098373353989,0.9399690162664601,1167,0.14872192099147946,0.3993028659953524,0.45197521301316806
5837,4393529,2133,19,291,1214,2114,2133,1.0,0.008907641819034223,0.9910923581809657,628,0.13642756680731363,0.5691514299109236,0.2944210032817628
5838,4393530,2807,10,510,1368,2797,2807,1.0,0.003562522265764161,0.9964374777342359,929,0.18168863555397222,0.4873530459565372,0.33095831848949053
5839,4393538,3319,92,530,1935,3227,3319,1.0,0.02771919252786984,0.9722808074721302,854,0.15968665260620668,0.583006929798132,0.25730641759566136
5840,4393539,15,0,0,4,15,15,1.0,0.0,1.0,11,0.0,0.26666666666666666,0.7333333333333333
5841,4393542,2755,36,412,1024,2719,2755,1.0,0.013067150635208712,0.9869328493647913,1319,0.14954627949183302,0.3716878402903811,0.4787658802177858
5842,4393545,1884,40,336,1387,1844,1884,1.0,0.021231422505307854,0.9787685774946921,161,0.17834394904458598,0.7361995753715499,0.08545647558386411
5843,4393554,2904,18,449,1518,2886,2904,1.0,0.006198347107438017,0.993801652892562,937,0.15461432506887052,0.5227272727272727,0.3226584022038568
5844,4393558,2974,129,472,1961,2845,2974,1.0,0.04337592468056489,0.956624075319435,541,0.15870880968392737,0.6593813046402152,0.18190988567585742
5846,4393562,141,0,9,72,141,141,1.0,0.0,1.0,60,0.06382978723404255,0.5106382978723404,0.425531914893617
5848,4393567,3800,346,337,1338,3454,3800,1.0,0.09105263157894737,0.9089473684210526,2125,0.0886842105263158,0.35210526315789475,0.5592105263157895
5849,4393570,3890,59,524,1071,3831,3890,1.0,0.015167095115681234,0.9848329048843187,2295,0.13470437017994857,0.27532133676092546,0.589974293059126
5850,4393574,7,0,1,0,7,7,1.0,0.0,1.0,6,0.14285714285714285,0.0,0.8571428571428571
5852,4393579,1000,18,122,497,982,1000,1.0,0.018,0.982,381,0.122,0.497,0.381
5857,4393585,36,1,0,0,35,36,1.0,0.027777777777777776,0.9722222222222222,36,0.0,0.0,1.0
5859,4393624,198,11,17,68,187,198,1.0,0.05555555555555555,0.9444444444444444,113,0.08585858585858586,0.3434343434343434,0.5707070707070707
5860,4393626,609,11,87,236,598,609,1.0,0.0180623973727422,0.9819376026272578,286,0.14285714285714285,0.38752052545155996,0.4696223316912972
5861,4393637,2114,11,386,723,2103,2114,1.0,0.005203405865657522,0.9947965941343425,1005,0.1825922421948912,0.34200567644276253,0.47540208136234624
5862,4393646,3129,202,425,943,2927,3129,1.0,0.06455736657078939,0.9354426334292106,1761,0.13582614253755193,0.3013742409715564,0.5627996164908916
5863,4393647,2556,109,557,1096,2447,2556,1.0,0.042644757433489826,0.9573552425665102,903,0.21791862284820032,0.4287949921752739,0.3532863849765258
5864,4393648,4696,526,590,1378,4170,4696,1.0,0.11201022146507666,0.8879897785349233,2728,0.1256388415672913,0.2934412265758092,0.5809199318568995
5868,4393662,22,0,4,5,22,22,1.0,0.0,1.0,13,0.18181818181818182,0.22727272727272727,0.5909090909090909
5869,4393663,5,0,0,0,5,5,1.0,0.0,1.0,5,0.0,0.0,1.0
5871,4393665,10,0,0,0,10,10,1.0,0.0,1.0,10,0.0,0.0,1.0
5872,4393667,108,7,8,35,101,108,1.0,0.06481481481481481,0.9351851851851852,65,0.07407407407407407,0.32407407407407407,0.6018518518518519
5873,4393668,258,0,38,131,258,258,1.0,0.0,1.0,89,0.14728682170542637,0.5077519379844961,0.3449612403100775
5874,4393669,3,0,1,1,3,3,1.0,0.0,1.0,1,0.3333333333333333,0.3333333333333333,0.3333333333333333
5875,4393671,921,0,138,336,921,921,1.0,0.0,1.0,447,0.1498371335504886,0.36482084690553745,0.48534201954397393
5876,4393695,3499,480,532,1115,3019,3499,1.0,0.1371820520148614,0.8628179479851386,1852,0.15204344098313805,0.3186624749928551,0.5292940840240069
5877,4393696,4040,393,457,1155,3647,4040,1.0,0.09727722772277228,0.9027227722772277,2428,0.11311881188118812,0.28589108910891087,0.600990099009901
5878,4393698,3696,260,600,1131,3436,3696,1.0,0.07034632034632035,0.9296536796536796,1965,0.16233766233766234,0.3060064935064935,0.5316558441558441
5879,4393700,2237,194,257,800,2043,2237,1.0,0.08672329012069736,0.9132767098793027,1180,0.11488600804649084,0.35762181493071077,0.5274921770227984
5880,4394006,1108,444,164,25,664,1108,1.0,0.4007220216606498,0.5992779783393501,919,0.148014440433213,0.02256317689530686,0.8294223826714802
5881,4394016,1619,110,425,533,1509,1619,1.0,0.06794317479925881,0.9320568252007412,661,0.2625077208153181,0.3292155651636813,0.40827671402100063
5882,4394017,4530,897,748,232,3633,4530,1.0,0.19801324503311257,0.8019867549668874,3550,0.16512141280353201,0.05121412803532009,0.7836644591611479
5883,4394018,1617,0,177,433,1617,1617,1.0,0.0,1.0,1007,0.10946196660482375,0.26777983920841064,0.6227581941867656
5884,4394020,2770,151,277,495,2619,2770,1.0,0.05451263537906137,0.9454873646209386,1998,0.1,0.17870036101083034,0.7212996389891697
5885,4394042,1886,45,226,370,1841,1886,1.0,0.02386002120890774,0.9761399787910923,1290,0.11983032873807,0.19618239660657477,0.6839872746553552
5886,4394044A,4284,364,385,1534,3920,4284,1.0,0.08496732026143791,0.9150326797385621,2365,0.08986928104575163,0.3580765639589169,0.5520541549953315
5887,4394044B,83,0,7,28,83,83,1.0,0.0,1.0,48,0.08433734939759036,0.3373493975903614,0.5783132530120482
5888,4394045,2354,35,396,1350,2319,2354,1.0,0.014868309260832626,0.9851316907391674,608,0.16822429906542055,0.5734919286321155,0.2582837723024639
5889,4394046,4677,12,394,1627,4665,4677,1.0,0.0025657472738935213,0.9974342527261065,2656,0.08424203549283729,0.3478725678853966,0.5678853966217661
5890,4394047,3283,4,304,1197,3279,3283,1.0,0.0012183978068839476,0.9987816021931161,1782,0.09259823332318001,0.3646055437100213,0.5427962229667986
5891,4394048,717,0,234,50,717,717,1.0,0.0,1.0,433,0.3263598326359833,0.0697350069735007,0.603905160390516
5892,4394050,1748,435,449,57,1313,1748,1.0,0.2488558352402746,0.7511441647597255,1242,0.2568649885583524,0.03260869565217391,0.7105263157894737
5893,4394051,13,0,1,1,13,13,1.0,0.0,1.0,11,0.07692307692307693,0.07692307692307693,0.8461538461538461
5894,4394053,1508,124,176,402,1384,1508,1.0,0.08222811671087533,0.9177718832891246,930,0.11671087533156499,0.26657824933687,0.616710875331565
5895,4394057,350,63,119,206,287,350,1.0,0.18,0.82,25,0.34,0.5885714285714285,0.07142857142857142
5896,4394060,2068,96,539,308,1972,2068,1.0,0.04642166344294004,0.9535783365570599,1221,0.26063829787234044,0.14893617021276595,0.5904255319148937
5897,4394065,4363,56,387,1497,4307,4363,1.0,0.012835205134082053,0.9871647948659179,2479,0.08870043548017419,0.3431125372450149,0.568187027274811
5898,4394067,1768,30,445,111,1738,1768,1.0,0.016968325791855202,0.9830316742081447,1212,0.2516968325791855,0.06278280542986425,0.6855203619909502
5899,4394068,1412,44,356,109,1368,1412,1.0,0.031161473087818695,0.9688385269121813,947,0.2521246458923513,0.07719546742209632,0.6706798866855525
5900,4394069,5829,600,763,1689,5229,5829,1.0,0.1029336078229542,0.8970663921770458,3377,0.13089723794819008,0.28975810602161606,0.5793446560301938
5901,4394070,2714,272,599,814,2442,2714,1.0,0.10022107590272661,0.8997789240972734,1301,0.22070744288872512,0.2999263080324245,0.4793662490788504
5902,4394073,374,16,66,136,358,374,1.0,0.0427807486631016,0.9572192513368984,172,0.17647058823529413,0.36363636363636365,0.45989304812834225
5903,4394077,185,5,82,95,180,185,1.0,0.02702702702702703,0.972972972972973,8,0.44324324324324327,0.5135135135135135,0.043243243243243246
5904,4394086,2457,12,465,1283,2445,2457,1.0,0.004884004884004884,0.9951159951159951,709,0.18925518925518925,0.5221815221815221,0.28856328856328856
5905,4394087,827,33,153,52,794,827,1.0,0.03990326481257558,0.9600967351874244,622,0.18500604594921402,0.06287787182587666,0.7521160822249093
5906,4394091,3422,72,390,972,3350,3422,1.0,0.02104032729398013,0.9789596727060199,2060,0.11396843950905904,0.28404441846873174,0.6019871420222093
5907,4394092,921,9,248,66,912,921,1.0,0.009771986970684038,0.990228013029316,607,0.2692725298588491,0.07166123778501629,0.6590662323561346
5908,4394093,2570,0,551,170,2570,2570,1.0,0.0,1.0,1849,0.21439688715953306,0.06614785992217899,0.7194552529182879
5909,4394096,997,13,393,197,984,997,1.0,0.013039117352056168,0.9869608826479438,407,0.39418254764292876,0.19759277833500502,0.4082246740220662
5910,4394097,1152,14,367,167,1138,1152,1.0,0.012152777777777778,0.9878472222222222,618,0.3185763888888889,0.1449652777777778,0.5364583333333334
5911,4394101,1586,0,258,249,1586,1586,1.0,0.0,1.0,1079,0.1626733921815889,0.15699873896595207,0.680327868852459
5912,4394102,1268,26,214,232,1242,1268,1.0,0.02050473186119874,0.9794952681388013,822,0.16876971608832808,0.1829652996845426,0.6482649842271293
5913,4394107,1189,120,291,82,1069,1189,1.0,0.10092514718250631,0.8990748528174937,816,0.2447434819175778,0.06896551724137931,0.6862910008410429
5914,4394110,946,6,321,82,940,946,1.0,0.006342494714587738,0.9936575052854123,543,0.339323467230444,0.08668076109936575,0.5739957716701902
5915,4394113,2027,287,69,145,1740,2027,1.0,0.1415885545140602,0.8584114454859398,1813,0.034040453872718306,0.07153428712382832,0.8944252590034534
5916,4394115,498,5,71,426,493,498,1.1889952153110048,0.010040160642570281,0.9899598393574297,1,0.142570281124498,0.8554216867469879,0.002008032128514056
5917,4394116,2056,9,403,879,2047,2056,1.0,0.004377431906614786,0.9956225680933852,774,0.19601167315175097,0.4275291828793774,0.3764591439688716
5918,4394118,1835,428,320,405,1407,1835,1.0,0.2332425068119891,0.7667574931880109,1110,0.17438692098092642,0.22070844686648503,0.6049046321525886
5919,4394121,4083,29,435,821,4054,4083,1.0,0.007102620622091599,0.9928973793779085,2827,0.106539309331374,0.20107763899093803,0.692383051677688
5920,4394122,2470,44,383,208,2426,2470,1.0,0.017813765182186234,0.9821862348178138,1879,0.15506072874493926,0.08421052631578947,0.7607287449392712
5921,4394123,2111,44,368,133,2067,2111,1.0,0.020843202273803884,0.9791567977261961,1610,0.1743249644718143,0.06300331596399811,0.7626717195641876
5922,4394124,1084,0,310,410,1084,1084,1.0,0.0,1.0,364,0.2859778597785978,0.37822878228782286,0.33579335793357934
5923,4394125,688,43,110,155,645,688,1.0,0.0625,0.9375,423,0.15988372093023256,0.22529069767441862,0.6148255813953488
5924,4394128,3993,103,484,954,3890,3993,1.0,0.025795141497620837,0.9742048585023791,2555,0.12121212121212122,0.23891810668670171,0.639869772101177
5925,4394129,1050,0,228,500,1050,1050,1.0,0.0,1.0,322,0.21714285714285714,0.47619047619047616,0.30666666666666664
5926,4394130,2441,68,513,1318,2373,2441,1.0,0.027857435477263416,0.9721425645227366,610,0.2101597705858255,0.5399426464563704,0.24989758295780418
5927,4394135,1605,340,285,421,1265,1605,1.0,0.2118380062305296,0.7881619937694704,899,0.17757009345794392,0.2623052959501558,0.5601246105919003
5928,4394136,3815,468,496,587,3347,3815,1.0,0.12267365661861075,0.8773263433813893,2732,0.13001310615989514,0.15386631716906946,0.7161205766710353
5929,4394137,1688,5,289,625,1683,1688,1.0,0.002962085308056872,0.9970379146919431,774,0.1712085308056872,0.370260663507109,0.4585308056872038
5930,4394138,1576,19,150,199,1557,1576,1.0,0.012055837563451776,0.9879441624365483,1227,0.09517766497461928,0.12626903553299493,0.7785532994923858
5931,4394141,3923,474,490,842,3449,3923,1.0,0.12082589854703034,0.8791741014529697,2591,0.12490440989039,0.21463165944430282,0.6604639306653072
5932,4394144,1931,34,266,571,1897,1931,1.0,0.017607457276022784,0.9823925427239772,1094,0.13775245986535473,0.29570170895908854,0.5665458311755567
5933,4394155,3343,20,559,300,3323,3343,1.0,0.005982650314089142,0.9940173496859108,2484,0.1672150762787915,0.08973975471133712,0.7430451690098714
5934,4394159,2417,0,319,466,2417,2417,1.0,0.0,1.0,1632,0.13198179561439802,0.1928009929664874,0.6752172114191146
5935,4394162,733,20,75,90,713,733,1.0,0.027285129604365622,0.9727148703956344,568,0.10231923601637108,0.12278308321964529,0.7748976807639836
5936,4394163,985,6,256,527,979,985,1.0,0.006091370558375634,0.9939086294416244,202,0.2598984771573604,0.5350253807106599,0.2050761421319797
5937,4394178,4320,553,609,1222,3767,4320,1.0,0.12800925925925927,0.8719907407407408,2489,0.14097222222222222,0.2828703703703704,0.5761574074074074
5938,4394179,2062,415,287,299,1647,2062,1.0,0.20126091173617847,0.7987390882638216,1476,0.13918525703200776,0.14500484966052377,0.7158098933074685
5939,4394182,3643,93,621,1356,3550,3643,1.0,0.025528410650562723,0.9744715893494372,1666,0.17046390337633818,0.3722206972275597,0.4573153993961021
5940,4394191,1451,141,206,491,1310,1451,1.0,0.09717436250861475,0.9028256374913852,754,0.1419710544452102,0.3383873190902826,0.5196416264645073
5941,4394195,1673,14,336,131,1659,1673,1.0,0.008368200836820083,0.9916317991631799,1206,0.200836820083682,0.07830245068738792,0.7208607292289301
5942,4394201,1262,49,371,86,1213,1262,1.0,0.03882725832012678,0.9611727416798732,805,0.29397781299524567,0.06814580031695722,0.6378763866877971
5943,4394202,1834,0,284,421,1834,1834,1.0,0.0,1.0,1129,0.15485278080697928,0.22955288985823338,0.6155943293347873
5944,4394203,3025,759,497,430,2266,3025,1.0,0.2509090909090909,0.7490909090909091,2098,0.16429752066115702,0.14214876033057852,0.6935537190082645
5945,4394204,5025,190,603,992,4835,5025,1.0,0.03781094527363184,0.9621890547263682,3430,0.12,0.19741293532338308,0.6825870646766169
5946,4394218,1896,5,232,325,1891,1896,1.0,0.0026371308016877636,0.9973628691983122,1339,0.12236286919831224,0.17141350210970463,0.7062236286919831
5947,4394222,1883,59,269,314,1824,1883,1.0,0.031332979288369624,0.9686670207116304,1300,0.14285714285714285,0.16675517790759425,0.6903876792352629
5948,4394230,4592,229,731,1546,4363,4592,1.0,0.049869337979094076,0.9501306620209059,2315,0.15918989547038329,0.3366724738675958,0.5041376306620209
5949,4394231,1905,80,408,106,1825,1905,1.0,0.04199475065616798,0.958005249343832,1391,0.2141732283464567,0.05564304461942257,0.7301837270341207
5950,4394232,5056,523,722,1142,4533,5056,1.0,0.10344145569620253,0.8965585443037974,3192,0.14280063291139242,0.22587025316455697,0.6313291139240507
5951,4394233,1924,234,374,92,1690,1924,1.0,0.12162162162162163,0.8783783783783784,1458,0.1943866943866944,0.04781704781704782,0.7577962577962578
5952,4394234,3158,68,586,1451,3090,3158,1.0,0.021532615579480684,0.9784673844205193,1121,0.18556048131728942,0.45946801773274226,0.3549715009499683
5953,4394239,172,0,21,43,172,172,1.0,0.0,1.0,108,0.12209302325581395,0.25,0.627906976744186
5954,4394242,906,6,79,284,900,906,1.0,0.006622516556291391,0.9933774834437086,543,0.08719646799116998,0.31346578366445915,0.5993377483443708
5955,4394243,2246,112,247,415,2134,2246,1.0,0.04986642920747997,0.95013357079252,1584,0.10997328584149599,0.18477292965271594,0.705253784505788
5956,4394250,4178,720,503,919,3458,4178,1.0,0.1723312589755864,0.8276687410244136,2756,0.12039253231211106,0.2199617041646721,0.6596457635232168
5957,4394252,1292,54,247,345,1238,1292,1.0,0.04179566563467492,0.958204334365325,700,0.19117647058823528,0.26702786377708976,0.541795665634675
5958,4394253,682,79,100,155,603,682,1.0,0.1158357771260997,0.8841642228739003,427,0.1466275659824047,0.22727272727272727,0.626099706744868
5959,4394256,1084,69,157,89,1015,1084,1.0,0.06365313653136531,0.9363468634686347,838,0.1448339483394834,0.08210332103321033,0.7730627306273062
5960,4394259,1218,19,186,570,1199,1218,1.0,0.015599343185550082,0.9844006568144499,462,0.15270935960591134,0.46798029556650245,0.3793103448275862
5961,4394261,4860,473,675,932,4387,4860,1.0,0.09732510288065843,0.9026748971193416,3253,0.1388888888888889,0.19176954732510287,0.6693415637860082
5962,4394272,629,25,83,123,604,629,1.0,0.0397456279809221,0.9602543720190779,423,0.13195548489666137,0.19554848966613672,0.6724960254372019
5963,4394276,2541,321,431,798,2220,2541,1.0,0.12632821723730814,0.8736717827626919,1312,0.16961826052735143,0.3140495867768595,0.516332152695789
5964,4394284,363,17,28,125,346,363,1.0,0.046831955922865015,0.953168044077135,210,0.07713498622589532,0.3443526170798898,0.5785123966942148
5965,4394285,1654,185,98,101,1469,1654,1.0,0.11185006045949214,0.8881499395405078,1455,0.0592503022974607,0.06106408706166868,0.8796856106408706
5966,4394288,376,113,73,5,263,376,1.0,0.300531914893617,0.699468085106383,298,0.19414893617021275,0.013297872340425532,0.7925531914893617
5967,4394290,2749,195,425,819,2554,2749,1.0,0.07093488541287742,0.9290651145871226,1505,0.15460167333575844,0.2979265187340851,0.5474718079301564
5968,4394312,129,4,22,22,125,129,1.0,0.031007751937984496,0.9689922480620154,85,0.17054263565891473,0.17054263565891473,0.6589147286821705
5969,4394328,1819,121,256,428,1698,1819,1.0,0.06652006597031336,0.9334799340296867,1135,0.14073666849917538,0.23529411764705882,0.6239692138537658
5970,4394338,4094,465,629,1093,3629,4094,1.0,0.11358085002442599,0.886419149975574,2372,0.15363947239863215,0.26697606253053247,0.5793844650708354
5971,4394340,2383,0,270,875,2383,2383,1.0,0.0,1.0,1238,0.11330255979857323,0.3671842215694503,0.5195132186319765
5972,4394342,2429,105,448,1040,2324,2429,1.0,0.043227665706051875,0.9567723342939481,941,0.1844380403458213,0.4281597365170852,0.38740222313709344
5973,4394343,1570,55,257,757,1515,1570,1.0,0.03503184713375796,0.964968152866242,556,0.16369426751592356,0.4821656050955414,0.354140127388535
5974,4394344,1524,29,301,628,1495,1524,1.0,0.019028871391076115,0.9809711286089239,595,0.19750656167979003,0.4120734908136483,0.39041994750656167
5975,4394350,1814,35,419,455,1779,1814,1.0,0.019294377067254686,0.9807056229327453,940,0.23098125689084895,0.2508269018743109,0.5181918412348401
5976,4394362,17,3,0,3,14,17,1.0,0.17647058823529413,0.8235294117647058,14,0.0,0.17647058823529413,0.8235294117647058
5977,4394369,3937,344,615,1306,3593,3937,1.0,0.0873761747523495,0.9126238252476505,2016,0.15621031242062483,0.3317246634493269,0.5120650241300483
5979,4394371,2324,24,217,993,2300,2324,1.0,0.010327022375215147,0.9896729776247849,1114,0.09337349397590361,0.4272805507745267,0.4793459552495697
5980,4394373,349,17,32,81,332,349,1.0,0.04871060171919771,0.9512893982808023,236,0.09169054441260745,0.23209169054441262,0.6762177650429799
5981,4394374,2834,276,484,753,2558,2834,1.0,0.09738884968242767,0.9026111503175723,1597,0.1707833450952717,0.26570218772053633,0.563514467184192
5982,4394375,2725,185,309,1085,2540,2725,1.0,0.06788990825688074,0.9321100917431193,1331,0.11339449541284403,0.3981651376146789,0.48844036697247706
5983,4394395,914,1,79,209,913,914,1.0,0.0010940919037199124,0.9989059080962801,626,0.08643326039387308,0.2286652078774617,0.6849015317286652
5984,4394397,500,0,90,132,500,500,1.0,0.0,1.0,278,0.18,0.264,0.556
5985,4394399,244,3,26,95,241,244,1.0,0.012295081967213115,0.9877049180327869,123,0.10655737704918032,0.38934426229508196,0.5040983606557377
5986,4394400,650,25,45,78,625,650,1.0,0.038461538461538464,0.9615384615384616,527,0.06923076923076923,0.12,0.8107692307692308
5987,4394410,3332,295,608,807,3037,3332,1.0,0.08853541416566627,0.9114645858343338,1917,0.18247298919567828,0.2421968787515006,0.5753301320528211
5988,4394429,1805,268,136,343,1537,1805,1.0,0.1484764542936288,0.8515235457063712,1326,0.07534626038781163,0.19002770083102494,0.7346260387811634
5989,4394432,167,19,12,1,148,167,1.0,0.11377245508982035,0.8862275449101796,154,0.0718562874251497,0.005988023952095809,0.9221556886227545
5990,4394452,3236,846,411,523,2390,3236,1.0,0.261433868974042,0.738566131025958,2302,0.12700865265760197,0.161619283065513,0.711372064276885
5991,4394454,3592,370,333,876,3222,3592,1.0,0.10300668151447662,0.8969933184855234,2383,0.09270601336302896,0.24387527839643652,0.6634187082405345
5992,4394456,1267,130,209,522,1137,1267,1.0,0.1026045777426993,0.8973954222573007,536,0.164956590370955,0.4119968429360695,0.4230465666929755
5994,4394475,33,1,19,11,32,33,1.0,0.030303030303030304,0.9696969696969697,3,0.5757575757575758,0.3333333333333333,0.09090909090909091
5996,4394480,538,32,45,271,506,538,1.0,0.05947955390334572,0.9405204460966543,222,0.08364312267657993,0.5037174721189591,0.41263940520446096
5997,4394483,46,0,12,10,46,46,1.0,0.0,1.0,24,0.2608695652173913,0.21739130434782608,0.5217391304347826
5998,4394485,741,2,91,89,739,741,1.0,0.002699055330634278,0.9973009446693657,561,0.12280701754385964,0.12010796221322537,0.757085020242915
6000,4394492,1526,145,138,230,1381,1526,1.0,0.09501965923984272,0.9049803407601573,1158,0.09043250327653997,0.15072083879423329,0.7588466579292268
6001,4394493,438,11,60,106,427,438,1.0,0.02511415525114155,0.9748858447488584,272,0.136986301369863,0.2420091324200913,0.6210045662100456
6002,4394494,301,35,2,1,266,301,1.0,0.11627906976744186,0.8837209302325582,298,0.006644518272425249,0.0033222591362126247,0.9900332225913622
6003,4394495,93,19,53,22,74,93,1.0,0.20430107526881722,0.7956989247311828,18,0.5698924731182796,0.23655913978494625,0.1935483870967742
6004,4394496,1250,340,209,104,910,1250,1.0,0.272,0.728,937,0.1672,0.0832,0.7496
6005,4394497,5888,2200,750,429,3688,5888,1.0,0.3736413043478261,0.626358695652174,4709,0.12737771739130435,0.07286005434782608,0.7997622282608695
6006,4394498,552,0,113,344,552,552,1.0,0.0,1.0,95,0.20471014492753623,0.6231884057971014,0.1721014492753623
6007,4394499,5771,633,723,1043,5138,5771,1.0,0.10968636284872639,0.8903136371512737,4005,0.12528158031536996,0.18073124241899152,0.6939871772656385
6008,4394503,1143,0,226,169,1143,1143,1.0,0.0,1.0,748,0.19772528433945757,0.14785651793525809,0.6544181977252843
6009,4394508,5212,501,729,1292,4711,5212,1.0,0.09612432847275518,0.9038756715272448,3191,0.1398695318495779,0.2478894858019954,0.6122409823484267
6011,4394528,4305,435,718,1441,3870,4305,1.0,0.10104529616724739,0.8989547038327527,2146,0.16678281068524972,0.33472706155632986,0.49849012775842044
6012,4394531,3525,100,507,1188,3425,3525,1.0,0.028368794326241134,0.9716312056737588,1830,0.14382978723404255,0.33702127659574466,0.5191489361702127
6013,4394532,1742,34,158,639,1708,1742,1.0,0.01951779563719862,0.9804822043628014,945,0.09070034443168772,0.3668197474167623,0.5424799081515499
6014,4394533,1662,15,217,510,1647,1662,1.0,0.009025270758122744,0.9909747292418772,935,0.1305655836341757,0.30685920577617326,0.562575210589651
6015,4394534,4734,334,634,1331,4400,4734,1.0,0.07055344317701732,0.9294465568229827,2769,0.13392479932403886,0.28115758343895225,0.5849176172370089
6016,4394540,3802,356,580,957,3446,3802,1.0,0.09363492898474488,0.9063650710152551,2265,0.15255128879537086,0.2517096265123619,0.5957390846922672
6017,4394551,4067,303,599,1266,3764,4067,1.0,0.07450208999262356,0.9254979100073765,2202,0.14728300958937793,0.3112859601671994,0.5414310302434227
6019,4394565,34,0,11,21,34,34,1.0,0.0,1.0,2,0.3235294117647059,0.6176470588235294,0.058823529411764705
6020,4394568,53,0,16,9,53,53,1.0,0.0,1.0,28,0.3018867924528302,0.16981132075471697,0.5283018867924528
6021,4394572,64,7,28,10,57,64,1.0,0.109375,0.890625,26,0.4375,0.15625,0.40625
6023,4394587,197,59,132,2,138,197,1.0,0.29949238578680204,0.700507614213198,63,0.6700507614213198,0.01015228426395939,0.3197969543147208
6024,4394588,4542,480,797,1616,4062,4542,1.0,0.10568031704095113,0.8943196829590488,2129,0.1754733597534126,0.35579040070453544,0.46873623954205196
6025,4394591,3983,513,475,809,3470,3983,1.0,0.12879738890283707,0.8712026110971629,2699,0.11925684157670098,0.20311323123273914,0.6776299271905599
6027,4394593,354,0,66,58,354,354,1.0,0.0,1.0,230,0.1864406779661017,0.1638418079096045,0.6497175141242938
6028,4394595,79,0,19,29,79,79,1.0,0.0,1.0,31,0.24050632911392406,0.3670886075949367,0.3924050632911392
6029,4394596,174,0,54,44,174,174,1.0,0.0,1.0,76,0.3103448275862069,0.25287356321839083,0.4367816091954023
6031,4394599,6245,685,584,1021,5560,6245,1.0,0.10968775020016013,0.8903122497998399,4640,0.09351481184947959,0.1634907926341073,0.7429943955164131
6035,4394620,276,4,25,10,272,276,1.0,0.014492753623188406,0.9855072463768116,241,0.09057971014492754,0.036231884057971016,0.8731884057971014
6039,4394634,2080,68,169,279,2012,2080,1.0,0.032692307692307694,0.9673076923076923,1632,0.08125,0.13413461538461538,0.7846153846153846
6040,4394638,2169,295,292,589,1874,2169,1.0,0.13600737667127707,0.863992623328723,1288,0.13462425080682341,0.27155371138773626,0.5938220378054403
6041,4394640,437,51,101,93,386,437,1.0,0.11670480549199085,0.8832951945080092,243,0.2311212814645309,0.2128146453089245,0.5560640732265446
6042,4394649,4047,105,418,1183,3942,4047,1.0,0.025945144551519646,0.9740548554484804,2446,0.10328638497652583,0.29231529528045463,0.6043983197430195
6043,4394650,2435,238,256,361,2197,2435,1.0,0.09774127310061602,0.902258726899384,1818,0.10513347022587269,0.14825462012320328,0.746611909650924
6045,4394682,486,4,86,61,482,486,1.0,0.00823045267489712,0.9917695473251029,339,0.17695473251028807,0.12551440329218108,0.6975308641975309
6048,4394687,358,6,43,60,352,358,1.0,0.01675977653631285,0.9832402234636871,255,0.12011173184357542,0.16759776536312848,0.7122905027932961
6049,4394688,43,0,9,5,43,43,1.0,0.0,1.0,29,0.20930232558139536,0.11627906976744186,0.6744186046511628
6050,4394689,118,0,25,14,118,118,1.0,0.0,1.0,79,0.211864406779661,0.11864406779661017,0.6694915254237288
6051,4394690,11,0,2,2,11,11,1.0,0.0,1.0,7,0.18181818181818182,0.18181818181818182,0.6363636363636364
6052,4394691,18,0,2,3,18,18,1.0,0.0,1.0,13,0.1111111111111111,0.16666666666666666,0.7222222222222222
6053,4394692,31,0,7,6,31,31,1.0,0.0,1.0,18,0.22580645161290322,0.1935483870967742,0.5806451612903226
6054,4394693,22,0,2,1,22,22,1.0,0.0,1.0,19,0.09090909090909091,0.045454545454545456,0.8636363636363636
6055,4394694,2856,169,438,898,2687,2856,1.0,0.05917366946778711,0.9408263305322129,1520,0.15336134453781514,0.31442577030812324,0.5322128851540616
6056,4394702,2211,219,194,408,1992,2211,1.0,0.09905020352781546,0.9009497964721845,1609,0.0877431026684758,0.18453188602442333,0.7277250113071009
6057,4394703,3266,323,527,753,2943,3266,1.0,0.09889773423147581,0.9011022657685241,1986,0.16135946111451316,0.23055725658297613,0.6080832823025107
6058,4410101,3795,554,616,1569,3241,3795,1.0,0.14598155467720686,0.8540184453227931,1610,0.16231884057971013,0.4134387351778656,0.42424242424242425
6059,4410102,3271,183,331,1034,3088,3271,1.0,0.05594619382451849,0.9440538061754815,1906,0.10119229593396514,0.3161112809538367,0.5826964231121982
6060,4410103,3478,225,387,1129,3253,3478,1.0,0.06469235192639448,0.9353076480736056,1962,0.11127084531339851,0.3246118458884416,0.5641173087981599
6061,4410104,2544,14,275,1507,2530,2544,1.0,0.00550314465408805,0.9944968553459119,762,0.10809748427672956,0.592374213836478,0.29952830188679247
6062,4410105,5829,549,514,1144,5280,5829,1.0,0.0941842511580031,0.9058157488419969,4171,0.0881797907016641,0.196260078915766,0.7155601303825699
6063,4410106,3349,405,190,426,2944,3349,1.0,0.12093162137951627,0.8790683786204837,2733,0.05673335323977307,0.1272021498954912,0.8160644968647357
6064,4410107,858,14,75,274,844,858,1.0,0.016317016317016316,0.9836829836829837,509,0.08741258741258741,0.31934731934731936,0.5932400932400932
6065,4410108,980,30,68,640,950,980,1.0,0.030612244897959183,0.9693877551020408,272,0.06938775510204082,0.6530612244897959,0.27755102040816326
6066,4410109,164,1,10,140,163,164,1.0,0.006097560975609756,0.9939024390243902,14,0.06097560975609756,0.8536585365853658,0.08536585365853659
6067,4410110,67,0,13,54,67,67,1.2407407407407407,0.0,1.0,0,0.19402985074626866,0.8059701492537313,0.0
6068,4410201,2794,219,346,414,2575,2794,1.0,0.07838224767358626,0.9216177523264137,2034,0.12383679312813171,0.1481746599856836,0.7279885468861846
6069,4410202,4832,201,586,719,4631,4832,1.0,0.041597682119205295,0.9584023178807947,3527,0.12127483443708609,0.14879966887417218,0.7299254966887417
6070,4410203,3631,401,517,786,3230,3631,1.0,0.11043789589644726,0.8895621041035527,2328,0.14238501790140456,0.21646929220600386,0.6411456898925916
6071,4410204,2155,0,139,748,2155,2155,1.0,0.0,1.0,1268,0.06450116009280743,0.3470997679814385,0.588399071925754
6072,4410205,4838,724,642,866,4114,4838,1.0,0.1496486151302191,0.8503513848697809,3330,0.1326994625878462,0.17899958660603554,0.6883009508061182
6073,4410206,2948,28,258,1063,2920,2948,1.0,0.009497964721845319,0.9905020352781547,1627,0.08751696065128901,0.3605834464043419,0.5518995929443691
6074,4410207,336,11,46,146,325,336,1.0,0.03273809523809524,0.9672619047619048,144,0.13690476190476192,0.43452380952380953,0.42857142857142855
6075,4410301,3727,290,367,1074,3437,3727,1.0,0.07781057150523209,0.9221894284947679,2286,0.09847061980144889,0.288167426884894,0.6133619533136571
6076,4410302,2840,158,276,1301,2682,2840,1.0,0.05563380281690141,0.9443661971830986,1263,0.09718309859154929,0.4580985915492958,0.44471830985915495
6077,4410303,1296,0,94,919,1296,1296,1.0,0.0,1.0,283,0.07253086419753087,0.7091049382716049,0.2183641975308642
6078,4410304,4382,510,396,1291,3872,4382,1.0,0.1163852122318576,0.8836147877681424,2695,0.09036969420356002,0.29461433135554543,0.6150159744408946
6079,4410305,2539,206,315,1667,2333,2539,1.0,0.08113430484442694,0.918865695155573,557,0.12406459235919653,0.6565576998818432,0.21937770775896023
6080,4410306,4183,159,287,2007,4024,4183,1.0,0.038010996892182645,0.9619890031078173,1889,0.06861104470475735,0.47979918718623,0.4515897681090127
6081,4410307,4767,137,367,2514,4630,4767,1.0,0.028739249003566184,0.9712607509964338,1886,0.07698762324312985,0.527375707992448,0.39563666876442205
6082,4410308,1803,14,139,785,1789,1803,1.0,0.00776483638380477,0.9922351636161952,879,0.07709373266777593,0.4353854686633389,0.4875207986688852
6083,4410401,2448,110,214,369,2338,2448,1.0,0.04493464052287582,0.9550653594771242,1865,0.08741830065359477,0.15073529411764705,0.7618464052287581
6084,4410402,4332,361,355,1295,3971,4332,1.0,0.08333333333333333,0.9166666666666666,2682,0.08194829178208679,0.29893813481071096,0.6191135734072022
6085,4410403,4672,628,398,915,4044,4672,1.0,0.1344178082191781,0.865582191780822,3359,0.08518835616438356,0.19584760273972604,0.7189640410958904
6086,4410404,2974,89,384,857,2885,2974,1.0,0.02992602555480834,0.9700739744451916,1733,0.12911903160726296,0.28816408876933425,0.5827168796234028
6087,4410405,2698,213,285,694,2485,2698,1.0,0.07894736842105263,0.9210526315789473,1719,0.1056338028169014,0.257227575982209,0.6371386212008896
6088,4410406,3804,289,421,1575,3515,3804,1.0,0.0759726603575184,0.9240273396424816,1808,0.11067297581493166,0.4140378548895899,0.47528916929547843
6089,4410407,1647,46,155,650,1601,1647,1.0,0.02792956891317547,0.9720704310868246,842,0.09411050394656952,0.3946569520340012,0.5112325440194293
6090,4410408,3534,77,235,1916,3457,3534,1.0,0.02178834182229768,0.9782116581777023,1383,0.06649688737973967,0.5421618562535371,0.39134125636672323
6091,4410409,1112,3,49,416,1109,1112,1.0,0.002697841726618705,0.9973021582733813,647,0.044064748201438846,0.37410071942446044,0.5818345323741008
6092,4430001,177,6,11,87,171,177,1.0,0.03389830508474576,0.9661016949152542,79,0.062146892655367235,0.4915254237288136,0.4463276836158192
6093,4430002A,18,0,7,4,18,18,1.0,0.0,1.0,7,0.3888888888888889,0.2222222222222222,0.3888888888888889
6094,4430002B,164,5,72,55,159,164,1.0,0.03048780487804878,0.9695121951219512,37,0.43902439024390244,0.3353658536585366,0.22560975609756098
6095,4430003,179,6,26,117,173,179,1.0,0.0335195530726257,0.9664804469273743,36,0.1452513966480447,0.6536312849162011,0.2011173184357542
6096,4430004A,26,0,6,10,26,26,1.0,0.0,1.0,10,0.23076923076923078,0.38461538461538464,0.38461538461538464
6097,4430004B,156,5,62,85,151,156,1.0,0.03205128205128205,0.967948717948718,9,0.3974358974358974,0.5448717948717948,0.057692307692307696
6098,4450101,1178,138,47,209,1040,1178,1.0,0.11714770797962648,0.8828522920203735,922,0.039898132427843805,0.1774193548387097,0.7826825127334465
6099,4450102,1586,56,162,899,1530,1586,1.0,0.03530895334174023,0.9646910466582598,525,0.1021437578814628,0.5668348045397226,0.33102143757881464
6100,4450201,1405,56,148,246,1349,1405,1.0,0.0398576512455516,0.9601423487544484,1011,0.10533807829181495,0.17508896797153026,0.7195729537366548
6101,4450202,601,0,108,246,601,601,1.0,0.0,1.0,247,0.17970049916805325,0.40931780366056575,0.41098169717138106
6102,4450301,1526,76,358,355,1450,1526,1.0,0.04980340760157274,0.9501965923984272,813,0.2346002621231979,0.23263433813892528,0.5327653997378768
6103,4450401,1819,125,223,509,1694,1819,1.0,0.06871907641561298,0.9312809235843871,1087,0.12259483232545354,0.279824079164376,0.5975810885101704
6104,4450402,224,2,13,138,222,224,1.0,0.008928571428571428,0.9910714285714286,73,0.05803571428571429,0.6160714285714286,0.32589285714285715
6105,4470001,287,6,33,189,281,287,1.0,0.020905923344947737,0.9790940766550522,65,0.11498257839721254,0.6585365853658537,0.2264808362369338
6106,4470002,291,4,27,186,287,291,1.0,0.013745704467353952,0.9862542955326461,78,0.09278350515463918,0.6391752577319587,0.26804123711340205
6107,4473003,375,0,25,165,375,375,1.0,0.0,1.0,185,0.06666666666666667,0.44,0.49333333333333335
6108,4474005,117,0,6,47,117,117,1.0,0.0,1.0,64,0.05128205128205128,0.4017094017094017,0.5470085470085471
6109,4474006,191,4,18,113,187,191,1.0,0.020942408376963352,0.9790575916230366,60,0.09424083769633508,0.5916230366492147,0.31413612565445026
6110,4490001,848,259,321,46,589,848,1.0,0.30542452830188677,0.6945754716981132,481,0.3785377358490566,0.054245283018867926,0.5672169811320755
6111,4490002,544,41,165,201,503,544,1.0,0.07536764705882353,0.9246323529411765,178,0.30330882352941174,0.3694852941176471,0.3272058823529412
6112,4490003,632,29,77,280,603,632,1.0,0.04588607594936709,0.9541139240506329,275,0.12183544303797468,0.4430379746835443,0.435126582278481
6113,4490004,529,37,77,301,492,529,1.0,0.06994328922495274,0.9300567107750473,151,0.14555765595463138,0.5689981096408318,0.28544423440453687
6114,4490005,267,16,25,153,251,267,1.0,0.0599250936329588,0.9400749063670412,89,0.09363295880149813,0.5730337078651685,0.3333333333333333
6115,4490006,1411,14,124,612,1397,1411,1.0,0.009922041105598866,0.9900779588944011,675,0.08788093550673282,0.43373493975903615,0.47838412473423103
6116,4490007,1221,103,159,477,1118,1221,1.0,0.08435708435708436,0.9156429156429157,585,0.13022113022113022,0.3906633906633907,0.47911547911547914
6117,4490008,1633,360,287,200,1273,1633,1.0,0.22045315370483773,0.7795468462951622,1146,0.17575015309246786,0.1224739742804654,0.7017758726270668
6118,4490009,754,114,70,171,640,754,1.0,0.15119363395225463,0.8488063660477454,513,0.09283819628647215,0.22679045092838196,0.6803713527851459
6119,4490010,873,23,70,410,850,873,1.0,0.026345933562428408,0.9736540664375716,393,0.08018327605956473,0.46964490263459335,0.45017182130584193
6120,4490011,363,10,28,84,353,363,1.0,0.027548209366391185,0.9724517906336089,251,0.07713498622589532,0.23140495867768596,0.6914600550964187
6121,4490012,261,5,35,148,256,261,1.0,0.019157088122605363,0.9808429118773946,78,0.13409961685823754,0.5670498084291188,0.2988505747126437
6122,4490014,2325,443,345,495,1882,2325,1.0,0.19053763440860216,0.8094623655913978,1485,0.14838709677419354,0.2129032258064516,0.6387096774193548
6123,4490015,1309,40,91,369,1269,1309,1.0,0.030557677616501147,0.9694423223834988,849,0.06951871657754011,0.28189457601222306,0.6485867074102368
6124,4490016,2408,214,264,1091,2194,2408,1.0,0.0888704318936877,0.9111295681063123,1053,0.10963455149501661,0.4530730897009967,0.4372923588039867
6125,4490017,791,225,162,81,566,791,1.0,0.28445006321112515,0.7155499367888748,548,0.20480404551201012,0.10240202275600506,0.6927939317319848
6126,4490018,319,20,24,89,299,319,1.0,0.06269592476489028,0.9373040752351097,206,0.07523510971786834,0.27899686520376177,0.64576802507837
6127,4490019,998,77,142,267,921,998,1.0,0.07715430861723446,0.9228456913827655,589,0.14228456913827656,0.26753507014028055,0.5901803607214429
6128,4490020,1278,127,182,609,1151,1278,1.0,0.09937402190923318,0.9006259780907668,487,0.14241001564945227,0.4765258215962441,0.3810641627543036
6129,4510106,1810,26,307,380,1784,1810,1.0,0.014364640883977901,0.9856353591160221,1123,0.1696132596685083,0.20994475138121546,0.6204419889502762
6130,4510107,835,18,79,188,817,835,1.0,0.02155688622754491,0.9784431137724551,568,0.09461077844311377,0.2251497005988024,0.6802395209580838
6131,4510108,885,0,58,449,885,885,1.0,0.0,1.0,378,0.0655367231638418,0.5073446327683616,0.4271186440677966
6132,4510112,883,11,59,498,872,883,1.0,0.01245753114382786,0.9875424688561721,326,0.06681766704416761,0.5639864099660249,0.36919592298980747
6133,4510114,1661,0,295,103,1661,1661,1.0,0.0,1.0,1263,0.17760385310054183,0.062010836845273934,0.7603853100541842
6134,4510124,2148,516,420,165,1632,2148,1.0,0.24022346368715083,0.7597765363128491,1563,0.19553072625698323,0.07681564245810056,0.7276536312849162
6135,4510137,3019,29,616,658,2990,3019,1.0,0.009605829744948658,0.9903941702550514,1745,0.20404107320304737,0.21795296455780058,0.578005962239152
6136,4510144,2336,104,329,398,2232,2336,1.0,0.04452054794520548,0.9554794520547946,1609,0.1408390410958904,0.1703767123287671,0.6887842465753424
6137,4510146,6265,165,587,800,6100,6265,1.0,0.026336791699920193,0.9736632083000798,4878,0.0936951316839585,0.12769353551476456,0.7786113328012769
6138,4510213,2317,4,155,1481,2313,2317,1.0,0.0017263703064307294,0.9982736296935693,681,0.06689684937419077,0.6391886059559776,0.2939145446698317
6139,4510215,2992,300,291,1210,2692,2992,1.0,0.10026737967914438,0.8997326203208557,1491,0.09725935828877005,0.40441176470588236,0.4983288770053476
6140,4510225,73,0,2,50,73,73,1.0,0.0,1.0,21,0.0273972602739726,0.684931506849315,0.2876712328767123
6141,4510228,3695,267,372,1173,3428,3695,1.0,0.0722598105548038,0.9277401894451962,2150,0.1006765899864682,0.31745602165087955,0.5818673883626523
6142,4510230,9043,285,708,2306,8758,9043,1.0,0.03151608979321022,0.9684839102067898,6029,0.07829260201260643,0.2550038703969921,0.6667035275904014
6143,4510241,4950,49,481,2571,4901,4950,1.0,0.009898989898989899,0.9901010101010101,1898,0.09717171717171717,0.5193939393939394,0.38343434343434346
6144,4510304,3945,44,445,1291,3901,3945,1.0,0.011153358681875792,0.9888466413181242,2209,0.11280101394169835,0.3272496831432193,0.5599493029150824
6145,4510305,53,2,10,28,51,53,1.0,0.03773584905660377,0.9622641509433962,15,0.18867924528301888,0.5283018867924528,0.2830188679245283
6146,4510306,1901,169,204,562,1732,1901,1.0,0.08890057864281957,0.9110994213571805,1135,0.10731194108364019,0.29563387690689114,0.5970541820094687
6147,4510308,465,12,73,100,453,465,1.0,0.025806451612903226,0.9741935483870968,292,0.15698924731182795,0.21505376344086022,0.6279569892473118
6148,4510319,4055,102,375,1590,3953,4055,1.0,0.025154130702836005,0.974845869297164,2090,0.09247842170160296,0.3921085080147966,0.5154130702836005
6149,4510327,4240,413,493,841,3827,4240,1.0,0.0974056603773585,0.9025943396226415,2906,0.11627358490566038,0.19834905660377358,0.685377358490566
6150,4510348,829,8,86,322,821,829,1.0,0.009650180940892641,0.9903498190591074,421,0.1037394451145959,0.3884197828709288,0.5078407720144753
6151,4510351,334,6,46,236,328,334,1.0,0.017964071856287425,0.9820359281437125,52,0.1377245508982036,0.7065868263473054,0.15568862275449102
6152,4510358,5298,38,366,1862,5260,5298,1.0,0.007172517931294828,0.9928274820687052,3070,0.06908267270668177,0.35145337863344656,0.5794639486598716
6153,4510401,213,15,32,99,198,213,1.0,0.07042253521126761,0.9295774647887324,82,0.15023474178403756,0.4647887323943662,0.38497652582159625
6154,4510402,5144,484,525,1218,4660,5144,1.0,0.09409020217729394,0.9059097978227061,3401,0.1020606531881804,0.23678071539657855,0.661158631415241
6155,4510420,215,8,26,125,207,215,1.0,0.037209302325581395,0.9627906976744186,64,0.12093023255813953,0.5813953488372093,0.29767441860465116
6156,4510421,3222,73,366,1310,3149,3222,1.0,0.02265673494723774,0.9773432650527623,1546,0.11359404096834265,0.4065797641216636,0.4798261949099938
6157,4510422,1359,10,90,662,1349,1359,1.0,0.007358351729212656,0.9926416482707874,607,0.06622516556291391,0.48712288447387786,0.44665194996320823
6158,4510423,1299,30,82,588,1269,1299,1.0,0.023094688221709007,0.976905311778291,629,0.06312548113933796,0.45265588914549654,0.4842186297151655
6159,4510424,2737,88,343,1216,2649,2737,1.0,0.03215199123127512,0.9678480087687249,1178,0.12531969309462915,0.4442820606503471,0.43039824625502376
6160,4510434,1547,47,185,329,1500,1547,1.0,0.030381383322559793,0.9696186166774402,1033,0.1195862960568843,0.21266968325791855,0.6677440206851971
6161,4510435,2036,70,201,390,1966,2036,1.0,0.0343811394891945,0.9656188605108055,1445,0.0987229862475442,0.19155206286836934,0.7097249508840865
6162,4510436,4487,26,586,1677,4461,4487,1.0,0.005794517494985513,0.9942054825050145,2224,0.1305995096946735,0.3737463784265656,0.49565411187876085
6163,4530101,6319,1745,1875,396,4574,6319,1.0,0.27615128976103814,0.7238487102389619,4048,0.2967241652160152,0.0626681436936224,0.6406076910903624
6164,4530102,1447,249,369,111,1198,1447,1.0,0.17208016586040084,0.8279198341395991,967,0.25501036627505186,0.07671043538355218,0.668279198341396
6165,4530103,2234,255,626,345,1979,2234,1.0,0.11414503133393017,0.8858549686660698,1263,0.2802148612354521,0.15443151298119964,0.5653536257833482
6166,4530104,1209,280,446,288,929,1209,1.0,0.23159636062861869,0.7684036393713813,475,0.36889991728701405,0.23821339950372208,0.39288668320926384
6167,4530105,7572,2471,2250,945,5101,7572,1.0,0.32633386159535127,0.6736661384046487,4377,0.2971473851030111,0.12480190174326466,0.5780507131537242
6168,4530106,5451,1081,876,906,4370,5451,1.0,0.19831223628691982,0.8016877637130801,3669,0.16070445789763346,0.16620803522289487,0.6730875068794716
6169,4530107,587,59,68,122,528,587,1.0,0.10051107325383304,0.899488926746167,397,0.11584327086882454,0.20783645655877342,0.676320272572402
6170,4530108,2357,500,608,199,1857,2357,1.0,0.21213406873143828,0.7878659312685617,1550,0.25795502757742894,0.08442935935511243,0.6576156130674586
6171,4530109,2301,264,857,446,2037,2301,1.0,0.11473272490221642,0.8852672750977836,998,0.37244676227727075,0.19382877009995655,0.4337244676227727
6172,4530110,8104,1254,1505,1111,6850,8104,1.0,0.15473840078973347,0.8452615992102666,5488,0.18571076011846002,0.13709279368213229,0.6771964461994077
6173,4530111,6366,724,1617,849,5642,6366,1.0,0.1137291863022306,0.8862708136977694,3900,0.2540056550424128,0.13336475023562677,0.6126295947219604
6174,4530112,2608,311,565,258,2297,2608,1.0,0.11924846625766872,0.8807515337423313,1785,0.21664110429447853,0.09892638036809816,0.6844325153374233
6175,4530113,9975,1270,2192,1005,8705,9975,1.0,0.12731829573934836,0.8726817042606516,6778,0.21974937343358397,0.10075187969924812,0.6794987468671679
6176,4530114,173,80,114,58,93,173,1.1466666666666667,0.4624277456647399,0.5375722543352601,1,0.6589595375722543,0.3352601156069364,0.005780346820809248
6179,4530117,4810,1726,1322,139,3084,4810,1.0,0.35883575883575886,0.6411642411642412,3349,0.27484407484407486,0.0288981288981289,0.6962577962577963
6180,4530118,1266,284,302,47,982,1266,1.0,0.22432859399684044,0.7756714060031595,917,0.23854660347551343,0.03712480252764613,0.7243285939968405
6182,4530120,494,239,42,26,255,494,1.0,0.48380566801619435,0.5161943319838057,426,0.08502024291497975,0.05263157894736842,0.8623481781376519
6183,4530121,1183,606,511,31,577,1183,1.0,0.5122569737954353,0.48774302620456467,641,0.4319526627218935,0.026204564666103127,0.5418427726120034
6184,4530122,3755,1844,1599,80,1911,3755,1.0,0.4910785619174434,0.5089214380825566,2076,0.425832223701731,0.02130492676431425,0.5528628495339547
6185,4530123,6414,1264,971,996,5150,6414,1.0,0.19706891175553476,0.8029310882444652,4447,0.1513875896476458,0.15528531337698784,0.6933270969753664
6186,4530124,6211,1610,2391,164,4601,6211,1.0,0.2592175173080019,0.7407824826919981,3656,0.3849621639027532,0.02640476573820641,0.5886330703590404
6188,4530126,6244,1841,2529,137,4403,6244,1.0,0.2948430493273543,0.7051569506726457,3578,0.4050288276745676,0.02194106342088405,0.5730301089045484
6190,4530128,1,0,0,0,1,1,1.0,0.0,1.0,1,0.0,0.0,1.0
6191,4530129,4689,1880,1388,58,2809,4689,1.0,0.40093836638942204,0.599061633610578,3243,0.2960119428449563,0.01236937513329068,0.691618682021753
6192,4530130,2103,369,938,151,1734,2103,1.0,0.1754636233951498,0.8245363766048502,1014,0.4460294816928198,0.07180218735140276,0.48216833095577744
6193,4530131,2,0,0,0,2,2,1.0,0.0,1.0,2,0.0,0.0,1.0
6194,4530132,3856,1241,1409,138,2615,3856,1.0,0.32183609958506226,0.6781639004149378,2309,0.3654045643153527,0.03578838174273859,0.5988070539419087
6195,4530133,2855,332,1176,203,2523,2855,1.0,0.11628721541155868,0.8837127845884414,1476,0.4119089316987741,0.07110332749562172,0.5169877408056042
6197,4530135,5878,409,2392,468,5469,5878,1.0,0.0695814903028241,0.9304185096971759,3018,0.4069411364409663,0.0796189179993195,0.5134399455597142
6198,4530136,3579,426,973,929,3153,3579,1.0,0.11902766135792121,0.8809723386420788,1677,0.27186364906398436,0.25956971221011454,0.4685666387259011
6199,4530137,9870,950,1915,2145,8920,9870,1.0,0.09625126646403243,0.9037487335359676,5810,0.1940222897669706,0.21732522796352582,0.5886524822695035
6201,4530139,5440,1173,1330,381,4267,5440,1.0,0.215625,0.784375,3729,0.24448529411764705,0.07003676470588235,0.6854779411764705
6202,4530140,3290,304,787,212,2986,3290,1.0,0.09240121580547113,0.9075987841945289,2291,0.239209726443769,0.06443768996960486,0.6963525835866261
6203,4530141,790,257,163,58,533,790,1.0,0.32531645569620254,0.6746835443037975,569,0.20632911392405062,0.07341772151898734,0.720253164556962
6204,4530142,1988,314,424,76,1674,1988,1.0,0.1579476861167002,0.8420523138832998,1488,0.21327967806841047,0.03822937625754527,0.7484909456740443
6205,4530145,3265,520,1131,552,2745,3265,1.0,0.15926493108728942,0.8407350689127105,1582,0.3464012251148545,0.16906584992343032,0.4845329249617152
6206,4530146,3124,763,941,829,2361,3124,1.0,0.2442381562099872,0.7557618437900128,1354,0.30121638924455824,0.2653649167733675,0.4334186939820743
6207,4530148,6592,974,1438,796,5618,6592,1.0,0.14775485436893204,0.852245145631068,4358,0.21814320388349515,0.12075242718446602,0.6611043689320388
6208,4530149,1830,75,744,123,1755,1830,1.0,0.040983606557377046,0.9590163934426229,963,0.4065573770491803,0.06721311475409836,0.5262295081967213
6209,4530150,2836,470,598,884,2366,2836,1.0,0.16572637517630465,0.8342736248236954,1354,0.21086036671368125,0.31170662905500707,0.4774330042313117
6210,4530151,2620,575,1277,203,2045,2620,1.0,0.21946564885496184,0.7805343511450382,1140,0.48740458015267174,0.07748091603053435,0.4351145038167939
6211,4530152,3633,24,2077,182,3609,3633,1.0,0.006606110652353427,0.9933938893476466,1374,0.5717038260390862,0.05009633911368015,0.3781998348472337
6212,4530153,6598,1269,1716,718,5329,6598,1.0,0.1923310093967869,0.8076689906032131,4164,0.2600788117611397,0.10882085480448621,0.6311003334343741
6213,4530154,4198,1015,837,465,3183,4198,1.0,0.24178180085755122,0.7582181991424488,2896,0.1993806574559314,0.11076703191996189,0.6898523106241067
6214,4530156,9240,1419,2451,506,7821,9240,1.0,0.15357142857142858,0.8464285714285714,6283,0.26525974025974025,0.05476190476190476,0.679978354978355
6215,4530160,3134,450,800,474,2684,3134,1.0,0.14358647096362476,0.8564135290363752,1860,0.2552648372686662,0.15124441608168473,0.593490746649649
6216,4530161,3425,555,611,416,2870,3425,1.0,0.16204379562043797,0.8379562043795621,2398,0.1783941605839416,0.12145985401459854,0.7001459854014599
6217,4530163,304,2,38,113,302,304,1.0,0.006578947368421052,0.993421052631579,153,0.125,0.3717105263157895,0.5032894736842105
6218,4530164,3240,625,719,198,2615,3240,1.0,0.19290123456790123,0.8070987654320988,2323,0.22191358024691357,0.06111111111111111,0.7169753086419753
6219,4530200,6294,212,2276,500,6082,6294,1.0,0.033682872577057515,0.9663171274229425,3518,0.36161423578010804,0.07944073721004132,0.5589450270098506
6220,4530202,3468,95,1741,344,3373,3468,1.0,0.027393310265282585,0.9726066897347174,1383,0.5020184544405998,0.09919261822376009,0.39878892733564014
6221,4530203,1308,97,233,171,1211,1308,1.0,0.07415902140672782,0.9258409785932722,904,0.17813455657492355,0.13073394495412843,0.691131498470948
6222,4530205,4264,426,1054,416,3838,4264,1.0,0.099906191369606,0.900093808630394,2794,0.24718574108818012,0.0975609756097561,0.6552532833020638
6223,4530206,2104,54,475,175,2050,2104,1.0,0.025665399239543727,0.9743346007604563,1454,0.22576045627376426,0.08317490494296578,0.69106463878327
6224,4530207,6061,301,1654,1142,5760,6061,1.0,0.04966177198482099,0.950338228015179,3265,0.2728922620029698,0.18841775284606502,0.5386899851509652
6225,4530208,9629,1533,2752,1102,8096,9629,1.0,0.1592065635060754,0.8407934364939246,5775,0.28580330252362657,0.11444594454252778,0.5997507529338457
6226,4530209,1884,291,413,127,1593,1884,1.0,0.15445859872611464,0.8455414012738853,1344,0.21921443736730362,0.06740976645435244,0.7133757961783439
6227,4530210,1740,35,779,565,1705,1740,1.0,0.020114942528735632,0.9798850574712644,396,0.4477011494252874,0.32471264367816094,0.22758620689655173
6228,4530211,2584,278,713,324,2306,2584,1.0,0.10758513931888544,0.8924148606811145,1547,0.27592879256965946,0.12538699690402477,0.5986842105263158
6229,4530212,3774,25,1046,2169,3749,3774,1.0,0.006624271330153683,0.9933757286698464,559,0.2771595124536301,0.5747217806041336,0.14811870694223636
6231,4530214,2487,1,1030,848,2486,2487,1.0,0.0004020908725371934,0.9995979091274628,609,0.4141535987133092,0.34097305991154003,0.2448733413751508
6232,4530215,2452,374,804,483,2078,2452,1.0,0.15252854812398042,0.8474714518760196,1165,0.3278955954323002,0.1969820554649266,0.47512234910277323
6233,4530216,3727,649,826,349,3078,3727,1.0,0.1741346927823987,0.8258653072176013,2552,0.22162597263214381,0.09364099812181378,0.6847330292460424
6234,4530217,2850,306,887,358,2544,2850,1.0,0.10736842105263159,0.8926315789473684,1605,0.3112280701754386,0.1256140350877193,0.5631578947368421
6235,4530218,7308,679,1570,699,6629,7308,1.0,0.09291187739463602,0.907088122605364,5039,0.21483305966064586,0.09564860426929392,0.6895183360700602
6236,4530219,3833,530,1086,729,3303,3833,1.0,0.13827289329506914,0.8617271067049309,2018,0.2833289851291417,0.1901904513435951,0.5264805635272632
6237,4530220,1676,3,700,605,1673,1676,1.0,0.0017899761336515514,0.9982100238663485,371,0.41766109785202865,0.36097852028639615,0.22136038186157517
6238,4530221,1164,17,260,392,1147,1164,1.0,0.014604810996563574,0.9853951890034365,512,0.22336769759450173,0.33676975945017185,0.43986254295532645
6239,4530222,3919,379,1074,455,3540,3919,1.0,0.09670834396529727,0.9032916560347027,2390,0.27404950242408777,0.11610104618525134,0.6098494513906609
6240,4530223,1335,111,227,90,1224,1335,1.0,0.08314606741573034,0.9168539325842696,1018,0.1700374531835206,0.06741573033707865,0.7625468164794007
6241,4530224,380,21,87,26,359,380,1.0,0.05526315789473684,0.9447368421052632,267,0.22894736842105262,0.06842105263157895,0.7026315789473684
6242,4530225,4664,604,1255,757,4060,4664,1.0,0.12950257289879932,0.8704974271012007,2652,0.26908233276157806,0.16230703259005147,0.5686106346483705
6243,4530226,2560,426,591,236,2134,2560,1.0,0.16640625,0.83359375,1733,0.230859375,0.0921875,0.676953125
6244,4530227,1911,241,262,152,1670,1911,1.0,0.1261119832548404,0.8738880167451596,1497,0.1371009942438514,0.07953950811093669,0.783359497645212
6245,4530228,2023,104,606,508,1919,2023,1.0,0.0514087988136431,0.9485912011863569,909,0.2995551161641127,0.25111220958971825,0.4493326742461691
6246,4530229,2118,258,860,439,1860,2118,1.0,0.12181303116147309,0.8781869688385269,819,0.4060434372049103,0.2072710103871577,0.386685552407932
6247,4530231,3039,35,1107,943,3004,3039,1.0,0.011516946363935505,0.9884830536360645,989,0.36426456071076013,0.31029944060546233,0.32543599868377754
6248,4530232,6448,127,1361,2818,6321,6448,1.0,0.019696029776674936,0.980303970223325,2269,0.21107320099255583,0.43703473945409427,0.3518920595533499
6249,4530233,3684,68,966,1463,3616,3684,1.0,0.018458197611292075,0.9815418023887079,1255,0.26221498371335505,0.3971226927252986,0.34066232356134635
6250,4530234,2423,39,550,1105,2384,2423,1.0,0.01609574907139909,0.9839042509286009,768,0.22699133305819233,0.45604622368964093,0.3169624432521667
6251,4530235,3385,52,1315,245,3333,3385,1.0,0.01536189069423929,0.9846381093057607,1825,0.38847858197932056,0.0723781388478582,0.5391432791728212
6252,4530236,3538,100,1703,467,3438,3538,1.0,0.02826455624646693,0.971735443753533,1368,0.4813453928773318,0.13199547767100056,0.3866591294516676
6253,4530237,1898,14,860,734,1884,1898,1.0,0.007376185458377239,0.9926238145416227,304,0.45310853530031614,0.38672286617492097,0.1601685985247629
6254,4530238,2864,33,1225,679,2831,2864,1.0,0.011522346368715084,0.9884776536312849,960,0.42772346368715086,0.23708100558659218,0.33519553072625696
6255,4530239,2204,9,1186,533,2195,2204,1.0,0.004083484573502722,0.9959165154264973,485,0.5381125226860254,0.24183303085299457,0.22005444646098005
6256,4530240,1222,0,512,256,1222,1222,1.0,0.0,1.0,454,0.41898527004909986,0.20949263502454993,0.37152209492635024
6257,4530241,1580,0,885,276,1580,1580,1.0,0.0,1.0,419,0.560126582278481,0.17468354430379746,0.26518987341772154
6258,4530242,6753,128,2494,654,6625,6753,1.0,0.018954538723530284,0.9810454612764697,3605,0.36931734044128534,0.09684584629053754,0.5338368132681771
6259,4530243,2086,20,842,394,2066,2086,1.0,0.009587727708533078,0.9904122722914669,850,0.40364333652924256,0.18887823585810162,0.4074784276126558
6260,4530244,4644,104,990,1435,4540,4644,1.0,0.02239448751076658,0.9776055124892334,2219,0.2131782945736434,0.3090008613264427,0.4778208440999139
6261,4530245,1527,22,317,500,1505,1527,1.0,0.014407334643091027,0.9855926653569089,710,0.20759659462999344,0.3274394237066143,0.46496398166339226
6262,4530246,1827,19,687,550,1808,1827,1.0,0.010399562123700055,0.9896004378762999,590,0.3760262725779967,0.30103995621237,0.3229337712096333
6263,4530247,669,11,266,341,658,669,1.0,0.016442451420029897,0.9835575485799701,62,0.3976083707025411,0.5097159940209267,0.09267563527653214
6264,4530248,2777,59,1033,412,2718,2777,1.0,0.02124594886568239,0.9787540511343176,1332,0.3719841555635578,0.14836154123154482,0.4796543032048974
6265,4530249,3141,99,1257,865,3042,3141,1.0,0.03151862464183381,0.9684813753581661,1019,0.40019102196752626,0.27539000318369944,0.3244189748487743
6266,4530250,6558,68,2429,883,6490,6558,1.0,0.01036901494358036,0.9896309850564197,3246,0.3703873132052455,0.13464470875266848,0.494967978042086
6267,4530251,3406,46,1380,734,3360,3406,1.0,0.013505578391074574,0.9864944216089254,1292,0.4051673517322372,0.21550205519671167,0.3793305930710511
6268,4530252,3128,35,1226,513,3093,3128,1.0,0.01118925831202046,0.9888107416879796,1389,0.39194373401534527,0.16400255754475704,0.4440537084398977
6269,4530253,3077,11,1107,1080,3066,3077,1.0,0.0035749106272343193,0.9964250893727656,890,0.35976600584985374,0.35099122521936954,0.2892427689307767
6270,4530254,3792,88,1278,912,3704,3792,1.0,0.023206751054852322,0.9767932489451476,1602,0.3370253164556962,0.24050632911392406,0.4224683544303797
6271,4530256,1942,26,718,897,1916,1942,1.0,0.013388259526261586,0.9866117404737385,327,0.36972193614830073,0.46189495365602473,0.16838311019567456
6272,4530258,3067,112,983,622,2955,3067,1.0,0.03651776980762961,0.9634822301923704,1462,0.3205086403651777,0.20280404303880012,0.47668731659602215
6273,4530259,2986,135,1155,674,2851,2986,1.0,0.04521098459477562,0.9547890154052244,1157,0.3868050904219692,0.22572002679169456,0.38747488278633624
6274,4530260,2640,422,481,147,2218,2640,1.0,0.15984848484848485,0.8401515151515152,2012,0.1821969696969697,0.05568181818181818,0.7621212121212121
6275,4530262,5829,240,1864,1180,5589,5829,1.0,0.041173443129181676,0.9588265568708183,2785,0.319780408303311,0.20243609538514326,0.4777834963115457
6276,4530263,3364,72,1167,621,3292,3364,1.0,0.02140309155766944,0.9785969084423306,1576,0.34690844233055884,0.18460166468489894,0.4684898929845422
6277,4530266,461,4,206,212,457,461,1.0,0.008676789587852495,0.9913232104121475,43,0.44685466377440347,0.4598698481561822,0.09327548806941431
6278,4530267,2019,91,608,389,1928,2019,1.0,0.04507181773155027,0.9549281822684498,1022,0.3011391778107974,0.19266963843486876,0.5061911837543338
6279,4530268,1598,148,487,177,1450,1598,1.0,0.09261576971214018,0.9073842302878599,934,0.304755944931164,0.11076345431789737,0.5844806007509387
6280,4530273,3316,19,1430,532,3297,3316,1.0,0.005729794933655006,0.994270205066345,1354,0.4312424607961399,0.16043425814234016,0.4083232810615199
6281,4530274,2914,50,1282,258,2864,2914,1.0,0.017158544955387784,0.9828414550446122,1374,0.43994509265614273,0.08853809196980096,0.47151681537405626
6282,4530275,3669,81,1845,282,3588,3669,1.0,0.022076860179885527,0.9779231398201145,1542,0.5028618152085037,0.07686017988552739,0.42027800490596895
6283,4530277,8009,353,1531,965,7656,8009,1.0,0.04407541515794731,0.9559245848420527,5513,0.19115994506180548,0.12048944936945936,0.6883506055687352
6284,4530301,1474,55,485,322,1419,1474,1.0,0.03731343283582089,0.9626865671641791,667,0.32903663500678426,0.21845318860244234,0.4525101763907734
6285,4530302,3834,132,1011,1167,3702,3834,1.0,0.03442879499217527,0.9655712050078247,1656,0.26369327073552423,0.30438184663536777,0.431924882629108
6286,4530303,3157,110,811,1031,3047,3157,1.0,0.03484320557491289,0.9651567944250871,1315,0.25688945201140323,0.326575863161229,0.4165346848273678
6287,4530304,4125,15,1399,1494,4110,4125,1.0,0.0036363636363636364,0.9963636363636363,1232,0.33915151515151515,0.36218181818181816,0.2986666666666667
6288,4530305,7,0,5,2,7,7,1.4,0.0,1.0,0,0.7142857142857143,0.2857142857142857,0.0
6289,4530306,2583,21,613,1432,2562,2583,1.0,0.008130081300813009,0.991869918699187,538,0.2373209446380178,0.5543941153697252,0.20828493999225706
6290,4530307,1347,4,573,570,1343,1347,1.0,0.002969561989606533,0.9970304380103935,204,0.42538975501113585,0.42316258351893093,0.1514476614699332
6291,4530308,5217,18,1077,2217,5199,5217,1.0,0.0034502587694077054,0.9965497412305923,1923,0.20644048303622772,0.4249568717653824,0.36860264519838987
6292,4530309,2793,122,943,697,2671,2793,1.0,0.04368063014679556,0.9563193698532044,1153,0.3376297887576083,0.24955245255997136,0.4128177586824203
6293,4530310,6378,307,1470,1152,6071,6378,1.0,0.04813421135152085,0.9518657886484791,3756,0.23047977422389465,0.18062088428974601,0.5888993414863594
6294,4530311,6332,203,1751,685,6129,6332,1.0,0.03205938092229943,0.9679406190777006,3896,0.27653190145293743,0.10818066961465572,0.6152874289324068
6295,4530312,1524,5,525,844,1519,1524,1.0,0.0032808398950131233,0.9967191601049868,155,0.34448818897637795,0.5538057742782152,0.10170603674540682
6296,4530313,336,29,141,41,307,336,1.0,0.08630952380952381,0.9136904761904762,154,0.41964285714285715,0.12202380952380952,0.4583333333333333
6297,4530314,5089,116,1102,2157,4973,5089,1.0,0.02279426213401454,0.9772057378659854,1830,0.21654549027313813,0.42385537433680487,0.359599135390057
6298,4530315,3227,279,1246,1240,2948,3227,1.0,0.08645801053610164,0.9135419894638983,741,0.38611713665943603,0.3842578246048962,0.2296250387356678
6299,4530316,2635,0,395,701,2635,2635,1.0,0.0,1.0,1539,0.14990512333965844,0.266034155597723,0.5840607210626186
6300,4530317,2507,0,900,1072,2507,2507,1.0,0.0,1.0,535,0.35899481451934584,0.42760271240526526,0.2134024730753889
6301,4530318,712,0,203,325,712,712,1.0,0.0,1.0,184,0.2851123595505618,0.45646067415730335,0.25842696629213485
6302,4530319,2597,70,530,1155,2527,2597,1.0,0.026954177897574125,0.9730458221024259,912,0.20408163265306123,0.444743935309973,0.35117443203696574
6303,4530320,2310,105,394,1031,2205,2310,1.0,0.045454545454545456,0.9545454545454546,885,0.17056277056277055,0.44632034632034634,0.38311688311688313
6304,4530321,517,21,283,233,496,517,1.0794979079497908,0.04061895551257253,0.9593810444874274,1,0.5473887814313346,0.4506769825918762,0.0019342359767891683
6305,4530323,2742,224,868,421,2518,2742,1.0,0.08169219547775347,0.9183078045222466,1453,0.31655725747629465,0.1535375638220277,0.5299051787016776
6306,4530324,6965,120,993,2294,6845,6965,1.0,0.01722900215362527,0.9827709978463748,3678,0.1425699928212491,0.3293610911701364,0.5280689160086145
6307,4530325,22,0,10,12,22,22,3.6666666666666665,0.0,1.0,0,0.45454545454545453,0.5454545454545454,0.0
6308,4530326,2390,8,822,826,2382,2390,1.0,0.0033472803347280333,0.9966527196652719,742,0.34393305439330546,0.34560669456066945,0.3104602510460251
6309,4530327,2978,36,1105,1062,2942,2978,1.0,0.01208865010073875,0.9879113498992612,811,0.37105439892545333,0.35661517797179315,0.2723304231027535
6310,4530328,5211,226,1538,1032,4985,5211,1.0,0.04336979466513145,0.9566302053348685,2641,0.29514488581846093,0.1980426021876799,0.5068125119938591
6311,4530329,4310,261,1214,802,4049,4310,1.0,0.060556844547563805,0.9394431554524362,2294,0.2816705336426914,0.18607888631090488,0.5322505800464037
6312,4530330,2549,55,900,1238,2494,2549,1.0,0.02157708905453119,0.9784229109454688,411,0.35307963907414674,0.4856806590819929,0.16123970184386033
6313,4530331,2780,19,1035,920,2761,2780,1.0,0.006834532374100719,0.9931654676258993,825,0.3723021582733813,0.33093525179856115,0.29676258992805754
6314,4530332,3726,36,1623,291,3690,3726,1.0,0.00966183574879227,0.9903381642512077,1812,0.4355877616747182,0.07809983896940419,0.4863123993558776
6315,4530333,3368,171,973,1038,3197,3368,1.0,0.05077197149643706,0.9492280285035629,1357,0.288895486935867,0.3081947743467934,0.40290973871733965
6316,4530334,3356,111,895,1312,3245,3356,1.0,0.033075089392133494,0.9669249106078666,1149,0.2666865315852205,0.3909415971394517,0.34237187127532775
6317,4530335,2475,30,893,817,2445,2475,1.0,0.012121212121212121,0.9878787878787879,765,0.3608080808080808,0.3301010101010101,0.3090909090909091
6318,4530336,2320,26,771,853,2294,2320,1.0,0.011206896551724138,0.9887931034482759,696,0.33232758620689656,0.36767241379310345,0.3
6319,4530337,5047,484,1320,1192,4563,5047,1.0,0.09589855359619576,0.9041014464038042,2535,0.2615415098078066,0.23617990885674658,0.5022785813354468
6320,4530338,4715,17,1696,1720,4698,4715,1.0,0.0036055143160127253,0.9963944856839873,1299,0.3597030752916225,0.3647932131495228,0.2755037115588547
6321,4530339,2052,155,744,455,1897,2052,1.0,0.07553606237816764,0.9244639376218323,853,0.36257309941520466,0.22173489278752437,0.41569200779727095
6322,4530340,2923,28,861,305,2895,2923,1.0,0.009579199452617175,0.9904208005473828,1757,0.2945603831679781,0.10434485118029421,0.6010947656517277
6324,4530342,4983,9,2551,736,4974,4983,1.0,0.001806140878988561,0.9981938591210114,1696,0.5119405980333133,0.14770218743728677,0.3403572145294
6325,4530343,3783,258,703,630,3525,3783,1.0,0.06819984139571768,0.9318001586042823,2450,0.1858313507798044,0.16653449643140364,0.647634152788792
6326,4530344,2086,80,795,347,2006,2086,1.0,0.038350910834132314,0.9616490891658677,944,0.3811121764141898,0.1663470757430489,0.45254074784276127
6327,4530345,2,0,0,1,2,2,1.0,0.0,1.0,1,0.0,0.5,0.5
6328,4530346,3553,66,580,2091,3487,3553,1.0,0.018575851393188854,0.9814241486068112,882,0.16324233042499298,0.5885167464114832,0.24824092316352378
6329,4530347,2890,35,996,1028,2855,2890,1.0,0.012110726643598616,0.9878892733564014,866,0.34463667820069205,0.35570934256055364,0.2996539792387543
6330,4530349,5786,146,1723,1310,5640,5786,1.0,0.02523332181126858,0.9747666781887314,2753,0.29778776356723125,0.22640857241617698,0.4758036640165918
6331,4530350,4957,147,1577,868,4810,4957,1.0,0.029655033286261852,0.9703449667137382,2512,0.3181359693362921,0.17510591083316523,0.5067581198305426
6332,4530351,2536,115,732,402,2421,2536,1.0,0.045347003154574135,0.9546529968454258,1402,0.2886435331230284,0.15851735015772872,0.5528391167192429
6333,4530352,4071,19,1484,637,4052,4071,1.0,0.004667157946450504,0.9953328420535495,1950,0.3645295996069762,0.1564726111520511,0.47899778924097275
6334,4530354,4739,62,1660,1421,4677,4739,1.0,0.013082928887951045,0.986917071112049,1658,0.350284870225786,0.2998522895125554,0.3498628402616586
6335,4530356,2565,40,836,379,2525,2565,1.0,0.015594541910331383,0.9844054580896686,1350,0.32592592592592595,0.14775828460038987,0.5263157894736842
6336,4530357,546,0,221,226,546,546,1.0,0.0,1.0,99,0.40476190476190477,0.4139194139194139,0.1813186813186813
6337,4530358,5830,393,2004,883,5437,5830,1.0,0.06740994854202402,0.932590051457976,2943,0.34373927958833617,0.15145797598627786,0.504802744425386
6338,4530359,4958,91,1036,1631,4867,4958,1.0,0.01835417507059298,0.981645824929407,2291,0.208955223880597,0.3289632916498588,0.46208148446954417
6339,4530360,5433,259,1531,1216,5174,5433,1.0,0.047671636296705316,0.9523283637032947,2686,0.28179642922878706,0.22381741211117245,0.4943861586600405
6340,4530361,2024,3,426,456,2021,2024,1.0,0.0014822134387351778,0.9985177865612648,1142,0.21047430830039526,0.22529644268774704,0.5642292490118577
6341,4530362,2750,59,1230,736,2691,2750,1.0,0.021454545454545455,0.9785454545454545,784,0.44727272727272727,0.2676363636363636,0.2850909090909091
6342,4530363,1725,0,592,554,1725,1725,1.0,0.0,1.0,579,0.34318840579710147,0.32115942028985506,0.3356521739130435
6343,4530364,3296,4,1320,1367,3292,3296,1.0,0.0012135922330097086,0.9987864077669902,609,0.40048543689320387,0.41474514563106796,0.18476941747572814
6344,4530365,2400,61,629,612,2339,2400,1.0,0.025416666666666667,0.9745833333333334,1159,0.26208333333333333,0.255,0.48291666666666666
6345,4530366,5172,304,1801,1534,4868,5172,1.0,0.05877803557617943,0.9412219644238206,1837,0.3482211910286156,0.2965970610982212,0.3551817478731632
6346,4530367,5849,155,1765,1978,5694,5849,1.0,0.026500256454094717,0.9734997435459053,2106,0.3017609847837237,0.3381774662335442,0.36006154898273207
6347,4530368,310,4,81,226,306,310,1.0,0.012903225806451613,0.9870967741935484,3,0.26129032258064516,0.7290322580645161,0.00967741935483871
6348,4530369,2258,38,298,866,2220,2258,1.0,0.01682905225863596,0.983170947741364,1094,0.13197519929140833,0.38352524357838796,0.4844995571302037
6349,4530370,2671,44,316,527,2627,2671,1.0,0.01647323099962561,0.9835267690003744,1828,0.1183077499064021,0.19730438038187945,0.6843878697117185
6350,4530371,3165,85,540,1013,3080,3165,1.0,0.026856240126382307,0.9731437598736177,1612,0.17061611374407584,0.32006319115323856,0.5093206951026856
6351,4530372,2319,36,441,700,2283,2319,1.0,0.015523932729624839,0.9844760672703752,1178,0.19016817593790428,0.30185424752048295,0.5079775765416128
6352,4530373,5181,58,946,2277,5123,5181,1.0,0.011194750048253233,0.9888052499517468,1958,0.18259023354564755,0.4394904458598726,0.37791932059447986
6353,4530374,5836,50,1142,2392,5786,5836,1.0,0.008567511994516792,0.9914324880054832,2302,0.19568197395476353,0.40986977381768336,0.39444825222755314
6354,4530375,1006,8,211,400,998,1006,1.0,0.007952286282306162,0.9920477137176938,395,0.20974155069582506,0.3976143141153082,0.3926441351888668
6355,4530401,4210,503,708,357,3707,4210,1.0,0.11947743467933492,0.8805225653206651,3145,0.1681710213776722,0.08479809976247031,0.7470308788598575
6356,4530402,5954,472,1117,423,5482,5954,1.0,0.07927443735303998,0.92072556264696,4414,0.1876049714477662,0.0710446758481693,0.7413503527040645
6357,4530403,2038,106,374,295,1932,2038,1.0,0.052011776251226695,0.9479882237487733,1369,0.18351324828263002,0.14474975466143278,0.6717369970559371
6358,4530404,3801,376,756,213,3425,3801,1.0,0.09892133649039726,0.9010786635096028,2832,0.19889502762430938,0.056037884767166535,0.745067087608524
6359,4530405,1128,110,136,76,1018,1128,1.0,0.0975177304964539,0.9024822695035462,916,0.12056737588652482,0.0673758865248227,0.8120567375886525
6360,4530406,5220,154,940,1167,5066,5220,1.0,0.02950191570881226,0.9704980842911878,3113,0.18007662835249041,0.2235632183908046,0.596360153256705
6361,4530407,5690,1053,654,142,4637,5690,1.0,0.1850615114235501,0.8149384885764499,4894,0.11493848857644991,0.024956063268892794,0.8601054481546573
6362,4530408,4946,369,1234,592,4577,4946,1.0,0.07460574201374848,0.9253942579862515,3120,0.2494945410432673,0.1196926809543065,0.6308127780024262
6363,4530409,2303,97,963,147,2206,2303,1.0,0.04211897524967434,0.9578810247503257,1193,0.4181502388189318,0.06382978723404255,0.5180199739470256
6364,4530410,4787,516,1159,347,4271,4787,1.0,0.10779193649467307,0.8922080635053269,3281,0.24211405890954668,0.0724879883016503,0.685397952788803
6365,4530411,2889,217,623,230,2672,2889,1.0,0.07511249567324334,0.9248875043267567,2036,0.21564555209415023,0.0796123226029768,0.704742125302873
6366,4530412,325,0,37,9,325,325,1.0,0.0,1.0,279,0.11384615384615385,0.027692307692307693,0.8584615384615385
6367,4530413,1559,100,293,139,1459,1559,1.0,0.06414368184733804,0.935856318152662,1127,0.18794098781270044,0.08915971776779986,0.7228992944194996
6368,4530414,4725,412,1043,552,4313,4725,1.0,0.0871957671957672,0.9128042328042328,3130,0.22074074074074074,0.11682539682539683,0.6624338624338625
6369,4530415,1355,8,469,202,1347,1355,1.0,0.005904059040590406,0.9940959409594096,684,0.3461254612546125,0.14907749077490776,0.5047970479704798
6370,4530416,46,2,12,8,44,46,1.0,0.043478260869565216,0.9565217391304348,26,0.2608695652173913,0.17391304347826086,0.5652173913043478
6371,4530417,2459,70,647,259,2389,2459,1.0,0.028466856445709638,0.9715331435542903,1553,0.2631150874339162,0.10532736884912566,0.6315575437169582
6372,4530418,7,0,0,4,7,7,1.0,0.0,1.0,3,0.0,0.5714285714285714,0.42857142857142855
6373,4530419,719,4,177,126,715,719,1.0,0.005563282336578581,0.9944367176634215,416,0.24617524339360222,0.17524339360222532,0.5785813630041725
6374,4530420,4499,385,1088,215,4114,4499,1.0,0.08557457212713937,0.9144254278728606,3196,0.2418315181151367,0.047788397421649254,0.7103800844632141
6375,4530421,2984,35,1446,388,2949,2984,1.0,0.011729222520107238,0.9882707774798928,1150,0.48458445040214476,0.13002680965147453,0.3853887399463807
6376,4530422,2783,139,1249,176,2644,2783,1.0,0.04994610132950054,0.9500538986704995,1358,0.448796263025512,0.06324110671936758,0.4879626302551204
6377,4530423,5853,1140,1397,248,4713,5853,1.0,0.194771911840082,0.805228088159918,4208,0.23868101828122332,0.042371433452930124,0.7189475482658466
6378,4530424,3087,215,1250,215,2872,3087,1.0,0.06964690638160026,0.9303530936183998,1622,0.4049238743116294,0.06964690638160026,0.5254292193067703
6379,4530425,913,49,262,102,864,913,1.0,0.05366922234392114,0.9463307776560789,549,0.28696604600219056,0.11171960569550932,0.6013143483023001
6380,4530426,3485,136,1175,135,3349,3485,1.0,0.03902439024390244,0.9609756097560975,2175,0.33715925394548063,0.03873744619799139,0.624103299856528
6381,4530427,2972,395,940,87,2577,2972,1.0,0.132907133243607,0.867092866756393,1945,0.3162853297442799,0.029273216689098252,0.6544414535666218
6382,4530428,1990,130,481,258,1860,1990,1.0,0.06532663316582915,0.9346733668341709,1251,0.24170854271356784,0.12964824120603016,0.628643216080402
6383,4530429,12274,1672,2402,412,10602,12274,1.0,0.13622291021671826,0.8637770897832817,9460,0.1956982238878931,0.03356688935962197,0.7707348867524849
6384,4530430,1960,120,642,87,1840,1960,1.0,0.061224489795918366,0.9387755102040817,1231,0.32755102040816325,0.044387755102040814,0.628061224489796
6385,4530431,9879,1259,2301,365,8620,9879,1.0,0.1274420487903634,0.8725579512096366,7213,0.23291831156999696,0.03694705941896953,0.7301346290110335
6386,4530432,3,0,2,0,3,3,1.0,0.0,1.0,1,0.6666666666666666,0.0,0.3333333333333333
6387,4530433,4415,235,1343,242,4180,4415,1.0,0.053227633069082674,0.9467723669309174,2830,0.3041902604756512,0.05481313703284258,0.6409966024915063
6388,4530434,1,0,1,0,1,1,1.0,0.0,1.0,0,1.0,0.0,0.0
6389,4530435,8090,417,2203,1061,7673,8090,1.0,0.0515451174289246,0.9484548825710754,4826,0.2723114956736712,0.1311495673671199,0.5965389369592089
6390,4530436,655,46,168,12,609,655,1.0,0.07022900763358779,0.9297709923664123,475,0.2564885496183206,0.0183206106870229,0.7251908396946565
6391,4530437,3167,71,1329,235,3096,3167,1.0,0.02241869276918219,0.9775813072308178,1603,0.41964003789074833,0.0742027155036312,0.5061572466056204
6392,4530438,1709,121,640,90,1588,1709,1.0,0.07080163838502047,0.9291983616149795,979,0.37448800468110005,0.0526623756582797,0.5728496196606202
6393,4530439,3050,157,1220,129,2893,3050,1.0,0.05147540983606557,0.9485245901639344,1701,0.4,0.04229508196721311,0.5577049180327869
6394,4530440,1498,133,410,84,1365,1498,1.0,0.08878504672897196,0.9112149532710281,1004,0.27369826435246997,0.056074766355140186,0.6702269692923899
6395,4530441,5433,364,1615,459,5069,5433,1.0,0.06699797533591018,0.9330020246640898,3359,0.2972575004601509,0.08448371065709552,0.6182587888827535
6396,4530442,2058,104,547,110,1954,2058,1.0,0.05053449951409135,0.9494655004859086,1401,0.2657920310981535,0.05344995140913508,0.6807580174927114
6397,4530443,5640,337,1485,303,5303,5640,1.0,0.05975177304964539,0.9402482269503546,3852,0.2632978723404255,0.05372340425531915,0.6829787234042554
6398,4530444,694,56,98,4,638,694,1.0,0.08069164265129683,0.9193083573487032,592,0.14121037463976946,0.005763688760806916,0.8530259365994236
6399,4530446,1468,40,489,115,1428,1468,1.0,0.027247956403269755,0.9727520435967303,864,0.33310626702997276,0.07833787465940055,0.5885558583106267
6400,4530447,5450,254,1504,443,5196,5450,1.0,0.04660550458715596,0.953394495412844,3503,0.2759633027522936,0.08128440366972477,0.6427522935779817
6401,4530448,5826,651,1045,281,5175,5826,1.0,0.111740473738414,0.888259526261586,4500,0.1793683487813251,0.048232063165121866,0.772399588053553
6402,4530450,6423,763,1476,347,5660,6423,1.0,0.11879184181846489,0.8812081581815351,4600,0.2297991592713685,0.054024599096995175,0.7161762416316363
6403,4530451,4486,328,1236,369,4158,4486,1.0,0.07311636201515827,0.9268836379848417,2881,0.2755238519839501,0.08225590726705305,0.6422202407489969
6404,4530452,4870,625,835,143,4245,4870,1.0,0.12833675564681724,0.8716632443531828,3892,0.17145790554414783,0.029363449691991787,0.7991786447638604
6405,4530454,2869,164,834,425,2705,2869,1.0,0.05716277448588358,0.9428372255141164,1610,0.2906936214708958,0.14813523875914952,0.5611711397699547
6406,4530458,4185,206,1475,556,3979,4185,1.0,0.04922341696535245,0.9507765830346475,2154,0.35244922341696533,0.13285543608124253,0.5146953405017921
6407,4530460,4321,200,1508,453,4121,4321,1.0,0.046285582041194165,0.9537144179588058,2360,0.348993288590604,0.10483684332330478,0.5461698680860911
6408,4530461,5274,200,1813,396,5074,5274,1.0,0.037921880925293895,0.9620781190747061,3065,0.34376185058778913,0.07508532423208192,0.5811528251801289
6409,4530463,4174,352,1347,467,3822,4174,1.0,0.08433157642549113,0.9156684235745088,2360,0.32271202683277433,0.11188308576904647,0.5654048873981792
6410,4550001,773,75,98,383,698,773,1.0,0.09702457956015524,0.9029754204398448,292,0.12677878395860284,0.49547218628719275,0.3777490297542044
6411,4550002,833,8,80,304,825,833,1.0,0.009603841536614645,0.9903961584633854,449,0.09603841536614646,0.36494597839135656,0.539015606242497
6412,4550003,482,75,65,190,407,482,1.0,0.15560165975103735,0.8443983402489627,227,0.13485477178423236,0.3941908713692946,0.470954356846473
6413,4550004,364,0,25,147,364,364,1.0,0.0,1.0,192,0.06868131868131869,0.40384615384615385,0.5274725274725275
6414,4550005,501,55,33,112,446,501,1.0,0.10978043912175649,0.8902195608782435,356,0.0658682634730539,0.22355289421157684,0.7105788423153693
6415,4550006,254,0,17,129,254,254,1.0,0.0,1.0,108,0.06692913385826772,0.5078740157480315,0.4251968503937008
6416,4550007,168,0,23,117,168,168,1.0,0.0,1.0,28,0.13690476190476192,0.6964285714285714,0.16666666666666666
6417,4550008,428,0,34,241,428,428,1.0,0.0,1.0,153,0.0794392523364486,0.5630841121495327,0.3574766355140187
6418,4550009,573,89,59,279,484,573,1.0,0.15532286212914484,0.8446771378708552,235,0.10296684118673648,0.4869109947643979,0.41012216404886565
6419,4550010,308,7,34,184,301,308,1.0,0.022727272727272728,0.9772727272727273,90,0.11038961038961038,0.5974025974025974,0.2922077922077922
6420,4550011,1932,4,229,809,1928,1932,1.0,0.002070393374741201,0.9979296066252588,894,0.11853002070393374,0.41873706004140787,0.46273291925465837
6421,4550012,89,6,24,48,83,89,1.0,0.06741573033707865,0.9325842696629213,17,0.2696629213483146,0.5393258426966292,0.19101123595505617
6422,4550014,686,0,98,344,686,686,1.0,0.0,1.0,244,0.14285714285714285,0.5014577259475219,0.3556851311953353
6423,4550015,101,0,10,64,101,101,1.0,0.0,1.0,27,0.09900990099009901,0.6336633663366337,0.26732673267326734
6424,4550016,704,111,82,220,593,704,1.0,0.15767045454545456,0.8423295454545454,402,0.11647727272727272,0.3125,0.5710227272727273
6425,4550017,669,219,389,103,450,669,1.0,0.3273542600896861,0.672645739910314,177,0.5814648729446936,0.15396113602391628,0.2645739910313901
6426,4550018,131,33,64,7,98,131,1.0,0.25190839694656486,0.7480916030534351,60,0.48854961832061067,0.05343511450381679,0.4580152671755725
6427,4550019,1718,352,204,668,1366,1718,1.0,0.2048894062863795,0.7951105937136205,846,0.11874272409778813,0.38882421420256114,0.49243306169965073
6428,4550020,75,2,20,31,73,75,1.0,0.02666666666666667,0.9733333333333334,24,0.26666666666666666,0.41333333333333333,0.32
6429,4550021,484,7,26,157,477,484,1.0,0.014462809917355372,0.9855371900826446,301,0.05371900826446281,0.3243801652892562,0.621900826446281
6430,4570001,730,29,80,351,701,730,1.0,0.03972602739726028,0.9602739726027397,299,0.1095890410958904,0.4808219178082192,0.4095890410958904
6431,4570002,1240,310,260,267,930,1240,1.0,0.25,0.75,713,0.20967741935483872,0.2153225806451613,0.575
6432,4570003,1435,16,275,597,1419,1435,1.0,0.011149825783972125,0.9888501742160278,563,0.1916376306620209,0.41602787456445994,0.39233449477351917
6433,4570004,1284,38,106,611,1246,1284,1.0,0.029595015576323987,0.9704049844236761,567,0.08255451713395638,0.47585669781931467,0.441588785046729
6434,4570005,289,111,57,52,178,289,1.0,0.38408304498269896,0.615916955017301,180,0.1972318339100346,0.17993079584775087,0.6228373702422145
6435,4570006,439,0,44,248,439,439,1.0,0.0,1.0,147,0.10022779043280182,0.5649202733485194,0.3348519362186788
6436,4570007,747,0,35,323,747,747,1.0,0.0,1.0,389,0.04685408299866131,0.4323962516733601,0.5207496653279786
6437,4570008,212,0,19,106,212,212,1.0,0.0,1.0,87,0.08962264150943396,0.5,0.41037735849056606
6438,4570009,491,24,41,180,467,491,1.0,0.048879837067209775,0.9511201629327902,270,0.0835030549898167,0.3665987780040733,0.5498981670061099
6439,4570010,1411,99,128,607,1312,1411,1.0,0.07016300496102056,0.9298369950389794,676,0.09071580439404678,0.4301913536498937,0.47909284195605956
6440,4570011,149,0,11,56,149,149,1.0,0.0,1.0,82,0.0738255033557047,0.37583892617449666,0.5503355704697986
6441,4570013,906,41,81,250,865,906,1.0,0.04525386313465784,0.9547461368653422,575,0.08940397350993377,0.27593818984547464,0.6346578366445916
6442,4570014,1574,7,141,754,1567,1574,1.0,0.0044472681067344345,0.9955527318932655,679,0.08958068614993647,0.47903430749682335,0.4313850063532402
6443,4570015,929,0,82,406,929,929,1.0,0.0,1.0,441,0.08826695371367062,0.4370290635091496,0.4747039827771798
6444,4570016,666,111,51,271,555,666,1.0,0.16666666666666666,0.8333333333333334,344,0.07657657657657657,0.4069069069069069,0.5165165165165165
6445,4570017,2964,1141,91,198,1823,2964,1.0,0.3849527665317139,0.615047233468286,2675,0.03070175438596491,0.06680161943319839,0.9024966261808367
6446,4570018,1609,140,166,633,1469,1609,1.0,0.0870105655686762,0.9129894344313239,810,0.10316967060285892,0.39341205717837163,0.5034182722187694
6447,4590001,1363,147,231,776,1216,1363,1.0,0.1078503301540719,0.8921496698459281,356,0.169479090242113,0.5693323550990462,0.2611885546588408
6448,4590002,3455,122,141,1396,3333,3455,1.0,0.035311143270622285,0.9646888567293778,1918,0.04081041968162084,0.4040520984081042,0.555137481910275
6449,4590003,1954,37,154,740,1917,1954,1.0,0.018935516888433982,0.981064483111566,1060,0.07881269191402251,0.37871033776867963,0.5424769703172978
6450,4590004,863,4,141,438,859,863,1.0,0.004634994206257242,0.9953650057937428,284,0.1633835457705678,0.507531865585168,0.3290845886442642
6451,4590005,819,69,119,371,750,819,1.0,0.08424908424908426,0.9157509157509157,329,0.1452991452991453,0.452991452991453,0.4017094017094017
6452,4590006,1594,28,113,613,1566,1594,1.0,0.01756587202007528,0.9824341279799247,868,0.07089084065244668,0.3845671267252196,0.5445420326223338
6453,4590007,2553,139,307,1128,2414,2553,1.0,0.05444575009792401,0.945554249902076,1118,0.12025068546807677,0.4418331374853114,0.43791617704661184
6454,4590008,1292,144,153,392,1148,1292,1.0,0.11145510835913312,0.8885448916408669,747,0.11842105263157894,0.30340557275541796,0.5781733746130031
6455,4590009,2368,372,253,872,1996,2368,1.0,0.1570945945945946,0.8429054054054054,1243,0.10684121621621621,0.36824324324324326,0.5249155405405406
6456,4590010,2688,106,160,1131,2582,2688,1.0,0.03943452380952381,0.9605654761904762,1397,0.05952380952380952,0.42075892857142855,0.5197172619047619
6457,4590011,674,26,85,278,648,674,1.0,0.03857566765578635,0.9614243323442137,311,0.1261127596439169,0.4124629080118694,0.46142433234421365
6458,4590012,926,12,75,514,914,926,1.0,0.012958963282937365,0.9870410367170627,337,0.08099352051835854,0.5550755939524838,0.36393088552915764
6459,4590013,1050,244,164,362,806,1050,1.0,0.23238095238095238,0.7676190476190476,524,0.15619047619047619,0.34476190476190477,0.4990476190476191
6460,4590014,585,54,76,235,531,585,1.0,0.09230769230769231,0.9076923076923077,274,0.12991452991452992,0.4017094017094017,0.4683760683760684
6461,4590015,2008,44,119,898,1964,2008,1.0,0.021912350597609563,0.9780876494023905,991,0.05926294820717132,0.44721115537848605,0.49352589641434264
6462,4590016,1988,323,201,706,1665,1988,1.0,0.16247484909456741,0.8375251509054326,1081,0.1011066398390342,0.3551307847082495,0.5437625754527163
6463,4590017,2947,637,358,865,2310,2947,1.0,0.2161520190023753,0.7838479809976246,1724,0.12147947064811673,0.29351883271123175,0.5850016966406515
6464,4590018,705,135,106,251,570,705,1.0,0.19148936170212766,0.8085106382978723,348,0.150354609929078,0.35602836879432626,0.49361702127659574
6465,4590020,61,23,11,43,38,61,1.0,0.3770491803278688,0.6229508196721312,7,0.18032786885245902,0.7049180327868853,0.11475409836065574
6466,4590021,2,1,0,0,1,2,1.0,0.5,0.5,2,0.0,0.0,1.0
6467,4610001,436,21,77,262,415,436,1.0,0.0481651376146789,0.9518348623853211,97,0.17660550458715596,0.6009174311926605,0.22247706422018348
6468,4610002,229,11,28,90,218,229,1.0,0.048034934497816595,0.9519650655021834,111,0.1222707423580786,0.3930131004366812,0.4847161572052402
6469,4610003,581,34,100,168,547,581,1.0,0.058519793459552494,0.9414802065404475,313,0.1721170395869191,0.2891566265060241,0.5387263339070568
6470,4610004,557,40,70,264,517,557,1.0,0.0718132854578097,0.9281867145421903,223,0.12567324955116696,0.473967684021544,0.400359066427289
6471,4610005,137,6,12,54,131,137,1.0,0.043795620437956206,0.9562043795620438,71,0.08759124087591241,0.39416058394160586,0.5182481751824818
6472,4610006,385,24,46,115,361,385,1.0,0.06233766233766234,0.9376623376623376,224,0.11948051948051948,0.2987012987012987,0.5818181818181818
6473,4630001,1944,10,442,450,1934,1944,1.0,0.0051440329218107,0.9948559670781894,1052,0.2273662551440329,0.23148148148148148,0.5411522633744856
6474,4630002,1377,0,329,486,1377,1377,1.0,0.0,1.0,562,0.23892519970951343,0.35294117647058826,0.4081336238198983
6475,4630003,468,0,32,356,468,468,1.0,0.0,1.0,80,0.06837606837606838,0.7606837606837606,0.17094017094017094
6476,4630004,359,0,44,250,359,359,1.0,0.0,1.0,65,0.12256267409470752,0.6963788300835655,0.181058495821727
6477,4630005,1966,16,229,704,1950,1966,1.0,0.008138351983723296,0.9918616480162767,1033,0.11648016276703968,0.358087487283825,0.5254323499491353
6478,4630006,457,0,28,160,457,457,1.0,0.0,1.0,269,0.061269146608315096,0.350109409190372,0.5886214442013129
6479,4630007,1013,0,71,280,1013,1013,1.0,0.0,1.0,662,0.0700888450148075,0.2764067127344521,0.6535044422507403
6480,4630008,1523,0,460,357,1523,1523,1.0,0.0,1.0,706,0.3020354563361786,0.23440577806959947,0.46355876559422193
6481,4630009,1801,8,531,110,1793,1801,1.0,0.004441976679622432,0.9955580233203776,1160,0.29483620210993894,0.06107717934480844,0.6440866185452526
6482,4630010,788,4,207,41,784,788,1.0,0.005076142131979695,0.9949238578680203,540,0.2626903553299492,0.05203045685279188,0.6852791878172588
6483,4630011,458,0,96,212,458,458,1.0,0.0,1.0,150,0.2096069868995633,0.462882096069869,0.32751091703056767
6484,4630012,2290,19,462,700,2271,2290,1.0,0.008296943231441048,0.991703056768559,1128,0.2017467248908297,0.3056768558951965,0.4925764192139738
6485,4630013,3087,28,878,342,3059,3087,1.0,0.009070294784580499,0.9909297052154195,1867,0.2844185293164885,0.11078717201166181,0.6047942986718496
6486,4630014,179,0,16,81,179,179,1.0,0.0,1.0,82,0.0893854748603352,0.45251396648044695,0.4581005586592179
6487,4650010A,18,0,10,6,18,18,1.0,0.0,1.0,2,0.5555555555555556,0.3333333333333333,0.1111111111111111
6488,4650010B,2058,20,554,336,2038,2058,1.0,0.009718172983479106,0.9902818270165209,1168,0.2691933916423712,0.16326530612244897,0.5675413022351797
6489,4650011,2400,0,657,177,2400,2400,1.0,0.0,1.0,1566,0.27375,0.07375,0.6525
6490,4650012,540,6,82,50,534,540,1.0,0.011111111111111112,0.9888888888888889,408,0.15185185185185185,0.09259259259259259,0.7555555555555555
6491,4650013,1975,155,145,579,1820,1975,1.0,0.07848101265822785,0.9215189873417722,1251,0.07341772151898734,0.2931645569620253,0.6334177215189873
6492,4650020,127,0,16,111,127,127,1.1545454545454545,0.0,1.0,0,0.12598425196850394,0.8740157480314961,0.0
6493,4650021,2061,0,559,167,2061,2061,1.0,0.0,1.0,1335,0.2712275594371664,0.08102862688015526,0.6477438136826783
6494,4650022,3293,84,555,319,3209,3293,1.0,0.02550865472213787,0.9744913452778622,2419,0.16853932584269662,0.09687215305192834,0.7345885211053751
6495,4650023,225,0,52,112,225,225,1.0,0.0,1.0,61,0.2311111111111111,0.49777777777777776,0.27111111111111114
6496,4650024,1273,8,290,178,1265,1273,1.0,0.006284367635506678,0.9937156323644933,805,0.22780832678711704,0.13982717989002358,0.6323644933228594
6497,4650030,1476,61,339,295,1415,1476,1.0,0.041327913279132794,0.9586720867208672,842,0.22967479674796748,0.19986449864498645,0.5704607046070461
6498,4650031,4248,104,977,1545,4144,4248,1.0,0.02448210922787194,0.975517890772128,1726,0.22999058380414314,0.3637005649717514,0.4063088512241055
6499,4650032,217,0,50,159,217,217,1.0,0.0,1.0,8,0.2304147465437788,0.7327188940092166,0.03686635944700461
6500,4650033,1983,14,246,660,1969,1983,1.0,0.0070600100857286935,0.9929399899142713,1077,0.12405446293494705,0.3328290468986384,0.5431164901664145
6501,4650040,5165,12,1378,688,5153,5165,1.0,0.002323330106485963,0.997676669893514,3099,0.26679574056147143,0.13320425943852857,0.6
6502,4650041A,102,0,46,24,102,102,1.0,0.0,1.0,32,0.45098039215686275,0.23529411764705882,0.3137254901960784
6503,4650041B,1723,0,296,155,1723,1723,1.0,0.0,1.0,1272,0.1717933836331979,0.08995937318630295,0.7382472431804992
6504,4650042,43,0,3,23,43,43,1.0,0.0,1.0,17,0.06976744186046512,0.5348837209302325,0.3953488372093023
6505,4650043,62,0,12,28,62,62,1.0,0.0,1.0,22,0.1935483870967742,0.45161290322580644,0.3548387096774194
6506,467001A,1047,90,153,725,957,1047,1.0,0.08595988538681948,0.9140401146131805,169,0.14613180515759314,0.6924546322827125,0.16141356255969436
6507,467001B,1484,10,248,1235,1474,1484,1.069214131218457,0.006738544474393531,0.9932614555256065,1,0.16711590296495957,0.8322102425876011,0.0006738544474393531
6508,467001C,3902,15,94,696,3887,3902,1.0,0.0038441824705279346,0.996155817529472,3112,0.02409021014864172,0.17837006663249616,0.7975397232188621
6509,467001D,1826,5,125,583,1821,1826,1.0,0.002738225629791895,0.9972617743702081,1118,0.06845564074479737,0.3192771084337349,0.6122672508214677
6510,467001E,1759,85,139,399,1674,1759,1.0,0.04832291074474133,0.9516770892552586,1221,0.07902217168845935,0.22683342808413873,0.694144400227402
6511,467002A,1849,12,235,1613,1837,1849,1.0260966129927818,0.006489994591671174,0.9935100054083288,1,0.12709572742022715,0.8723634396971336,0.0005408328826392645
6512,467002B,4120,196,108,735,3924,4120,1.0,0.04757281553398058,0.9524271844660194,3277,0.02621359223300971,0.1783980582524272,0.795388349514563
6513,467002C,1823,25,167,1027,1798,1823,1.0,0.013713658804168952,0.986286341195831,629,0.0916072408118486,0.5633571036752606,0.34503565551289084
6514,467002D,2469,104,157,838,2365,2469,1.0,0.042122316727420006,0.9578776832725799,1474,0.06358849736735521,0.3394086674767112,0.5970028351559336
6515,467003A,3726,133,92,384,3593,3726,1.0,0.03569511540526033,0.9643048845947396,3250,0.024691358024691357,0.10305958132045089,0.8722490606548577
6516,467003B,2857,18,259,619,2839,2857,1.0,0.006300315015750788,0.9936996849842492,1979,0.09065453272663633,0.2166608330416521,0.6926846342317116
6517,467003C,1630,43,332,1297,1587,1630,1.688082901554404,0.02638036809815951,0.9736196319018405,1,0.20368098159509201,0.7957055214723926,0.0006134969325153375
6518,467003D,2172,198,201,1220,1974,2172,1.0,0.09116022099447514,0.9088397790055248,751,0.0925414364640884,0.5616942909760589,0.34576427255985265
6519,467004A,1393,18,85,729,1375,1393,1.0,0.012921751615218953,0.9870782483847811,579,0.061019382627422826,0.5233309404163675,0.41564967695620963
6520,467004B,1992,6,134,908,1986,1992,1.0,0.0030120481927710845,0.9969879518072289,950,0.06726907630522089,0.45582329317269077,0.47690763052208834
6521,467004C,2138,24,136,730,2114,2138,1.0,0.011225444340505144,0.9887745556594949,1272,0.06361085126286249,0.3414405986903648,0.5949485500467727
6522,467004D,3886,129,337,1506,3757,3886,1.0,0.03319608852290273,0.9668039114770973,2043,0.0867215645908389,0.38754503345342256,0.5257334019557386
6523,467004E,1165,32,82,550,1133,1165,1.0,0.027467811158798282,0.9725321888412017,533,0.0703862660944206,0.4721030042918455,0.4575107296137339
6524,4690001,958,128,147,106,830,958,1.0,0.1336116910229645,0.8663883089770354,705,0.1534446764091858,0.11064718162839249,0.7359081419624217
6525,4690002,1415,140,195,313,1275,1415,1.0,0.0989399293286219,0.901060070671378,907,0.13780918727915195,0.22120141342756183,0.6409893992932862
6526,4690003,1406,20,217,425,1386,1406,1.0,0.01422475106685633,0.9857752489331437,764,0.15433854907539118,0.302275960170697,0.5433854907539118
6527,4690004,1941,192,356,200,1749,1941,1.0,0.09891808346213292,0.9010819165378671,1385,0.18341061308603812,0.10303967027305512,0.7135497166409067
6528,4690005,4243,597,518,534,3646,4243,1.0,0.14070233325477258,0.8592976667452275,3191,0.12208343153429177,0.12585434833843978,0.7520622201272684
6529,4690006,518,0,95,55,518,518,1.0,0.0,1.0,368,0.1833976833976834,0.10617760617760617,0.7104247104247104
6530,4690007,2728,311,584,278,2417,2728,1.0,0.11400293255131964,0.8859970674486803,1866,0.21407624633431085,0.10190615835777127,0.6840175953079178
6531,4690008,3265,163,420,471,3102,3265,1.0,0.049923430321592646,0.9500765696784074,2374,0.12863705972434916,0.1442572741194487,0.7271056661562021
6532,4690009,1986,67,233,365,1919,1986,1.0,0.033736153071500505,0.9662638469284995,1388,0.11732124874118832,0.1837865055387714,0.6988922457200403
6533,4690010,2138,139,318,699,1999,2138,1.0,0.06501403180542563,0.9349859681945744,1121,0.14873713751169318,0.3269410664172123,0.5243217960710945
6534,4690011,467,0,53,186,467,467,1.0,0.0,1.0,228,0.11349036402569593,0.39828693790149894,0.48822269807280516
6535,4690012,761,57,233,161,704,761,1.0,0.07490144546649145,0.9250985545335085,367,0.3061760840998686,0.21156373193166886,0.48226018396846254
6536,4690013,1550,202,430,291,1348,1550,1.0,0.13032258064516128,0.8696774193548387,829,0.27741935483870966,0.18774193548387097,0.5348387096774193
6537,4690014,1157,34,188,546,1123,1157,1.0,0.029386343993085567,0.9706136560069144,423,0.16248919619706137,0.47191011235955055,0.3656006914433881
6538,4690015,114,4,16,60,110,114,1.0,0.03508771929824561,0.9649122807017544,38,0.14035087719298245,0.5263157894736842,0.3333333333333333
6539,4690016,381,9,55,195,372,381,1.0,0.023622047244094488,0.9763779527559056,131,0.14435695538057744,0.5118110236220472,0.3438320209973753
6540,4690017,1036,42,91,178,994,1036,1.0,0.04054054054054054,0.9594594594594594,767,0.08783783783783784,0.1718146718146718,0.7403474903474904
6541,4690018,4202,55,403,1585,4147,4202,1.0,0.013089005235602094,0.9869109947643979,2214,0.09590671108995716,0.3772013326987149,0.5268919562113279
6542,4690019,3594,369,525,927,3225,3594,1.0,0.10267111853088481,0.8973288814691152,2142,0.14607679465776294,0.2579298831385643,0.5959933222036727
6543,4690020,1269,0,142,636,1269,1269,1.0,0.0,1.0,491,0.11189913317572892,0.5011820330969267,0.38691883372734437
6544,4690021,3936,124,445,1716,3812,3936,1.0,0.031504065040650404,0.9684959349593496,1775,0.11305894308943089,0.43597560975609756,0.45096544715447157
6545,4690022,1610,15,128,924,1595,1610,1.0,0.009316770186335404,0.9906832298136646,558,0.07950310559006211,0.5739130434782609,0.34658385093167704
6546,4690023,1813,103,169,771,1710,1813,1.0,0.0568119139547711,0.9431880860452289,873,0.09321566464423607,0.42526199669056813,0.4815223386651958
6547,4690024,1494,100,109,732,1394,1494,1.0,0.06693440428380187,0.9330655957161981,653,0.07295850066934405,0.4899598393574297,0.43708165997322623
6548,4690025,4072,227,541,1401,3845,4072,1.0,0.05574656188605108,0.9442534381139489,2130,0.13285854616895873,0.34405697445972494,0.5230844793713163
6549,4690026,1332,35,152,460,1297,1332,1.0,0.026276276276276277,0.9737237237237237,720,0.11411411411411411,0.34534534534534533,0.5405405405405406
6550,4690027,1656,0,85,764,1656,1656,1.0,0.0,1.0,807,0.051328502415458936,0.4613526570048309,0.48731884057971014
6551,4690028,512,11,44,268,501,512,1.0,0.021484375,0.978515625,200,0.0859375,0.5234375,0.390625
6552,4690029,2426,50,383,1412,2376,2426,1.0,0.020610057708161583,0.9793899422918384,631,0.15787304204451771,0.5820280296784831,0.26009892827699915
6553,4690030,960,75,111,208,885,960,1.0,0.078125,0.921875,641,0.115625,0.21666666666666667,0.6677083333333333
6554,4690031,1053,69,182,230,984,1053,1.0,0.06552706552706553,0.9344729344729344,641,0.1728395061728395,0.2184235517568851,0.6087369420702754
6555,4690032,1597,228,297,185,1369,1597,1.0,0.1427676894176581,0.8572323105823418,1115,0.1859737006887915,0.1158422041327489,0.6981840951784596
6556,4690033,4740,162,474,2253,4578,4740,1.0,0.03417721518987342,0.9658227848101266,2013,0.1,0.4753164556962025,0.42468354430379746
6557,4690034,1551,263,336,113,1288,1551,1.0,0.16956802063185042,0.8304319793681496,1102,0.21663442940038685,0.07285622179239201,0.7105093488072212
6558,4690035,711,68,127,44,643,711,1.0,0.09563994374120956,0.9043600562587905,540,0.17862165963431786,0.06188466947960619,0.759493670886076
6559,4710101,1985,698,263,131,1287,1985,1.0,0.3516372795969773,0.6483627204030227,1591,0.13249370277078085,0.06599496221662468,0.8015113350125944
6560,4710102,10019,2227,722,1036,7792,10019,1.0,0.22227767242239743,0.7777223275776025,8261,0.07206308014771934,0.10340353328675517,0.8245333865655256
6561,4710103,2074,522,282,751,1552,2074,1.0,0.25168756027000966,0.7483124397299904,1041,0.1359691417550627,0.3621022179363549,0.5019286403085824
6562,4710104,2075,381,228,908,1694,2075,1.0,0.1836144578313253,0.8163855421686746,939,0.10987951807228916,0.4375903614457831,0.4525301204819277
6563,4710201,5502,1639,578,842,3863,5502,1.0,0.29789167575427117,0.7021083242457288,4082,0.10505270810614321,0.1530352599054889,0.7419120319883679
6564,4710203,803,187,87,275,616,803,1.0,0.2328767123287671,0.7671232876712328,441,0.10834371108343711,0.3424657534246575,0.5491905354919053
6565,4710204,2352,344,517,990,2008,2352,1.0,0.14625850340136054,0.8537414965986394,845,0.21981292517006804,0.42091836734693877,0.3592687074829932
6566,4710205,2290,76,377,1498,2214,2290,1.0,0.03318777292576419,0.9668122270742358,415,0.1646288209606987,0.6541484716157205,0.1812227074235808
6567,4710206,1196,337,227,313,859,1196,1.0,0.2817725752508361,0.7182274247491639,656,0.18979933110367894,0.2617056856187291,0.5484949832775919
6568,4710301,6103,1699,919,561,4404,6103,1.0,0.2783876781910536,0.7216123218089464,4623,0.15058168114042275,0.09192200557103064,0.7574963132885466
6569,4710302,466,107,69,159,359,466,1.0,0.2296137339055794,0.7703862660944206,238,0.148068669527897,0.34120171673819744,0.5107296137339056
6570,4710303,959,301,107,285,658,959,1.0,0.31386861313868614,0.6861313868613139,567,0.11157455683003129,0.29718456725756,0.5912408759124088
6571,4710304,9558,2404,453,1580,7154,9558,1.0,0.2515170537769408,0.7484829462230592,7525,0.047394852479598244,0.16530654948734044,0.7872985980330613
6572,4710401,6187,1451,671,607,4736,6187,1.0,0.23452400193955067,0.7654759980604493,4909,0.10845320834006789,0.09810893809600776,0.7934378535639244
6573,4710403,1673,248,235,672,1425,1673,1.0,0.14823670053795576,0.8517632994620442,766,0.14046622833233713,0.401673640167364,0.45786013150029886
6574,4710404,3606,629,517,1532,2977,3606,1.0,0.17443150305047145,0.8255684969495286,1557,0.14337215751525237,0.4248474764281753,0.4317803660565724
6575,4730101,2092,643,379,711,1449,2092,1.0,0.30736137667304014,0.6926386233269598,1002,0.18116634799235182,0.3398661567877629,0.4789674952198853
6576,4730102,1906,842,531,369,1064,1906,1.0,0.44176285414480587,0.5582371458551941,1006,0.27859391395592864,0.19359916054564533,0.527806925498426
6577,4730103,2008,1087,350,373,921,2008,1.0,0.5413346613545816,0.4586653386454183,1285,0.17430278884462153,0.1857569721115538,0.6399402390438247
6578,4730104,828,424,167,267,404,828,1.0,0.5120772946859904,0.48792270531400966,394,0.20169082125603865,0.322463768115942,0.4758454106280193
6579,4730105,654,98,74,389,556,654,1.0,0.14984709480122324,0.8501529051987767,191,0.11314984709480122,0.5948012232415902,0.29204892966360857
6580,4730206,2661,91,221,1182,2570,2661,1.0,0.034197670048853816,0.9658023299511462,1258,0.08305148440435926,0.44419391206313413,0.4727546035325066
6581,4730207,3757,7,199,1521,3750,3757,1.0,0.0018631887143997872,0.9981368112856002,2037,0.052967793452222516,0.40484429065743943,0.542187915890338
6582,4730208,1794,374,258,552,1420,1794,1.0,0.2084726867335563,0.7915273132664437,984,0.14381270903010032,0.3076923076923077,0.5484949832775919
6583,4730309,4162,3736,2017,17,426,4162,1.0,0.8976453628063431,0.1023546371936569,2128,0.4846227775108121,0.004084574723690533,0.5112926477654973
6584,4730310,1576,902,751,144,674,1576,1.0,0.5723350253807107,0.4276649746192893,681,0.47652284263959394,0.09137055837563451,0.43210659898477155
6585,4730311,651,206,139,281,445,651,1.0,0.31643625192012287,0.6835637480798771,231,0.21351766513056836,0.43164362519201227,0.3548387096774194
6586,4730312,1680,124,131,838,1556,1680,1.0,0.07380952380952381,0.9261904761904762,711,0.07797619047619048,0.4988095238095238,0.4232142857142857
6587,4730313,759,75,84,204,684,759,1.0,0.09881422924901186,0.9011857707509882,471,0.11067193675889328,0.26877470355731226,0.6205533596837944
6588,4730414,396,40,133,76,356,396,1.0,0.10101010101010101,0.898989898989899,187,0.33585858585858586,0.1919191919191919,0.4722222222222222
6589,4730415,1257,108,156,580,1149,1257,1.0,0.08591885441527446,0.9140811455847255,521,0.12410501193317422,0.4614160700079554,0.4144789180588703
6590,4730416,1926,780,325,310,1146,1926,1.0,0.40498442367601245,0.5950155763239875,1291,0.1687435098650052,0.16095534787123572,0.670301142263759
6591,4730417,1278,564,445,179,714,1278,1.0,0.4413145539906103,0.5586854460093896,654,0.34820031298904536,0.14006259780907668,0.5117370892018779
6592,4730418,1795,163,84,695,1632,1795,1.0,0.09080779944289694,0.909192200557103,1016,0.0467966573816156,0.3871866295264624,0.566016713091922
6593,4730419,39,3,2,36,36,39,2.7142857142857144,0.07692307692307693,0.9230769230769231,1,0.05128205128205128,0.9230769230769231,0.02564102564102564
6594,4730420A,1858,162,68,520,1696,1858,1.0,0.08719052744886975,0.9128094725511302,1270,0.03659849300322928,0.2798708288482239,0.6835306781485468
6596,4750002,2066,145,193,915,1921,2066,1.0,0.0701839303000968,0.9298160696999032,958,0.09341723136495644,0.44288480154888676,0.46369796708615685
6597,475001E,1623,140,260,264,1483,1623,1.0,0.0862600123228589,0.9137399876771412,1099,0.16019716574245224,0.16266173752310537,0.6771410967344423
6598,475001W,417,0,77,55,417,417,1.0,0.0,1.0,285,0.18465227817745802,0.13189448441247004,0.6834532374100719
6599,475003N,1492,52,121,532,1440,1492,1.0,0.03485254691689008,0.9651474530831099,839,0.08109919571045576,0.35656836461126007,0.5623324396782842
6600,475003S,342,0,19,134,342,342,1.0,0.0,1.0,189,0.05555555555555555,0.391812865497076,0.5526315789473685
6601,475004E,1465,106,126,326,1359,1465,1.0,0.07235494880546076,0.9276450511945392,1013,0.08600682593856655,0.22252559726962456,0.6914675767918089
6602,475004M,343,19,32,104,324,343,1.0,0.05539358600583091,0.9446064139941691,207,0.09329446064139942,0.3032069970845481,0.6034985422740525
6603,475004W,128,0,13,36,128,128,1.0,0.0,1.0,79,0.1015625,0.28125,0.6171875
6604,4770101,1194,322,343,458,872,1194,1.0,0.2696817420435511,0.7303182579564489,393,0.28726968174204354,0.38358458961474035,0.32914572864321606
6605,4770104,2341,868,762,228,1473,2341,1.0,0.37078171721486547,0.6292182827851346,1351,0.3255019222554464,0.09739427595044853,0.577103801794105
6606,4770109,1112,85,120,570,1027,1112,1.0,0.0764388489208633,0.9235611510791367,422,0.1079136690647482,0.512589928057554,0.37949640287769787
6607,4770115,965,194,143,415,771,965,1.0,0.20103626943005182,0.7989637305699482,407,0.14818652849740932,0.43005181347150256,0.42176165803108806
6608,4770117,141,43,70,8,98,141,1.0,0.3049645390070922,0.6950354609929078,63,0.49645390070921985,0.05673758865248227,0.44680851063829785
6609,4770121,124,53,19,33,71,124,1.0,0.4274193548387097,0.5725806451612904,72,0.1532258064516129,0.2661290322580645,0.5806451612903226
6610,4770202,455,18,40,80,437,455,1.0,0.03956043956043956,0.9604395604395605,335,0.08791208791208792,0.17582417582417584,0.7362637362637363
6611,4770203,1757,516,240,984,1241,1757,1.0,0.29368241320432553,0.7063175867956745,533,0.13659647125782584,0.560045532157086,0.3033579965850882
6612,4770205,2130,133,271,1164,1997,2130,1.0,0.06244131455399061,0.9375586854460094,695,0.1272300469483568,0.5464788732394367,0.32629107981220656
6613,4770208,1537,124,120,875,1413,1537,1.0,0.08067664281067013,0.9193233571893299,542,0.07807417046193885,0.5692908262849707,0.35263500325309044
6614,4770307,1740,323,214,726,1417,1740,1.0,0.18563218390804598,0.8143678160919541,800,0.12298850574712644,0.41724137931034483,0.45977011494252873
6615,4770311,1229,195,128,630,1034,1229,1.0,0.15866558177379983,0.8413344182262001,471,0.10414971521562245,0.5126118795768918,0.38323840520748575
6616,4770312,1207,105,116,635,1102,1207,1.0,0.08699254349627175,0.9130074565037283,456,0.09610604805302403,0.5260977630488816,0.37779618889809446
6617,4770316,508,105,26,109,403,508,1.0,0.20669291338582677,0.7933070866141733,373,0.051181102362204724,0.21456692913385828,0.734251968503937
6618,4770320,1579,16,138,1106,1563,1579,1.0,0.01013299556681444,0.9898670044331855,335,0.08739708676377454,0.7004433185560481,0.21215959468017734
6619,4770406,3378,755,183,760,2623,3378,1.0,0.22350503256364712,0.7764949674363528,2435,0.0541740674955595,0.22498519834221434,0.7208407341622262
6620,4770410,1274,336,150,571,938,1274,1.0,0.26373626373626374,0.7362637362637363,553,0.11773940345368916,0.44819466248037676,0.4340659340659341
6621,4770413,1058,0,46,462,1058,1058,1.0,0.0,1.0,550,0.043478260869565216,0.43667296786389415,0.5198487712665406
6622,4770414,566,0,53,510,566,566,1.0,0.0,1.0,3,0.09363957597173145,0.901060070671378,0.00530035335689046
6623,4770418,587,115,98,238,472,587,1.0,0.19591141396933562,0.8040885860306644,251,0.16695059625212946,0.40545144804088584,0.42759795570698467
6624,4770419,526,67,101,295,459,526,1.0,0.12737642585551331,0.8726235741444867,130,0.1920152091254753,0.5608365019011406,0.24714828897338403
6625,4790122,579,0,161,36,579,579,1.0,0.0,1.0,382,0.27806563039723664,0.06217616580310881,0.6597582037996546
6626,4790124,2259,2,763,109,2257,2259,1.0,0.0008853474988933156,0.9991146525011066,1387,0.3377600708277999,0.048251438689685705,0.6139884904825144
6627,4790125,1040,20,376,40,1020,1040,1.0,0.019230769230769232,0.9807692307692307,624,0.36153846153846153,0.038461538461538464,0.6
6628,4790128,601,0,232,49,601,601,1.0,0.0,1.0,320,0.3860232945091514,0.08153078202995008,0.5324459234608985
6629,4790129,2519,0,932,104,2519,2519,1.0,0.0,1.0,1483,0.36998809051210796,0.04128622469233823,0.5887256847955538
6630,4790130,4167,4,1437,150,4163,4167,1.0,0.0009599232061435085,0.9990400767938565,2580,0.34485241180705545,0.03599712023038157,0.619150467962563
6631,4790132,4604,0,1147,166,4604,4604,1.0,0.0,1.0,3291,0.249131190269331,0.036055603822762815,0.7148132059079062
6632,4790133,2919,0,1080,140,2919,2919,1.0,0.0,1.0,1699,0.3699897225077081,0.047961630695443645,0.5820486467968482
6633,4790134,1824,0,836,75,1824,1824,1.0,0.0,1.0,913,0.4583333333333333,0.04111842105263158,0.5005482456140351
6634,4790135,1139,0,613,57,1139,1139,1.0,0.0,1.0,469,0.5381913959613697,0.05004389815627744,0.4117647058823529
6635,4790136,225,0,167,58,225,225,1.2784090909090908,0.0,1.0,0,0.7422222222222222,0.2577777777777778,0.0
6636,4790154,3829,30,264,31,3799,3829,1.0,0.007834943849569079,0.9921650561504309,3534,0.06894750587620789,0.008096108644554715,0.9229563854792374
6637,4790164,1229,0,380,99,1229,1229,1.0,0.0,1.0,750,0.30919446704637915,0.080553295362083,0.6102522375915378
6638,4790169,1470,0,313,37,1470,1470,1.0,0.0,1.0,1120,0.21292517006802722,0.025170068027210883,0.7619047619047619
6639,4790215,1602,0,559,125,1602,1602,1.0,0.0,1.0,918,0.3489388264669164,0.0780274656679151,0.5730337078651685
6640,4790218,2502,1,745,228,2501,2502,1.0,0.0003996802557953637,0.9996003197442046,1529,0.297761790567546,0.09112709832134293,0.6111111111111112
6641,4790219,1765,8,475,198,1757,1765,1.0,0.004532577903682719,0.9954674220963173,1092,0.26912181303116145,0.11218130311614731,0.6186968838526912
6642,4790220,1422,0,395,64,1422,1422,1.0,0.0,1.0,963,0.2777777777777778,0.0450070323488045,0.6772151898734177
6643,4790221,1067,0,366,190,1067,1067,1.0,0.0,1.0,511,0.3430178069353327,0.1780693533270853,0.47891283973758203
6644,4790226,1321,0,304,63,1321,1321,1.0,0.0,1.0,954,0.23012869038607117,0.04769114307342922,0.7221801665404997
6645,4790227,4860,0,903,214,4860,4860,1.0,0.0,1.0,3743,0.18580246913580248,0.044032921810699586,0.7701646090534979
6646,4790231,3803,0,1177,291,3803,3803,1.0,0.0,1.0,2335,0.3094925059163818,0.07651853799631869,0.6139889560872995
6647,4790237,468,0,319,105,468,468,1.0,0.0,1.0,44,0.6816239316239316,0.22435897435897437,0.09401709401709402
6648,4790239,6183,52,1240,531,6131,6183,1.0,0.008410156881772603,0.9915898431182274,4412,0.20054989487303898,0.0858806404657933,0.7135694646611677
6649,4790255,1952,16,488,251,1936,1952,1.0,0.00819672131147541,0.9918032786885246,1213,0.25,0.1285860655737705,0.6214139344262295
6650,4790266,2280,11,554,108,2269,2280,1.0,0.004824561403508772,0.9951754385964913,1618,0.24298245614035088,0.04736842105263158,0.7096491228070175
6651,4790267,2402,49,524,131,2353,2402,1.0,0.020399666944213156,0.9796003330557869,1747,0.21815154038301415,0.05453788509575354,0.7273105745212323
6652,4790268,51,0,9,2,51,51,1.0,0.0,1.0,40,0.17647058823529413,0.0392156862745098,0.7843137254901961
6653,4790308,859,0,240,85,859,859,1.0,0.0,1.0,534,0.27939464493597205,0.0989522700814901,0.6216530849825378
6654,4790309,3008,33,1107,360,2975,3008,1.0,0.010970744680851064,0.989029255319149,1541,0.3680186170212766,0.1196808510638298,0.5123005319148937
6655,4790310,366,0,117,26,366,366,1.0,0.0,1.0,223,0.319672131147541,0.07103825136612021,0.6092896174863388
6656,4790311,1672,4,577,128,1668,1672,1.0,0.0023923444976076554,0.9976076555023924,967,0.3450956937799043,0.07655502392344497,0.5783492822966507
6657,4790312,1410,4,490,89,1406,1410,1.0,0.0028368794326241137,0.9971631205673759,831,0.3475177304964539,0.06312056737588652,0.5893617021276596
6658,4790338,577,0,60,11,577,577,1.0,0.0,1.0,506,0.10398613518197573,0.019064124783362217,0.8769497400346621
6659,4790340,1802,0,785,673,1802,1802,1.0,0.0,1.0,344,0.43562708102108766,0.3734739178690344,0.19089900110987792
6660,4790341,1557,3,316,362,1554,1557,1.0,0.0019267822736030828,0.9980732177263969,879,0.2029543994861914,0.23249839434810532,0.5645472061657033
6661,4790342,2201,3,656,250,2198,2201,1.0,0.0013630168105406633,0.9986369831894594,1295,0.2980463425715584,0.11358473421172194,0.5883689232167196
6662,4790343,2622,0,881,443,2622,2622,1.0,0.0,1.0,1298,0.3360030511060259,0.16895499618611748,0.4950419527078566
6663,4790344,4863,6,1263,1056,4857,4863,1.0,0.0012338062924120913,0.9987661937075879,2544,0.25971622455274523,0.21714990746452806,0.5231338679827268
6664,4790345,2616,21,718,365,2595,2616,1.0,0.008027522935779817,0.9919724770642202,1533,0.27446483180428133,0.13952599388379205,0.5860091743119266
6665,4790349,1177,9,258,206,1168,1177,1.0,0.0076465590484282074,0.9923534409515717,713,0.21920135938827529,0.1750212404418012,0.6057774001699235
6666,4790350,61,0,11,17,61,61,1.0,0.0,1.0,33,0.18032786885245902,0.2786885245901639,0.5409836065573771
6667,4790351,721,0,189,38,721,721,1.0,0.0,1.0,494,0.2621359223300971,0.052704576976421634,0.6851595006934813
6668,4790356,5805,16,1187,525,5789,5805,1.0,0.002756244616709733,0.9972437553832902,4093,0.2044788975021533,0.09043927648578812,0.7050818260120586
6669,4790359,3735,25,1126,454,3710,3735,1.0,0.006693440428380187,0.9933065595716198,2155,0.3014725568942436,0.1215528781793842,0.5769745649263721
6670,4790360,518,0,245,55,518,518,1.0,0.0,1.0,218,0.47297297297297297,0.10617760617760617,0.42084942084942084
6671,4790361,1894,0,596,210,1894,1894,1.0,0.0,1.0,1088,0.3146779303062302,0.11087645195353749,0.5744456177402323
6672,4790362,461,0,169,33,461,461,1.0,0.0,1.0,259,0.3665943600867679,0.07158351409978309,0.561822125813449
6673,4790363,869,0,348,74,869,869,1.0,0.0,1.0,447,0.4004602991944764,0.08515535097813579,0.5143843498273878
6674,4790401,1790,4,538,74,1786,1790,1.0,0.0022346368715083797,0.9977653631284916,1178,0.3005586592178771,0.041340782122905026,0.6581005586592179
6675,4790402,1890,1,514,79,1889,1890,1.0,0.0005291005291005291,0.9994708994708995,1297,0.27195767195767195,0.0417989417989418,0.6862433862433862
6676,4790403,1574,2,438,56,1572,1574,1.0,0.0012706480304955528,0.9987293519695044,1080,0.2782719186785261,0.035578144853875476,0.6861499364675985
6677,4790404,1718,0,532,93,1718,1718,1.0,0.0,1.0,1093,0.309662398137369,0.05413271245634459,0.6362048894062864
6678,4790405,2231,0,694,92,2231,2231,1.0,0.0,1.0,1445,0.3110712684894666,0.041237113402061855,0.6476916181084715
6679,4790406,919,0,331,42,919,919,1.0,0.0,1.0,546,0.3601741022850925,0.04570184983677911,0.5941240478781284
6680,4790407,716,10,140,36,706,716,1.0,0.013966480446927373,0.9860335195530726,540,0.19553072625698323,0.05027932960893855,0.7541899441340782
6681,4790413,2688,0,748,123,2688,2688,1.0,0.0,1.0,1817,0.27827380952380953,0.04575892857142857,0.6759672619047619
6682,4790414,1296,8,384,62,1288,1296,1.0,0.006172839506172839,0.9938271604938271,850,0.2962962962962963,0.047839506172839504,0.6558641975308642
6683,4790416,1205,4,355,48,1201,1205,1.0,0.0033195020746887966,0.9966804979253112,802,0.2946058091286307,0.03983402489626556,0.6655601659751037
6684,4790417,625,0,242,87,625,625,1.0,0.0,1.0,296,0.3872,0.1392,0.4736
6685,4790423,1333,0,391,51,1333,1333,1.0,0.0,1.0,891,0.2933233308327082,0.03825956489122281,0.668417104276069
6686,4790446,4137,0,1213,288,4137,4137,1.0,0.0,1.0,2636,0.29320763838530334,0.06961566352429296,0.6371766980904037
6687,4790447,3076,14,609,326,3062,3076,1.0,0.004551365409622887,0.9954486345903771,2141,0.19798439531859557,0.10598179453836151,0.6960338101430429
6688,4790448,716,0,116,27,716,716,1.0,0.0,1.0,573,0.16201117318435754,0.03770949720670391,0.8002793296089385
6689,4790453,638,11,155,27,627,638,1.0,0.017241379310344827,0.9827586206896551,456,0.24294670846394983,0.04231974921630094,0.7147335423197492
6690,4790457,135,0,17,20,135,135,1.0,0.0,1.0,98,0.1259259259259259,0.14814814814814814,0.725925925925926
6691,4790458,3519,0,844,238,3519,3519,1.0,0.0,1.0,2437,0.2398408638817846,0.06763285024154589,0.6925262858766695
6692,4790465,790,0,324,43,790,790,1.0,0.0,1.0,423,0.41012658227848103,0.05443037974683544,0.5354430379746835
6693,4810101A,1058,196,205,390,862,1058,1.0,0.18525519848771266,0.8147448015122873,463,0.1937618147448015,0.3686200378071834,0.43761814744801514
6694,4810101B,1743,630,260,499,1113,1743,1.0,0.3614457831325301,0.6385542168674698,984,0.1491681009753299,0.2862880091795754,0.5645438898450946
6695,4810102,2472,323,303,1182,2149,2472,1.0,0.13066343042071196,0.8693365695792881,987,0.12257281553398058,0.47815533980582525,0.39927184466019416
6696,4810103,2488,101,253,787,2387,2488,1.0,0.040594855305466235,0.9594051446945338,1448,0.10168810289389067,0.3163183279742765,0.5819935691318328
6697,4810201,2393,110,253,1309,2283,2393,1.0,0.045967404931048894,0.9540325950689511,831,0.10572503134141245,0.5470121186794819,0.3472628499791057
6698,4810202,824,447,417,159,377,824,1.0,0.5424757281553398,0.4575242718446602,248,0.5060679611650486,0.1929611650485437,0.30097087378640774
6699,4810203,3414,1315,1042,620,2099,3414,1.0,0.38517867603983597,0.614821323960164,1752,0.30521382542472175,0.18160515524311657,0.5131810193321616
6700,4810301,2493,18,189,1312,2475,2493,1.0,0.007220216606498195,0.9927797833935018,992,0.07581227436823104,0.5262735659847573,0.39791415964701166
6701,4810302,2468,132,239,1039,2336,2468,1.0,0.05348460291734198,0.946515397082658,1190,0.09683954619124797,0.42098865478119935,0.4821717990275527
6702,4810303,2253,62,152,1095,2191,2253,1.0,0.027518863737239236,0.9724811362627608,1006,0.06746560142032845,0.48601864181091875,0.44651575676875277
6703,4810401,3086,471,560,660,2615,3086,1.0,0.1526247569669475,0.8473752430330524,1866,0.18146467919637072,0.21386908619572262,0.6046662346079067
6704,4810402,2006,110,189,480,1896,2006,1.0,0.054835493519441676,0.9451645064805583,1337,0.09421734795613161,0.23928215353938184,0.6665004985044866
6705,4810403,957,359,173,218,598,957,1.0,0.37513061650992685,0.6248693834900731,566,0.180773249738767,0.2277951933124347,0.5914315569487983
6706,4830001,184,0,7,154,184,184,1.0,0.0,1.0,23,0.03804347826086957,0.8369565217391305,0.125
6707,4830002,564,2,28,297,562,564,1.0,0.0035460992907801418,0.9964539007092199,239,0.04964539007092199,0.526595744680851,0.4237588652482269
6708,4830003,630,1,40,288,629,630,1.0,0.0015873015873015873,0.9984126984126984,302,0.06349206349206349,0.45714285714285713,0.4793650793650794
6709,4830004,152,0,13,98,152,152,1.0,0.0,1.0,41,0.08552631578947369,0.6447368421052632,0.26973684210526316
6710,4830005,84,5,4,56,79,84,1.0,0.05952380952380952,0.9404761904761905,24,0.047619047619047616,0.6666666666666666,0.2857142857142857
6711,4830006,144,8,11,74,136,144,1.0,0.05555555555555555,0.9444444444444444,59,0.0763888888888889,0.5138888888888888,0.4097222222222222
6712,4830007,108,0,5,84,108,108,1.0,0.0,1.0,19,0.046296296296296294,0.7777777777777778,0.17592592592592593
6713,4830008,780,52,55,269,728,780,1.0,0.06666666666666667,0.9333333333333333,456,0.07051282051282051,0.34487179487179487,0.5846153846153846
6714,4830009,962,43,68,481,919,962,1.0,0.0446985446985447,0.9553014553014553,413,0.07068607068607069,0.5,0.4293139293139293
6715,4830010,113,0,1,77,113,113,1.0,0.0,1.0,35,0.008849557522123894,0.6814159292035398,0.30973451327433627
6716,4850101,282,4,44,237,278,282,1.0107913669064748,0.014184397163120567,0.9858156028368794,1,0.15602836879432624,0.8404255319148937,0.0035460992907801418
6717,4850102,795,58,109,422,737,795,1.0,0.0729559748427673,0.9270440251572327,264,0.1371069182389937,0.5308176100628931,0.3320754716981132
6718,4850103,5305,199,575,2164,5106,5305,1.0,0.037511781338360035,0.9624882186616399,2566,0.10838831291234684,0.4079170593779453,0.48369462770970784
6719,4850104,1479,145,199,663,1334,1479,1.0,0.09803921568627451,0.9019607843137255,617,0.1345503718728871,0.4482758620689655,0.4171737660581474
6720,4850105,3675,164,448,1439,3511,3675,1.0,0.04462585034013605,0.9553741496598639,1788,0.1219047619047619,0.39156462585034013,0.48653061224489796
6721,4850106,1006,1,62,406,1005,1006,1.0,0.0009940357852882703,0.9990059642147118,538,0.061630218687872766,0.40357852882703776,0.5347912524850894
6722,4850107,41,6,2,21,35,41,1.0,0.14634146341463414,0.8536585365853658,18,0.04878048780487805,0.5121951219512195,0.43902439024390244
6723,4850108,3642,283,459,1584,3359,3642,1.0,0.07770455793520044,0.9222954420647995,1599,0.12602965403624383,0.43492586490939045,0.4390444810543657
6724,4850109,3656,121,484,1837,3535,3656,1.0,0.03309628008752735,0.9669037199124726,1335,0.1323851203501094,0.5024617067833698,0.36515317286652077
6725,4850110,815,79,83,306,736,815,1.0,0.09693251533742331,0.9030674846625767,426,0.10184049079754601,0.3754601226993865,0.5226993865030675
6726,4850111,1631,308,73,244,1323,1631,1.0,0.1888412017167382,0.8111587982832618,1314,0.04475781729000613,0.1496014714898835,0.8056407112201104
6727,4850112,62,4,7,21,58,62,1.0,0.06451612903225806,0.9354838709677419,34,0.11290322580645161,0.3387096774193548,0.5483870967741935
6728,4850113,1312,31,92,316,1281,1312,1.0,0.023628048780487805,0.9763719512195121,904,0.0701219512195122,0.24085365853658536,0.6890243902439024
6729,4850115,5,2,0,2,3,5,1.0,0.4,0.6,3,0.0,0.4,0.6
6730,4850116,63,32,3,19,31,63,1.0,0.5079365079365079,0.49206349206349204,41,0.047619047619047616,0.30158730158730157,0.6507936507936508
6731,4850117,55,28,4,20,27,55,1.0,0.509090909090909,0.4909090909090909,31,0.07272727272727272,0.36363636363636365,0.5636363636363636
6732,4850201,8746,1056,455,904,7690,8746,1.0,0.1207409101303453,0.8792590898696547,7387,0.05202378230048022,0.10336153670249257,0.8446146809970272
6733,4850202,2396,177,360,745,2219,2396,1.0,0.07387312186978297,0.926126878130217,1291,0.15025041736227046,0.31093489148580966,0.5388146911519198
6734,4850203,3089,409,344,567,2680,3089,1.0,0.13240530916154095,0.8675946908384591,2178,0.11136290061508579,0.18355454839753965,0.7050825509873746
6735,4850204,775,44,82,283,731,775,1.0,0.0567741935483871,0.9432258064516129,410,0.10580645161290322,0.36516129032258066,0.5290322580645161
6736,4850205,5020,151,368,2022,4869,5020,1.0,0.030079681274900398,0.9699203187250997,2630,0.07330677290836653,0.40278884462151393,0.5239043824701195
6737,4850206,4184,150,353,1374,4034,4184,1.0,0.035850860420650096,0.9641491395793499,2457,0.08436902485659656,0.3283938814531549,0.5872370936902486
6738,4850207,936,155,167,241,781,936,1.0,0.1655982905982906,0.8344017094017094,528,0.17841880341880342,0.25747863247863245,0.5641025641025641
6739,4850208,131,2,20,44,129,131,1.0,0.015267175572519083,0.9847328244274809,67,0.15267175572519084,0.33587786259541985,0.5114503816793893
6740,4850209,2,1,0,0,1,2,1.0,0.5,0.5,2,0.0,0.0,1.0
6741,4850210,1,1,0,0,0,1,1.0,1.0,0.0,1,0.0,0.0,1.0
6742,4850211,237,32,39,137,205,237,1.0,0.1350210970464135,0.8649789029535865,61,0.16455696202531644,0.5780590717299579,0.25738396624472576
6743,4850301,227,26,7,15,201,227,1.0,0.1145374449339207,0.8854625550660793,205,0.030837004405286344,0.06607929515418502,0.9030837004405287
6744,4850302,3313,399,349,452,2914,3313,1.0,0.12043465137337761,0.8795653486266224,2512,0.10534258979776638,0.1364322366435255,0.7582251735587081
6745,4850303,2655,861,675,233,1794,2655,1.0,0.32429378531073444,0.6757062146892655,1747,0.2542372881355932,0.08775894538606403,0.6580037664783428
6746,4850304,812,137,49,110,675,812,1.0,0.1687192118226601,0.8312807881773399,653,0.0603448275862069,0.1354679802955665,0.8041871921182266
6747,4850305,594,10,77,154,584,594,1.0,0.016835016835016835,0.9831649831649831,363,0.12962962962962962,0.25925925925925924,0.6111111111111112
6748,4850306,1148,756,445,111,392,1148,1.0,0.6585365853658537,0.34146341463414637,592,0.3876306620209059,0.09668989547038327,0.5156794425087108
6749,4850307,5620,2002,31,141,3618,5620,1.0,0.3562277580071174,0.6437722419928825,5448,0.005516014234875445,0.02508896797153025,0.9693950177935943
6750,4850308,1063,157,136,175,906,1063,1.0,0.14769520225776106,0.852304797742239,752,0.1279397930385701,0.16462841015992474,0.7074317968015051
6751,4850309,4264,4,346,2127,4260,4264,1.0,0.0009380863039399625,0.99906191369606,1791,0.08114446529080675,0.49882739212007504,0.4200281425891182
6752,4850310,1585,10,122,881,1575,1585,1.0,0.006309148264984227,0.9936908517350158,582,0.07697160883280757,0.5558359621451104,0.36719242902208205
6753,4850311,2973,882,663,239,2091,2973,1.0,0.2966700302724521,0.7033299697275479,2071,0.22300706357214933,0.08039017827110663,0.696602758156744
6754,4850312,130,21,14,3,109,130,1.0,0.16153846153846155,0.8384615384615385,113,0.1076923076923077,0.023076923076923078,0.8692307692307693
6755,4850313,54,14,19,4,40,54,1.0,0.25925925925925924,0.7407407407407407,31,0.35185185185185186,0.07407407407407407,0.5740740740740741
6756,4850315,159,5,26,51,154,159,1.0,0.031446540880503145,0.9685534591194969,82,0.16352201257861634,0.32075471698113206,0.5157232704402516
6757,4850316,132,17,16,22,115,132,1.0,0.12878787878787878,0.8712121212121212,94,0.12121212121212122,0.16666666666666666,0.7121212121212122
6758,4850317,82,2,12,47,80,82,1.0,0.024390243902439025,0.975609756097561,23,0.14634146341463414,0.573170731707317,0.2804878048780488
6759,4850318,631,15,77,165,616,631,1.0,0.02377179080824089,0.9762282091917591,389,0.12202852614896989,0.26148969889064977,0.6164817749603804
6760,4850319,76,1,9,13,75,76,1.0,0.013157894736842105,0.9868421052631579,54,0.11842105263157894,0.17105263157894737,0.7105263157894737
6761,4850401,2642,66,334,1177,2576,2642,1.0,0.02498107494322483,0.9750189250567751,1131,0.1264193792581378,0.44549583648750946,0.42808478425435276
6762,4850402,860,24,115,413,836,860,1.0,0.027906976744186046,0.9720930232558139,332,0.13372093023255813,0.48023255813953486,0.386046511627907
6763,4850403,2923,49,357,1097,2874,2923,1.0,0.016763599042080055,0.98323640095792,1469,0.12213479302086896,0.37529934998289427,0.5025658569962368
6764,4850404,2842,105,290,1526,2737,2842,1.0,0.03694581280788178,0.9630541871921182,1026,0.10204081632653061,0.5369458128078818,0.3610133708655876
6765,4850405,2780,170,363,767,2610,2780,1.0,0.06115107913669065,0.9388489208633094,1650,0.13057553956834533,0.2758992805755396,0.5935251798561151
6766,4850406,3173,79,436,1492,3094,3173,1.0,0.024897573274503624,0.9751024267254964,1245,0.13740939174283012,0.4702174598172077,0.3923731484399622
6767,4850407,2440,246,325,621,2194,2440,1.0,0.10081967213114754,0.8991803278688525,1494,0.13319672131147542,0.2545081967213115,0.6122950819672132
6768,4850408,5,0,0,2,5,5,1.0,0.0,1.0,3,0.0,0.4,0.6
6769,4850409,5,0,0,2,5,5,1.0,0.0,1.0,3,0.0,0.4,0.6
6770,4850410,274,5,41,146,269,274,1.0,0.01824817518248175,0.9817518248175182,87,0.14963503649635038,0.5328467153284672,0.3175182481751825
6771,4850411,1030,29,128,393,1001,1030,1.0,0.02815533980582524,0.9718446601941747,509,0.12427184466019417,0.38155339805825245,0.4941747572815534
6772,4850412,722,11,55,430,711,722,1.0,0.015235457063711912,0.9847645429362881,237,0.07617728531855955,0.5955678670360111,0.32825484764542934
6773,4850413,1656,69,109,473,1587,1656,1.0,0.041666666666666664,0.9583333333333334,1074,0.06582125603864734,0.2856280193236715,0.6485507246376812
6774,4850414,986,11,66,306,975,986,1.0,0.011156186612576065,0.9888438133874239,614,0.06693711967545639,0.3103448275862069,0.6227180527383367
6775,4870001A,1570,121,129,493,1449,1570,1.0,0.07707006369426751,0.9229299363057325,948,0.0821656050955414,0.31401273885350317,0.6038216560509554
6776,4870001B,137,0,11,53,137,137,1.0,0.0,1.0,73,0.08029197080291971,0.38686131386861317,0.5328467153284672
6777,4870019,2271,439,349,555,1832,2271,1.0,0.1933069132540731,0.8066930867459269,1367,0.15367679436371642,0.24438573315719947,0.6019374724790841
6778,4870020,1992,99,177,359,1893,1992,1.0,0.04969879518072289,0.9503012048192772,1456,0.08885542168674698,0.18022088353413654,0.7309236947791165
6779,4870021,2741,211,178,1088,2530,2741,1.0,0.07697920466982854,0.9230207953301715,1475,0.0649398029916089,0.3969354250273623,0.5381247719810288
6780,4890001,2499,0,634,161,2499,2499,1.0,0.0,1.0,1704,0.2537014805922369,0.06442577030812324,0.6818727490996399
6781,4890002A,34,2,19,3,32,34,1.0,0.058823529411764705,0.9411764705882353,12,0.5588235294117647,0.08823529411764706,0.35294117647058826
6782,4890002B,1910,0,468,156,1910,1910,1.0,0.0,1.0,1286,0.2450261780104712,0.08167539267015707,0.6732984293193718
6783,4890003,1140,0,289,122,1140,1140,1.0,0.0,1.0,729,0.2535087719298246,0.10701754385964912,0.6394736842105263
6784,4890004,1526,0,515,153,1526,1526,1.0,0.0,1.0,858,0.33748361730013104,0.10026212319790301,0.562254259501966
6785,4890005,718,0,351,66,718,718,1.0,0.0,1.0,301,0.48885793871866295,0.09192200557103064,0.4192200557103064
6786,4890006,434,0,139,68,434,434,1.0,0.0,1.0,227,0.32027649769585254,0.15668202764976957,0.5230414746543779
6787,4890007,1724,0,358,173,1724,1724,1.0,0.0,1.0,1193,0.20765661252900233,0.10034802784222738,0.6919953596287703
6788,4890008,824,11,284,90,813,824,1.0,0.013349514563106795,0.9866504854368932,450,0.3446601941747573,0.10922330097087378,0.5461165048543689
6789,4890009,1175,0,322,137,1175,1175,1.0,0.0,1.0,716,0.27404255319148935,0.11659574468085106,0.6093617021276596
6790,4890010,210,0,50,160,210,210,1.05,0.0,1.0,0,0.23809523809523808,0.7619047619047619,0.0
6791,4890011,2019,115,144,115,1904,2019,1.0,0.05695889053987122,0.9430411094601288,1760,0.0713224368499257,0.05695889053987122,0.8717186726102031
6792,4890012,115,0,27,12,115,115,1.0,0.0,1.0,76,0.23478260869565218,0.10434782608695652,0.6608695652173913
6793,4910119,3909,380,909,1208,3529,3909,1.0,0.09721156305960604,0.902788436940394,1792,0.23254029163468917,0.3090304425684318,0.458429265796879
6794,4910122,2145,94,530,935,2051,2145,1.0,0.04382284382284382,0.9561771561771562,680,0.24708624708624707,0.4358974358974359,0.317016317016317
6795,4910135,6010,650,824,561,5360,6010,1.0,0.10815307820299501,0.891846921797005,4625,0.13710482529118137,0.09334442595673877,0.7695507487520798
6796,4910138,4883,84,946,1508,4799,4883,1.0,0.017202539422486177,0.9827974605775138,2429,0.19373336063895147,0.30882654106082325,0.4974400983002253
6797,4910140,1893,166,535,703,1727,1893,1.0,0.08769149498151083,0.9123085050184891,655,0.2826201796090861,0.37136819862651876,0.34601162176439515
6798,4910145,3765,575,815,542,3190,3765,1.0,0.15272244355909695,0.8472775564409031,2408,0.21646746347941567,0.1439575033200531,0.6395750332005312
6799,4910146,5050,462,1444,1121,4588,5050,1.0,0.09148514851485148,0.9085148514851485,2485,0.2859405940594059,0.22198019801980198,0.49207920792079207
6800,4910147,4050,125,796,700,3925,4050,1.0,0.030864197530864196,0.9691358024691358,2554,0.19654320987654322,0.1728395061728395,0.6306172839506173
6801,4910149,3717,449,573,474,3268,3717,1.0,0.12079634113532418,0.8792036588646758,2670,0.15415657788539144,0.1275221953188055,0.718321226795803
6802,4910150,3676,433,678,467,3243,3676,1.0,0.11779107725788901,0.8822089227421109,2531,0.18443960826985853,0.12704026115342765,0.6885201305767138
6803,4910151,2796,159,713,662,2637,2796,1.0,0.05686695278969957,0.9431330472103004,1421,0.2550071530758226,0.23676680972818312,0.5082260371959942
6804,4910152,3340,177,764,480,3163,3340,1.0,0.0529940119760479,0.9470059880239521,2096,0.22874251497005987,0.1437125748502994,0.6275449101796408
6805,4910160,4475,183,1190,1384,4292,4475,1.0,0.04089385474860335,0.9591061452513967,1901,0.2659217877094972,0.30927374301675975,0.424804469273743
6806,4910162,3639,209,882,680,3430,3639,1.0,0.05743336081341028,0.9425666391865897,2077,0.24237427864798022,0.18686452322066502,0.5707611981313547
6807,4910172,1996,0,479,884,1996,1996,1.0,0.0,1.0,633,0.23997995991983967,0.44288577154308617,0.31713426853707416
6808,4910182,4038,220,844,1758,3818,4038,1.0,0.05448241703813769,0.9455175829618623,1436,0.20901436354631006,0.43536404160475484,0.35562159484893513
6809,4910185,1268,106,592,444,1162,1268,1.0,0.083596214511041,0.916403785488959,232,0.4668769716088328,0.3501577287066246,0.1829652996845426
6810,4910186,3149,175,652,821,2974,3149,1.0,0.055573197840584315,0.9444268021594157,1676,0.20704985709749127,0.2607176881549698,0.5322324547475389
6811,4910189,2816,153,657,867,2663,2816,1.0,0.05433238636363636,0.9456676136363636,1292,0.2333096590909091,0.3078835227272727,0.4588068181818182
6812,4910190,4232,196,1111,1876,4036,4232,1.0,0.046313799621928164,0.9536862003780718,1245,0.262523629489603,0.44328922495274103,0.29418714555765596
6813,4910197,2578,81,667,1063,2497,2578,1.0,0.031419705197827774,0.9685802948021722,848,0.2587276958882855,0.41233514352211015,0.32893716058960437
6814,4910198,3643,184,1075,1480,3459,3643,1.0,0.05050782322261872,0.9494921767773813,1088,0.2950864671973648,0.4062585780949767,0.2986549547076585
6815,4910201,5717,138,910,1515,5579,5717,1.0,0.024138534196256778,0.9758614658037432,3292,0.15917439216372223,0.2649991254154277,0.5758264824208501
6816,4910202,790,13,117,205,777,790,1.0,0.016455696202531647,0.9835443037974684,468,0.14810126582278482,0.25949367088607594,0.5924050632911393
6817,4910204,5254,184,909,1576,5070,5254,1.0,0.03502093642938713,0.9649790635706129,2769,0.1730110392082223,0.29996193376475067,0.527027027027027
6818,4910206,3483,45,378,1287,3438,3483,1.0,0.012919896640826873,0.9870801033591732,1818,0.10852713178294573,0.3695090439276486,0.5219638242894057
6819,4910207,4749,47,486,1739,4702,4749,1.0,0.009896820383238577,0.9901031796167614,2524,0.10233733417561591,0.3661823541798273,0.5314803116445568
6820,4910216,2459,109,606,920,2350,2459,1.0,0.04432696217974787,0.9556730378202521,933,0.2464416429442863,0.37413582757218383,0.3794225294835299
6821,4910218,3607,236,943,916,3371,3607,1.0,0.06542833379539784,0.9345716662046022,1748,0.26143609647906846,0.2539506515109509,0.48461325200998057
6822,4910253,6008,435,784,1499,5573,6008,1.0,0.07240346205059921,0.9275965379494008,3725,0.13049267643142476,0.24950066577896138,0.6200066577896138
6823,4910254,4193,34,692,1137,4159,4193,1.0,0.008108752683043167,0.9918912473169569,2364,0.16503696637252563,0.2711662294300024,0.563796804197472
6824,4910259,4347,384,543,836,3963,4347,1.0,0.0883367839889579,0.911663216011042,2968,0.12491373360938578,0.1923165401426271,0.6827697262479872
6825,4910263,5284,144,607,1024,5140,5284,1.0,0.02725208175624527,0.9727479182437547,3653,0.11487509462528388,0.19379258137774413,0.691332323996972
6826,4910264,6558,89,681,1302,6469,6558,1.0,0.013571210734980178,0.9864287892650199,4575,0.10384263494967978,0.19853613906678866,0.6976212259835316
6827,4910266,4598,248,670,908,4350,4598,1.0,0.053936494127881686,0.9460635058721183,3020,0.14571552849064812,0.197477163984341,0.6568073075250108
6828,4910267,3515,160,350,1007,3355,3515,1.0,0.04551920341394026,0.9544807965860598,2158,0.09957325746799431,0.2864864864864865,0.6139402560455192
6829,4910273,2983,101,781,1034,2882,2983,1.0,0.033858531679517266,0.9661414683204828,1168,0.26181696278913846,0.34663090848139455,0.391552128729467
6830,4910274,5046,238,611,605,4808,5046,1.0,0.04716607213634562,0.9528339278636544,3830,0.12108600871977804,0.11989694807768529,0.7590170432025367
6831,4910275,3421,128,872,678,3293,3421,1.0,0.03741596024554224,0.9625840397544577,1871,0.2548962291727565,0.19818766442560654,0.5469161064016369
6832,4910278,6203,210,1263,1823,5993,6203,1.0,0.033854586490407866,0.9661454135095922,3117,0.20361115589231019,0.2938900532000645,0.5024987909076254
6833,4910283,6369,267,954,1328,6102,6369,1.0,0.041921808761187,0.958078191238813,4087,0.1497880357983985,0.20850997016800127,0.6417019940336003
6834,4910287,5248,360,997,1592,4888,5248,1.0,0.06859756097560976,0.9314024390243902,2659,0.18997713414634146,0.30335365853658536,0.5066692073170732
6835,4910305,2662,75,370,1286,2587,2662,1.0,0.028174305033809167,0.9718256949661909,1006,0.13899323816679188,0.4830954169797145,0.3779113448534936
6836,4910309,1318,3,173,556,1315,1318,1.0,0.002276176024279211,0.9977238239757208,589,0.13125948406676782,0.4218512898330804,0.44688922610015175
6837,4910310,1830,0,244,752,1830,1830,1.0,0.0,1.0,834,0.13333333333333333,0.41092896174863386,0.4557377049180328
6838,4910311,2306,97,266,764,2209,2306,1.0,0.04206418039895923,0.9579358196010408,1276,0.11535125758889853,0.3313096270598439,0.5533391153512576
6839,4910312,4432,144,350,1226,4288,4432,1.0,0.032490974729241874,0.9675090252707581,2856,0.078971119133574,0.2766245487364621,0.644404332129964
6840,4910314,6267,350,736,734,5917,6267,1.0,0.05584809318653263,0.9441519068134674,4797,0.11744056167225148,0.11712142971118558,0.765438008616563
6841,4910330,4411,117,950,1441,4294,4411,1.0,0.026524597596916798,0.9734754024030832,2020,0.21537066424846973,0.3266832917705736,0.4579460439809567
6842,4910331,3973,133,461,862,3840,3973,1.0,0.03347596274855273,0.9665240372514473,2650,0.11603322426378052,0.21696451044550719,0.6670022652907123
6843,4910332,2964,87,529,1166,2877,2964,1.0,0.029352226720647773,0.9706477732793523,1269,0.17847503373819162,0.393387314439946,0.42813765182186236
6844,4910333A,4532,510,795,1422,4022,4532,1.0,0.11253309796999117,0.8874669020300088,2315,0.17541924095322153,0.3137687555163283,0.5108120035304501
6845,4910333B,31,1,4,8,30,31,1.0,0.03225806451612903,0.967741935483871,19,0.12903225806451613,0.25806451612903225,0.6129032258064516
6846,4910337,4577,740,791,1202,3837,4577,1.0,0.16167795499235307,0.838322045007647,2584,0.17282062486344768,0.2626174350010924,0.5645619401354599
6847,4910339,3705,402,626,667,3303,3705,1.0,0.10850202429149798,0.891497975708502,2412,0.1689608636977058,0.18002699055330634,0.6510121457489878
6848,4910341,3211,101,363,918,3110,3211,1.0,0.03145437558393024,0.9685456244160697,1930,0.11304889442541265,0.28589224540641545,0.6010588601681719
6849,4910342,2046,147,216,192,1899,2046,1.0,0.0718475073313783,0.9281524926686217,1638,0.10557184750733138,0.093841642228739,0.8005865102639296
6850,4910343,3844,94,581,1552,3750,3844,1.0,0.02445369406867846,0.9755463059313215,1711,0.1511446409989594,0.4037460978147763,0.4451092611862643
6851,4910344,2881,105,367,1233,2776,2881,1.0,0.03644567858382506,0.9635543214161749,1281,0.12738632419298854,0.4279763970843457,0.44463727872266573
6852,4910345,1649,15,163,456,1634,1649,1.0,0.009096422073984234,0.9909035779260158,1030,0.09884778653729533,0.2765312310491207,0.624620982413584
6853,4910368,4372,528,509,500,3844,4372,1.0,0.12076852698993595,0.879231473010064,3363,0.11642268984446477,0.11436413540713632,0.7692131747483989
6854,4910369,3994,178,547,886,3816,3994,1.0,0.04456685027541312,0.9554331497245869,2561,0.13695543314972458,0.22183274912368553,0.6412118177265899
6855,4910370,5844,203,845,1633,5641,5844,1.0,0.034736481861738534,0.9652635181382615,3366,0.1445927446954141,0.27943189596167006,0.5759753593429158
6856,4910371,3298,79,426,1055,3219,3298,1.0,0.023953911461491815,0.9760460885385082,1817,0.12916919345057612,0.31989084293511216,0.5509399636143117
6857,4910379,5073,55,695,2294,5018,5073,1.0,0.010841711019120836,0.9891582889808792,2084,0.13699980287798147,0.4521979105066036,0.41080228661541496
6858,4910381,3836,20,772,2038,3816,3836,1.0,0.005213764337851929,0.9947862356621481,1026,0.20125130344108447,0.5312825860271115,0.26746611053180397
6859,4910392,5005,21,692,1942,4984,5005,1.0,0.004195804195804196,0.9958041958041958,2371,0.13826173826173827,0.388011988011988,0.47372627372627374
6860,4910393,3347,17,667,1757,3330,3347,1.0,0.005079175380938153,0.9949208246190618,923,0.19928293994622048,0.5249477143710786,0.27576934568270095
6861,4910394,1902,39,340,900,1863,1902,1.0,0.02050473186119874,0.9794952681388013,662,0.17875920084121977,0.47318611987381703,0.3480546792849632
6862,4910395,3455,34,373,1192,3421,3455,1.0,0.009840810419681621,0.9901591895803183,1890,0.10795947901591896,0.3450072358900145,0.5470332850940666
6863,4910396,3952,40,849,2020,3912,3952,1.0,0.010121457489878543,0.9898785425101214,1083,0.21482793522267207,0.5111336032388664,0.27403846153846156
6864,4910402,6610,942,1023,1068,5668,6610,1.0,0.14251134644478064,0.8574886535552194,4519,0.15476550680786688,0.1615733736762481,0.683661119515885
6865,4910403,3421,288,441,598,3133,3421,1.0,0.08418591055247004,0.91581408944753,2382,0.12890967553346974,0.17480268927214265,0.6962876351943876
6866,4910413,721,1,113,220,720,721,1.0,0.0013869625520110957,0.9986130374479889,388,0.15672676837725383,0.30513176144244103,0.5381414701803051
6867,4910415,1827,101,297,671,1726,1827,1.0,0.055281882868089764,0.9447181171319102,859,0.1625615763546798,0.3672687465790914,0.4701696770662288
6868,4910420,5479,567,688,1088,4912,5479,1.0,0.10348603759810185,0.8965139624018982,3703,0.12557035955466325,0.19857638255156052,0.6758532578937763
6869,4910423,4856,355,955,901,4501,4856,1.0,0.07310543657331137,0.9268945634266886,3000,0.19666392092257,0.18554365733113673,0.6177924217462932
6870,4910424,4739,684,856,1636,4055,4739,1.0,0.14433424773158895,0.855665752268411,2247,0.18062882464654992,0.3452205106562566,0.4741506646971935
6871,4910425,1371,356,144,193,1015,1371,1.0,0.25966447848285923,0.7403355215171408,1034,0.1050328227571116,0.14077315827862874,0.7541940189642596
6872,4910426,2528,355,404,640,2173,2528,1.0,0.14042721518987342,0.8595727848101266,1484,0.15981012658227847,0.25316455696202533,0.5870253164556962
6873,4910427,3300,157,552,873,3143,3300,1.0,0.04757575757575758,0.9524242424242424,1875,0.16727272727272727,0.26454545454545453,0.5681818181818182
6874,4910428,3169,307,516,951,2862,3169,1.0,0.09687598611549385,0.9031240138845061,1702,0.16282739034395707,0.3000946670874093,0.5370779425686336
6875,4910429,2970,253,375,285,2717,2970,1.0,0.08518518518518518,0.9148148148148149,2310,0.12626262626262627,0.09595959595959595,0.7777777777777778
6876,4910434,2962,98,369,1207,2864,2962,1.0,0.03308575286968265,0.9669142471303174,1386,0.12457798784604997,0.4074949358541526,0.4679270762997974
6877,4910436,1043,61,87,335,982,1043,1.0,0.058485139022051776,0.9415148609779482,621,0.08341323106423777,0.3211888782358581,0.5953978906999041
6878,4910455,4396,358,734,559,4038,4396,1.0,0.08143767060964513,0.9185623293903549,3103,0.16696997270245678,0.12716105550500456,0.7058689717925387
6879,4910456,2360,462,478,344,1898,2360,1.0,0.19576271186440677,0.8042372881355933,1538,0.20254237288135593,0.14576271186440679,0.6516949152542373
6880,4910463,5020,642,1250,982,4378,5020,1.0,0.12788844621513945,0.8721115537848606,2788,0.24900398406374502,0.1956175298804781,0.5553784860557769
6881,4910480,6459,747,1241,1234,5712,6459,1.0,0.11565257779842081,0.8843474222015791,3984,0.19213500541879547,0.19105124632296022,0.6168137482582443
6882,4910484,4713,730,879,1076,3983,4713,1.0,0.15489072777424145,0.8451092722257585,2758,0.18650541056651815,0.22830468915764907,0.5851899002758328
6883,4910488,2850,203,524,835,2647,2850,1.0,0.0712280701754386,0.9287719298245614,1491,0.18385964912280703,0.2929824561403509,0.5231578947368422
6884,4910489,4456,357,922,1550,4099,4456,1.0,0.08011669658886894,0.9198833034111311,1984,0.2069120287253142,0.3478456014362657,0.4452423698384201
6885,4910490,1438,148,214,351,1290,1438,1.0,0.10292072322670376,0.8970792767732962,873,0.14881780250347706,0.24408901251738527,0.6070931849791377
6886,4910491,8005,1114,1289,1392,6891,8005,1.0,0.1391630231105559,0.860836976889444,5324,0.16102435977514054,0.17389131792629606,0.6650843222985634
6887,4930101,2696,41,468,766,2655,2696,1.0,0.015207715133531157,0.9847922848664689,1462,0.17359050445103857,0.2841246290801187,0.5422848664688428
6888,4930102,2650,3,708,332,2647,2650,1.0,0.0011320754716981133,0.9988679245283019,1610,0.26716981132075474,0.12528301886792453,0.6075471698113207
6889,4930103,2250,1,363,552,2249,2250,1.0,0.00044444444444444447,0.9995555555555555,1335,0.16133333333333333,0.24533333333333332,0.5933333333333334
6890,4930104,1332,2,156,403,1330,1332,1.0,0.0015015015015015015,0.9984984984984985,773,0.11711711711711711,0.30255255255255253,0.5803303303303303
6891,4930205,2104,0,335,734,2104,2104,1.0,0.0,1.0,1035,0.15922053231939162,0.3488593155893536,0.4919201520912547
6892,4930206,3013,57,579,793,2956,3013,1.0,0.018918021905077995,0.981081978094922,1641,0.19216727514105542,0.2631928310653833,0.5446398937935613
6893,4930207,2047,42,291,799,2005,2047,1.0,0.02051783097215437,0.9794821690278456,957,0.14215925744992672,0.3903273082559844,0.4675134342940889
6894,4930208,573,0,61,261,573,573,1.0,0.0,1.0,251,0.10645724258289703,0.45549738219895286,0.43804537521815007
6895,4930209,474,0,39,233,474,474,1.0,0.0,1.0,202,0.08227848101265822,0.49156118143459915,0.42616033755274263
6896,4930310,884,25,91,358,859,884,1.0,0.02828054298642534,0.9717194570135747,435,0.10294117647058823,0.40497737556561086,0.4920814479638009
6897,4930311,2276,21,145,914,2255,2276,1.0,0.00922671353251318,0.9907732864674869,1217,0.06370826010544815,0.4015817223198594,0.5347100175746925
6898,4930312,2951,64,216,1333,2887,2951,1.0,0.021687563537783804,0.9783124364622162,1402,0.07319552694002034,0.45171128431040325,0.4750931887495764
6899,4930313,3135,45,354,1180,3090,3135,1.0,0.014354066985645933,0.9856459330143541,1601,0.11291866028708133,0.3763955342902711,0.5106858054226475
6900,4930414,2767,39,306,1012,2728,2767,1.0,0.014094687387061799,0.9859053126129382,1449,0.11058908565233104,0.365739067582219,0.52367184676545
6901,4930415,3425,136,315,1581,3289,3425,1.0,0.039708029197080295,0.9602919708029197,1529,0.09197080291970802,0.46160583941605837,0.4464233576642336
6902,4930416,2677,44,394,967,2633,2677,1.0,0.016436309301456856,0.9835636906985431,1316,0.14717967874486365,0.3612252521479268,0.49159506910720957
6903,4950101,1167,26,92,418,1141,1167,1.0,0.022279348757497857,0.9777206512425022,657,0.07883461868037704,0.3581833761782348,0.5629820051413882
6904,4950201,462,1,44,105,461,462,1.0,0.0021645021645021645,0.9978354978354979,313,0.09523809523809523,0.22727272727272727,0.6774891774891775
6905,4950202,511,9,54,306,502,511,1.0,0.01761252446183953,0.9823874755381604,151,0.10567514677103718,0.598825831702544,0.29549902152641877
6906,4950301,1430,13,74,392,1417,1430,1.0,0.00909090909090909,0.990909090909091,964,0.05174825174825175,0.27412587412587414,0.6741258741258741
6907,4950401,1134,81,134,110,1053,1134,1.0,0.07142857142857142,0.9285714285714286,890,0.11816578483245149,0.09700176366843033,0.7848324514991182
6908,4970001,1390,42,104,695,1348,1390,1.0,0.030215827338129497,0.9697841726618706,591,0.07482014388489208,0.5,0.4251798561151079
6909,4970002,3251,119,287,1189,3132,3251,1.0,0.036604121808674256,0.9633958781913258,1775,0.08828052906797908,0.36573362042448476,0.5459858505075361
6910,4970003,881,14,51,347,867,881,1.0,0.015891032917139614,0.9841089670828603,483,0.05788876276958002,0.3938706015891033,0.5482406356413166
6911,4970004,401,0,42,121,401,401,1.0,0.0,1.0,238,0.10473815461346633,0.30174563591022446,0.5935162094763092
6912,4970005,1922,0,100,675,1922,1922,1.0,0.0,1.0,1147,0.05202913631633715,0.3511966701352758,0.5967741935483871
6913,4970006,2137,17,161,729,2120,2137,1.0,0.007955077211043519,0.9920449227889565,1247,0.07533926064576509,0.341132428638278,0.5835283107159569
6914,4970007A,827,4,69,325,823,827,1.0,0.0048367593712212815,0.9951632406287787,433,0.08343409915356712,0.39298669891172916,0.5235792019347038
6915,4970007B,722,14,72,324,708,722,1.0,0.019390581717451522,0.9806094182825484,326,0.0997229916897507,0.4487534626038781,0.4515235457063712
6916,4970008,2257,5,178,1112,2252,2257,1.0,0.002215330084182543,0.9977846699158175,967,0.07886575099689853,0.49268941072219763,0.42844483828090385
6917,4970009,2050,10,155,995,2040,2050,1.0,0.004878048780487805,0.9951219512195122,900,0.07560975609756097,0.4853658536585366,0.43902439024390244
6918,4970010,408,10,44,257,398,408,1.0,0.024509803921568627,0.9754901960784313,107,0.10784313725490197,0.6299019607843137,0.2622549019607843
6919,4970011,501,17,41,264,484,501,1.0,0.033932135728542916,0.9660678642714571,196,0.08183632734530938,0.5269461077844312,0.3912175648702595
6920,4970012,1931,19,140,672,1912,1931,1.0,0.00983946141895391,0.9901605385810461,1119,0.07250129466597618,0.34800621439668566,0.5794924909373381
6921,4970013,1301,0,109,425,1301,1301,1.0,0.0,1.0,767,0.08378170637970792,0.32667179093005383,0.5895465026902382
6922,4970014,2633,38,129,813,2595,2633,1.0,0.014432206608431447,0.9855677933915685,1691,0.04899354348651728,0.30877326243828335,0.6422331940751994
6923,4970015,1525,0,83,642,1525,1525,1.0,0.0,1.0,800,0.05442622950819672,0.42098360655737704,0.5245901639344263
6924,4970016,2612,0,143,979,2612,2612,1.0,0.0,1.0,1490,0.054747320061255746,0.37480857580398164,0.5704441041347627
6925,4970017,2856,0,217,1256,2856,2856,1.0,0.0,1.0,1383,0.07598039215686274,0.43977591036414565,0.4842436974789916
6926,4970018,1744,177,57,434,1567,1744,1.0,0.1014908256880734,0.8985091743119266,1253,0.03268348623853211,0.24885321100917432,0.7184633027522935
6927,4970019,521,0,55,209,521,521,1.0,0.0,1.0,257,0.10556621880998081,0.40115163147792704,0.4932821497120921
6928,4970020,1371,7,83,509,1364,1371,1.0,0.005105762217359592,0.9948942377826404,779,0.060539752005835154,0.3712618526622903,0.5681983953318746
6929,4970022,1014,0,74,457,1014,1014,1.0,0.0,1.0,483,0.07297830374753451,0.45069033530571995,0.47633136094674555
6930,4970023,2079,6,151,781,2073,2079,1.0,0.002886002886002886,0.9971139971139971,1147,0.07263107263107263,0.37566137566137564,0.5517075517075517
6931,4970024,4732,152,355,1462,4580,4732,1.0,0.032121724429416736,0.9678782755705833,2915,0.07502113271344041,0.30896027049873204,0.6160185967878276
6932,4970025,125,0,18,51,125,125,1.0,0.0,1.0,56,0.144,0.408,0.448
6933,4970027,4398,6,303,1484,4392,4398,1.0,0.001364256480218281,0.9986357435197817,2611,0.0688949522510232,0.33742610277398816,0.5936789449749886
6934,49901-1,3447,149,326,1319,3298,3447,1.0,0.04322599361763853,0.9567740063823614,1802,0.09457499274731651,0.38265158108500147,0.5227734261676821
6935,49901-2,2570,49,213,1148,2521,2570,1.0,0.01906614785992218,0.9809338521400778,1209,0.08287937743190661,0.4466926070038911,0.47042801556420233
6936,49901-3,2379,7,174,915,2372,2379,1.0,0.0029424127784783522,0.9970575872215216,1290,0.07313997477931904,0.38461538461538464,0.5422446406052963
6937,49901-4,818,1,38,391,817,818,1.0,0.0012224938875305623,0.9987775061124694,389,0.04645476772616137,0.4779951100244499,0.47555012224938875
6938,49902-1,776,1,32,227,775,776,1.0,0.001288659793814433,0.9987113402061856,517,0.041237113402061855,0.2925257731958763,0.6662371134020618
6939,49902-2,4360,315,347,1673,4045,4360,1.0,0.07224770642201835,0.9277522935779816,2340,0.07958715596330275,0.38371559633027524,0.536697247706422
6940,49902-3,3599,160,352,1422,3439,3599,1.0,0.04445679355376494,0.955543206446235,1825,0.09780494581828286,0.3951097527090859,0.5070853014726313
6941,49903-1,1583,48,120,568,1535,1583,1.0,0.030322173089071383,0.9696778269109286,895,0.07580543272267846,0.35881238155401135,0.5653821857233101
6942,49903-2,2869,13,283,1785,2856,2869,1.0,0.004531195538515162,0.9954688044614849,801,0.09864064133844545,0.622168002788428,0.27919135587312655
6943,49903-3,4266,788,609,1496,3478,4266,1.0,0.1847163619315518,0.8152836380684482,2161,0.14275668073136427,0.3506797937177684,0.5065635255508674
6944,49904-1,802,5,61,419,797,802,1.0,0.006234413965087282,0.9937655860349127,322,0.07605985037406483,0.5224438902743143,0.4014962593516209
6945,49904-2,2299,0,194,1175,2299,2299,1.0,0.0,1.0,930,0.08438451500652458,0.5110917790343628,0.40452370595911263
6946,49904-3,3355,376,256,1405,2979,3355,1.0,0.1120715350223547,0.8879284649776453,1694,0.07630402384500745,0.4187779433681073,0.5049180327868853
6947,49904-4,1119,9,51,408,1110,1119,1.0,0.00804289544235925,0.9919571045576407,660,0.045576407506702415,0.3646112600536193,0.5898123324396782
6948,5010101,1130,6,58,493,1124,1130,1.0,0.005309734513274336,0.9946902654867257,579,0.05132743362831858,0.43628318584070797,0.5123893805309735
6949,5010202,1228,1,92,456,1227,1228,1.0,0.0008143322475570033,0.999185667752443,680,0.0749185667752443,0.3713355048859935,0.5537459283387622
6950,5010303,544,0,86,217,544,544,1.0,0.0,1.0,241,0.15808823529411764,0.39889705882352944,0.4430147058823529
6951,5010305,529,11,42,97,518,529,1.0,0.020793950850661626,0.9792060491493384,390,0.07939508506616257,0.1833648393194707,0.7372400756143668
6952,5010404,474,0,73,268,474,474,1.0,0.0,1.0,133,0.1540084388185654,0.5654008438818565,0.2805907172995781
6953,5010406,576,6,58,167,570,576,1.0,0.010416666666666666,0.9895833333333334,351,0.10069444444444445,0.2899305555555556,0.609375
6954,5030005,2831,32,220,1575,2799,2831,1.0,0.01130342635111268,0.9886965736488873,1036,0.07771105616389969,0.5563405157188273,0.3659484281172731
6955,5030006,177,5,16,124,172,177,1.0,0.02824858757062147,0.9717514124293786,37,0.0903954802259887,0.7005649717514124,0.20903954802259886
6956,5030007,167,0,19,91,167,167,1.0,0.0,1.0,57,0.11377245508982035,0.5449101796407185,0.3413173652694611
6957,5030010,599,0,33,242,599,599,1.0,0.0,1.0,324,0.05509181969949917,0.4040066777963272,0.5409015025041736
6958,5030016,271,0,13,165,271,271,1.0,0.0,1.0,93,0.04797047970479705,0.6088560885608856,0.34317343173431736
6959,5030020,247,0,15,119,247,247,1.0,0.0,1.0,113,0.06072874493927125,0.4817813765182186,0.4574898785425101
6960,5030022,3346,33,260,1961,3313,3346,1.0,0.00986252241482367,0.9901374775851763,1125,0.07770472205618649,0.5860729228930066,0.33622235505080694
6961,5030023,2719,14,223,1045,2705,2719,1.0,0.0051489518205222505,0.9948510481794778,1451,0.08201544685546157,0.3843324751746966,0.5336520779698418
6962,5030024,2581,123,195,915,2458,2581,1.0,0.047655947307245254,0.9523440526927548,1471,0.0755521115846571,0.3545137543587757,0.5699341340565672
6963,5050001,1631,0,699,233,1631,1631,1.0,0.0,1.0,699,0.42857142857142855,0.14285714285714285,0.42857142857142855
6964,5050002,1115,0,429,141,1115,1115,1.0,0.0,1.0,545,0.3847533632286996,0.12645739910313902,0.48878923766816146
6965,5050003,2002,0,530,378,2002,2002,1.0,0.0,1.0,1094,0.2647352647352647,0.1888111888111888,0.5464535464535465
6966,5050004,1256,0,527,168,1256,1256,1.0,0.0,1.0,561,0.4195859872611465,0.1337579617834395,0.446656050955414
6967,505001A,104,0,55,12,104,104,1.0,0.0,1.0,37,0.5288461538461539,0.11538461538461539,0.3557692307692308
6968,505001B,95,0,74,12,95,95,1.0,0.0,1.0,9,0.7789473684210526,0.12631578947368421,0.09473684210526316
6969,505002A,474,0,213,53,474,474,1.0,0.0,1.0,208,0.44936708860759494,0.11181434599156118,0.4388185654008439
6970,5070001,849,0,273,74,849,849,1.0,0.0,1.0,502,0.3215547703180212,0.08716136631330977,0.591283863368669
6971,5070002,2307,21,834,135,2286,2307,1.0,0.009102730819245773,0.9908972691807543,1338,0.36150845253576075,0.05851755526657997,0.5799739921976593
6972,5070003,2266,29,890,76,2237,2266,1.0,0.012797881729920565,0.9872021182700794,1300,0.39276257722859664,0.03353927625772286,0.5736981465136805
6973,5070004,1056,0,413,166,1056,1056,1.0,0.0,1.0,477,0.39109848484848486,0.1571969696969697,0.45170454545454547
6974,507001A,888,5,307,68,883,888,1.0,0.00563063063063063,0.9943693693693694,513,0.34572072072072074,0.07657657657657657,0.5777027027027027
6975,507004A,670,3,325,55,667,670,1.0,0.004477611940298508,0.9955223880597015,290,0.48507462686567165,0.08208955223880597,0.43283582089552236
